txn_id,posted_date,value_date,merchant_name,mcc,category,subcategory,amount,currency,balance_after,channel,location_city,location_country,card_last4,user_id,recurring_id,notes
5510543d-27ed-400d-a320-0a6749307fd3,2024-01-01,2024-01-02,Apple.com/bill,5734,Shopping,Electronics,-142.37,GBP,2357.63,E-Com,Cupertino,US,1045,user_001,,
74d63b63-3220-4c99-8e82-b2522c49c439,2024-01-01,2024-01-02,Sainsbury's,5411,Groceries,Supermarket,-47.5,GBP,2310.13,POS,London,GB,1045,user_001,,
bd0a6a64-12b2-4997-9e2d-827076f7e49a,2024-01-01,2024-01-03,Uber UK,4121,Transport,Ride Hailing,-18.62,GBP,2291.51,E-Com,London,GB,2219,user_002,,
dd06f27f-8f06-4cd2-9e19-a621f9bd0ccc,2024-01-01,2024-01-01,Crown Estates Lettings,6513,Housing,Rent,-1624.71,GBP,666.8,POS,London,GB,1045,user_001,rec_19f70fbcce,
10dd3c25-f4d2-4690-a049-453135550ec0,2024-01-02,2024-01-02,Shell,5541,Transport,Fuel,-88.75,GBP,578.05,POS,London,GB,9074,user_001,,
aadf7488-f892-4121-9138-7ad86aca56d8,2024-01-02,2024-01-02,Tesco,5411,Groceries,Supermarket,-76.56,GBP,501.49,POS,London,GB,2219,user_001,,
436d840f-4e66-4460-8135-bbfb885d3469,2024-01-03,2024-01-05,Uber UK,4121,Transport,Ride Hailing,-25.96,GBP,475.53,E-Com,London,GB,1045,user_001,,
24ee3a14-ebd4-4386-98fa-ef6e9e6c70df,2024-01-05,2024-01-08,Uber UK,4121,Transport,Ride Hailing,-26.42,GBP,449.11,E-Com,London,GB,4488,user_001,,
b465fc5a-489b-43e7-aea3-e384969be487,2024-01-05,2024-01-08,Deliveroo,5812,Food & Drink,Delivery,-24.99,GBP,424.12,E-Com,London,GB,9074,user_001,,
b588475f-7066-41cd-b109-c5079a933ee8,2024-01-05,2024-01-08,Pret A Manger,5814,Food & Drink,Eating Out,-10.38,GBP,413.74,POS,London,GB,1045,user_001,,
2ddcb8f3-d54a-4f38-ae52-c9719952c333,2024-01-06,2024-01-08,Amazon UK,5942,Shopping,Online Retail,-46.75,GBP,366.99,E-Com,London,GB,9074,user_001,,
d7fb1065-837b-4758-9cae-654f2c42b8f2,2024-01-06,2024-01-08,Pret A Manger,5814,Food & Drink,Eating Out,-7.86,GBP,359.13,POS,London,GB,9074,user_001,,
e393ddd8-0845-4d6b-ad90-efd8aba2b4d0,2024-01-06,2024-01-08,Amazon UK,5942,Shopping,Online Retail,-98.97,GBP,260.16,E-Com,London,GB,9074,user_001,,
ea335483-e56f-4416-8344-d1b96b410c3b,2024-01-06,2024-01-08,Tesco,5411,Groceries,Supermarket,-60.11,GBP,200.05,POS,London,GB,1045,user_001,,
2060132f-2a68-48bc-bb69-d60faba177ad,2024-01-07,2024-01-08,Transport for London,4111,Transport,Transit,-8.84,GBP,191.21,POS,London,GB,2219,user_001,,
6bd92e60-843c-414e-a9b1-0320c6161bf6,2024-01-07,2024-01-08,Waitrose,5411,Groceries,Supermarket,-61.63,GBP,129.58,POS,London,GB,9074,user_001,,
8b53769e-1763-4565-92e3-29bb4b06f233,2024-01-07,2024-01-08,Sainsbury's,5411,Groceries,Supermarket,-68.41,GBP,61.17,POS,London,GB,1045,user_001,,
b84d15d7-04b6-4f97-a79f-c61c2a4527bf,2024-01-07,2024-01-09,Tesco,5411,Groceries,Supermarket,-32.26,GBP,28.91,POS,London,GB,4488,user_002,,
db83b518-4e54-4711-b50a-853f3b46146e,2024-01-07,2024-01-09,Shell,5541,Transport,Fuel,-56.76,GBP,-27.85,POS,London,GB,1045,user_002,,
e09458ce-1d9b-49ae-b037-2dad1acf5c4f,2024-01-07,2024-01-09,Transport for London,4111,Transport,Transit,-11.58,GBP,-39.43,POS,London,GB,4488,user_001,,
b572b540-4d84-4bb4-8644-a23f660828f3,2024-01-08,2024-01-08,Tesco,5411,Groceries,Supermarket,-20.03,GBP,-59.46,POS,London,GB,1045,user_001,,
de99ade3-ce42-4785-840d-fed0781567ea,2024-01-08,2024-01-10,Shell,5541,Transport,Fuel,-82.13,GBP,-141.59,POS,London,GB,2219,user_002,,
f03e2fb8-1f22-4f41-92c5-8efd5185f071,2024-01-08,2024-01-09,Octopus Energy,4900,Utilities,Electricity,-120.61,GBP,-262.2,Direct Debit,London,GB,2219,user_001,rec_141a4a0666,
f692ea1b-f9b4-4f2a-9872-651da12189ad,2024-01-08,2024-01-09,Shell,5541,Transport,Fuel,-32.53,GBP,-294.73,POS,London,GB,1045,user_001,,
a3da8ae6-a756-40da-b4b7-1604af4efb0c,2024-01-09,2024-01-09,Uber UK,4121,Transport,Ride Hailing,-30.45,GBP,-325.18,E-Com,London,GB,4488,user_002,,
da295a9c-dd09-4b3c-86ef-f5307316edc2,2024-01-09,2024-01-09,Tesco,5411,Groceries,Supermarket,-72.38,GBP,-397.56,POS,London,GB,4488,user_001,,
e60c5050-dccf-49a9-a610-e1dc147a816f,2024-01-10,2024-01-10,Deliveroo,5812,Food & Drink,Delivery,-25.79,GBP,-423.35,E-Com,London,GB,9074,user_001,,
630dc3ce-3be4-4bca-b72f-45b35223479f,2024-01-11,2024-01-12,Thames Water,4900,Utilities,Water,-39.2,GBP,-462.55,Direct Debit,Reading,GB,2219,user_002,rec_954d02400c,
b14bc153-5b09-4515-9118-d8b82da57c50,2024-01-12,2024-01-15,Amazon UK,5942,Shopping,Online Retail,-100.45,GBP,-563.0,E-Com,London,GB,9074,user_001,,
cbd936cb-858e-4318-9e70-2374f5d743a9,2024-01-12,2024-01-15,Amazon UK,5942,Shopping,Online Retail,-79.9,GBP,-642.9,E-Com,London,GB,1045,user_001,,
389fe119-abcd-4997-8800-6e61496afcd7,2024-01-13,2024-01-15,Pret A Manger,5814,Food & Drink,Eating Out,-8.47,GBP,-651.37,POS,London,GB,1045,user_001,,
88d80ea2-acb5-4ef1-ab4f-52e544171b61,2024-01-13,2024-01-15,Transport for London,4111,Transport,Transit,-5.32,GBP,-656.69,POS,London,GB,1045,user_001,,
d661544e-0c4d-495f-90a5-b3a968171e8a,2024-01-13,2024-01-15,Pret A Manger,5814,Food & Drink,Eating Out,-10.9,GBP,-667.59,POS,London,GB,2219,user_001,,
050232d5-169b-407c-894d-b39ed124e6da,2024-01-14,2024-01-16,Waitrose,5411,Groceries,Supermarket,-38.85,GBP,-706.44,POS,London,GB,1045,user_001,,
22da3cd8-d185-4421-9480-fba3589bcd14,2024-01-14,2024-01-16,Pret A Manger,5814,Food & Drink,Eating Out,-6.35,GBP,-712.79,POS,London,GB,4488,user_001,,
abeb3c94-de23-44e0-96bc-b84ca8b8192a,2024-01-14,2024-01-16,Pret A Manger,5814,Food & Drink,Eating Out,-6.03,GBP,-718.82,POS,London,GB,1045,user_001,,
6dcb81db-3f65-4f9c-9bdc-5d1d8fc83f0b,2024-01-15,2024-01-17,City Council Tax,9399,Utilities,Council Tax,-158.61,GBP,-877.43,Direct Debit,London,GB,2219,user_001,rec_f531495db5,
75e4e8c1-c253-48d0-82c5-da30c5f7c347,2024-01-15,2024-01-17,Apple.com/bill,5734,Shopping,Electronics,-78.48,GBP,-955.91,E-Com,Cupertino,US,2219,user_001,,
8955f6ce-d681-4bea-b179-ced2c8f814a1,2024-01-15,2024-01-15,O2 UK,4814,Bills,Mobile,-45.3,GBP,-1001.21,Direct Debit,Slough,GB,2219,user_001,rec_95042d8101,
d047f211-08f8-46c6-9922-a988a97365d3,2024-01-15,2024-01-17,Deliveroo,5812,Food & Drink,Delivery,-14.13,GBP,-1015.34,E-Com,London,GB,9074,user_001,,
3324aa34-4f59-4e71-999b-a825106dd060,2024-01-16,2024-01-18,Waitrose,5411,Groceries,Supermarket,-73.04,GBP,-1088.38,POS,London,GB,2219,user_001,,
b2fa1f65-9264-444f-8b97-27a40acda032,2024-01-16,2024-01-17,Shell,5541,Transport,Fuel,-84.8,GBP,-1173.18,POS,London,GB,1045,user_001,,
de0f3221-42ac-41b8-8b78-c26723652cff,2024-01-16,2024-01-16,Waitrose,5411,Groceries,Supermarket,-75.97,GBP,-1249.15,POS,London,GB,4488,user_001,,
83bc45fe-e9ee-4403-a79b-e11854444131,2024-01-17,2024-01-18,GymBox,7997,Wellness,Gym,-54.94,GBP,-1304.09,Direct Debit,London,GB,9074,user_001,rec_3906953fd2,
fd85a082-a26c-440e-8555-332e717e9abb,2024-01-17,2024-01-17,ATM Withdrawal,6011,Cash,ATM,-102.39,GBP,-1406.48,ATM,London,GB,4488,user_001,,
5a43ef20-238d-4225-91d9-b356c1e971b6,2024-01-18,2024-01-18,Local Market,5499,Groceries,Specialty,-18.17,GBP,-1424.65,POS,London,GB,9074,user_002,,
beda8017-96f6-4bad-a826-e5fc03a7731b,2024-01-18,2024-01-19,Waitrose,5411,Groceries,Supermarket,-84.44,GBP,-1509.09,POS,London,GB,1045,user_001,,
ffdda4d4-41af-4a40-aaf3-61ebd89b055d,2024-01-18,2024-01-18,Uber UK,4121,Transport,Ride Hailing,-28.21,GBP,-1537.3,E-Com,London,GB,2219,user_001,,
693a179e-0d02-4ed4-a58b-e7a9ebc28a27,2024-01-19,2024-01-22,Spotify,5735,Entertainment,Subscriptions,-8.39,GBP,-1545.69,E-Com,Stockholm,SE,4488,user_001,rec_4c746d2c3b,
75a44f74-12f0-47ea-b1b0-5cc0d9149a37,2024-01-19,2024-01-22,Shell,5541,Transport,Fuel,-78.78,GBP,-1624.47,POS,London,GB,9074,user_001,,
01e65550-d3bf-4863-b659-ee4f96967d72,2024-01-20,2024-01-22,Local Market,5499,Groceries,Specialty,-13.57,GBP,-1638.04,POS,London,GB,4488,user_001,,
4ea8da80-7bfe-40d7-b1af-851fdc70fe2a,2024-01-21,2024-01-23,Pret A Manger,5814,Food & Drink,Eating Out,-6.31,GBP,-1644.35,POS,London,GB,1045,user_001,,
be24ffa8-ed92-4f3f-9b17-dd0fdf68e464,2024-01-21,2024-01-23,Shell,5541,Transport,Fuel,-87.77,GBP,-1732.12,POS,London,GB,4488,user_002,,
116e3ab5-1681-44a3-b4fe-c70a68b3e4bd,2024-01-22,2024-01-22,Netflix,7841,Entertainment,Subscriptions,-15.27,GBP,-1747.39,E-Com,Los Gatos,US,2219,user_002,rec_d9322c1382,
44ba36c7-6199-4f48-9a7d-f3d2bb232384,2024-01-22,2024-01-24,Sainsbury's,5411,Groceries,Supermarket,-28.89,GBP,-1776.28,POS,London,GB,4488,user_001,,
eac572ca-b152-402e-bf98-99df66d20e62,2024-01-22,2024-01-24,Amazon UK,5942,Shopping,Online Retail,-68.52,GBP,-1844.8,E-Com,London,GB,1045,user_001,,
05660e77-4e93-49da-9ad8-7fe1bfc19919,2024-01-25,2024-01-29,Amazon UK,5942,Shopping,Online Retail,-16.37,GBP,-1861.17,E-Com,London,GB,9074,user_001,,
62f90a94-5f56-43c6-8227-6ad5ab2da739,2024-01-25,2024-01-25,T212 Capital,6011,Income,Salary,3225.06,GBP,1363.89,Credit,London,GB,1045,user_002,rec_c649d24d0f,
6b0aa04b-be80-45d9-9d68-4cb3a34175ae,2024-01-25,2024-01-29,Local Market,5499,Groceries,Specialty,-18.18,GBP,1345.71,POS,London,GB,9074,user_001,,
c7a9cfca-6f19-400a-91ea-3bc3bad4ba50,2024-01-25,2024-01-26,Local Market,5499,Groceries,Specialty,-13.96,GBP,1331.75,POS,London,GB,2219,user_002,,
fc9eabc1-4d19-42c8-a150-742a2eb1e364,2024-01-25,2024-01-25,Local Market,5499,Groceries,Specialty,-10.83,GBP,1320.92,POS,London,GB,9074,user_001,,
0d4fc8a4-be75-44d1-aa15-58f3bca5e537,2024-01-26,2024-01-29,Deliveroo,5812,Food & Drink,Delivery,-29.64,GBP,1291.28,E-Com,London,GB,2219,user_001,,
5d3fd961-78d8-4b93-855e-56701a18bdcd,2024-01-26,2024-01-29,Deliveroo,5812,Food & Drink,Delivery,-14.01,GBP,1277.27,E-Com,London,GB,1045,user_002,,
bb920fb8-c38a-4755-94b4-31740da56eab,2024-01-26,2024-01-29,Pret A Manger,5814,Food & Drink,Eating Out,-10.0,GBP,1267.27,POS,London,GB,2219,user_002,,
706d56f5-2413-4bc3-b9be-fa770e3aa979,2024-01-27,2024-01-29,Pret A Manger,5814,Food & Drink,Eating Out,-10.23,GBP,1257.04,POS,London,GB,2219,user_001,,
ab7787f5-81b1-4215-8b9c-a2f3c6201390,2024-01-27,2024-01-29,Tesco,5411,Groceries,Supermarket,-53.06,GBP,1203.98,POS,London,GB,2219,user_001,,
f5fceb73-3613-4b1e-8ffe-8da160ed9f11,2024-01-27,2024-01-29,Amazon UK,5942,Shopping,Online Retail,-112.46,GBP,1091.52,E-Com,London,GB,4488,user_001,,
8e85d348-c5e2-41e0-bd5a-7f83c6c7a532,2024-01-28,2024-01-29,Local Market,5499,Groceries,Specialty,-9.56,GBP,1081.96,POS,London,GB,4488,user_001,,
012b87e5-6dc3-4d08-9606-9bb404d4c963,2024-01-29,2024-01-31,Tesco,5411,Groceries,Supermarket,-47.97,GBP,1033.99,POS,London,GB,9074,user_001,,
3fd541ec-e6de-4361-b823-7d6ce57b7477,2024-01-29,2024-01-30,Sainsbury's,5411,Groceries,Supermarket,-36.18,GBP,997.81,POS,London,GB,1045,user_001,,
d86997ad-96b1-4da7-a4dd-4ea4f935c96a,2024-01-29,2024-01-30,Uber UK,4121,Transport,Ride Hailing,-25.37,GBP,972.44,E-Com,London,GB,2219,user_001,,
ee67aad3-20ed-45cc-bac3-8661d70f5d60,2024-01-29,2024-01-29,Local Market,5499,Groceries,Specialty,-14.06,GBP,958.38,POS,London,GB,9074,user_001,,
322a8c60-4c8c-4c55-9ca2-534412d23a51,2024-01-30,2024-02-01,Amazon UK,5942,Shopping,Online Retail,-114.22,GBP,844.16,E-Com,London,GB,9074,user_002,,
78c9f82e-99f4-4a57-a296-ea4ad101eda2,2024-01-30,2024-01-30,Waitrose,5411,Groceries,Supermarket,-60.85,GBP,783.31,POS,London,GB,2219,user_001,,
c7a55c52-d872-4772-b0a3-40ede8fb225f,2024-01-30,2024-01-31,Pret A Manger,5814,Food & Drink,Eating Out,-11.99,GBP,771.32,POS,London,GB,1045,user_001,,
b3cb95c4-c75c-46ad-bfde-4375f577eed2,2024-01-31,2024-02-02,Waitrose,5411,Groceries,Supermarket,-77.93,GBP,693.39,POS,London,GB,2219,user_001,,
d8174e13-7682-4132-841a-8dfe4005956b,2024-01-31,2024-02-02,Pret A Manger,5814,Food & Drink,Eating Out,-7.53,GBP,685.86,POS,London,GB,2219,user_001,,
a2f12873-bb27-4c9d-aa42-ab25b7140468,2024-02-01,2024-02-01,Tesco,5411,Groceries,Supermarket,-71.09,GBP,614.77,POS,London,GB,9074,user_001,,
a3201542-69e1-4e4a-8f54-fe7903f7c130,2024-02-01,2024-02-05,Crown Estates Lettings,6513,Housing,Rent,-1525.32,GBP,-910.55,POS,London,GB,4488,user_001,rec_19f70fbcce,
ed2517ab-3f98-4754-a194-a80c134ed506,2024-02-02,2024-02-05,Uber UK,4121,Transport,Ride Hailing,-33.87,GBP,-944.42,E-Com,London,GB,4488,user_002,,
2ce04a8e-0a2f-41ed-a623-8d0336654647,2024-02-03,2024-02-05,Amazon UK,5942,Shopping,Online Retail,-42.73,GBP,-987.15,E-Com,London,GB,2219,user_001,,
3bf63056-55a9-4487-ade8-d6133073106b,2024-02-03,2024-02-05,Uber UK,4121,Transport,Ride Hailing,-31.84,GBP,-1018.99,E-Com,London,GB,1045,user_001,,
4b5223ae-39a6-43ea-8dd7-0ff09b2364fd,2024-02-03,2024-02-05,Deliveroo,5812,Food & Drink,Delivery,-12.71,GBP,-1031.7,E-Com,London,GB,2219,user_002,,
4e9d3b67-c819-465b-9bbe-d600393a6917,2024-02-03,2024-02-05,Waitrose,5411,Groceries,Supermarket,-67.63,GBP,-1099.33,POS,London,GB,9074,user_002,,
713ff591-06ac-4832-a8fc-d1f3c0842de5,2024-02-03,2024-02-05,Amazon UK,5942,Shopping,Online Retail,-82.92,GBP,-1182.25,E-Com,London,GB,4488,user_001,,
88b94065-6d57-40b9-97b1-b942c8cfa4b1,2024-02-03,2024-02-05,Local Market,5499,Groceries,Specialty,-14.21,GBP,-1196.46,POS,London,GB,4488,user_001,,
d330a6d0-f7f3-4b84-8461-1a1e305913ea,2024-02-04,2024-02-05,Pret A Manger,5814,Food & Drink,Eating Out,-10.07,GBP,-1206.53,POS,London,GB,4488,user_001,,
df6da03a-e73d-4044-9ee2-59c2fbb570f0,2024-02-04,2024-02-06,Tesco,5411,Groceries,Supermarket,-63.98,GBP,-1270.51,POS,London,GB,9074,user_001,,
3d3ddde8-4375-4350-9b4f-3c953ad8ffa0,2024-02-06,2024-02-06,Pret A Manger,5814,Food & Drink,Eating Out,-10.47,GBP,-1280.98,POS,London,GB,2219,user_001,,
ffa1fac1-dbea-43ef-9a8a-bba2748e8333,2024-02-06,2024-02-08,Transport for London,4111,Transport,Transit,-10.83,GBP,-1291.81,POS,London,GB,4488,user_001,,
74dab472-8dfe-4361-bbcc-ba4942e0d299,2024-02-07,2024-02-08,Deliveroo,5812,Food & Drink,Delivery,-22.32,GBP,-1314.13,E-Com,London,GB,2219,user_002,,
b1fa48f6-0629-4958-b3f3-044a995fe3db,2024-02-07,2024-02-07,Octopus Energy,4900,Utilities,Electricity,-132.09,GBP,-1446.22,Direct Debit,London,GB,2219,user_001,rec_141a4a0666,
debb9b3a-87c0-4934-beaf-dae7792e16bb,2024-02-07,2024-02-07,Sainsbury's,5411,Groceries,Supermarket,-67.92,GBP,-1514.14,POS,London,GB,2219,user_001,,
f57c612f-2ab4-472c-a617-dab41d132510,2024-02-07,2024-02-07,Transport for London,4111,Transport,Transit,-5.37,GBP,-1519.51,POS,London,GB,9074,user_001,,
2edd7e92-65ca-478d-aec5-b8810d37a286,2024-02-08,2024-02-08,Transport for London,4111,Transport,Transit,-11.34,GBP,-1530.85,POS,London,GB,1045,user_001,,
15881df4-6c63-4d92-860e-5494c2b32186,2024-02-10,2024-02-12,Sainsbury's,5411,Groceries,Supermarket,-18.59,GBP,-1549.44,POS,London,GB,4488,user_001,,
283ad243-28de-4f49-8a5b-09d040abd46d,2024-02-10,2024-02-12,Uber UK,4121,Transport,Ride Hailing,-29.28,GBP,-1578.72,E-Com,London,GB,2219,user_001,,
69603103-6f06-4701-9722-227de2728f85,2024-02-10,2024-02-12,Waitrose,5411,Groceries,Supermarket,-80.57,GBP,-1659.29,POS,London,GB,1045,user_002,,
d7175667-fd4b-4e0a-b72f-8bbf1b466764,2024-02-10,2024-02-12,Shell,5541,Transport,Fuel,-92.96,GBP,-1752.25,POS,London,GB,1045,user_001,,
38649788-4f70-4955-903d-feb2b3534731,2024-02-11,2024-02-13,Amazon UK,5942,Shopping,Online Retail,-110.04,GBP,-1862.29,E-Com,London,GB,2219,user_001,,
43056cc6-bff8-4d7d-881f-762e45c07a2a,2024-02-11,2024-02-12,Shell,5541,Transport,Fuel,-42.88,GBP,-1905.17,POS,London,GB,4488,user_001,,
66e69e68-66f9-48af-bd67-b02c7a1b268f,2024-02-11,2024-02-12,Uber UK,4121,Transport,Ride Hailing,-18.42,GBP,-1923.59,E-Com,London,GB,1045,user_001,,
6d92818b-de10-46d7-80eb-d2bb390d0751,2024-02-11,2024-02-13,Amazon UK,5942,Shopping,Online Retail,-99.68,GBP,-2023.27,E-Com,London,GB,2219,user_001,,
e553ee19-c17b-4f62-a981-e03fabcdb3b8,2024-02-11,2024-02-12,Sainsbury's,5411,Groceries,Supermarket,-59.8,GBP,-2083.07,POS,London,GB,1045,user_002,,
fb4fa5e3-b985-45a5-870c-7ece26bedcce,2024-02-11,2024-02-12,British Airways,4511,Travel,Flights,-222.94,EUR,-2306.01,E-Com,London,GB,1045,user_002,,Holiday booking
0fad446c-0307-47f8-8210-97c581456362,2024-02-12,2024-02-13,Thames Water,4900,Utilities,Water,-35.33,GBP,-2341.34,Direct Debit,Reading,GB,4488,user_001,rec_3a34d62842,
43232786-e0cd-4b96-8d2c-d9bee2f4387a,2024-02-12,2024-02-14,Transport for London,4111,Transport,Transit,-4.96,GBP,-2346.3,POS,London,GB,2219,user_001,,
fc194952-5631-48cb-a65e-acc41e8fc160,2024-02-13,2024-02-13,City Council Tax,9399,Utilities,Council Tax,-157.82,GBP,-2504.12,Direct Debit,London,GB,2219,user_001,rec_f531495db5,
17cda0f2-f58f-4e21-aa04-339ce8effc76,2024-02-14,2024-02-14,Pret A Manger,5814,Food & Drink,Eating Out,-5.84,GBP,-2509.96,POS,London,GB,1045,user_001,,
1c981040-80b6-4103-8425-9b7b918f0bdf,2024-02-14,2024-02-16,Uber UK,4121,Transport,Ride Hailing,-16.71,GBP,-2526.67,E-Com,London,GB,4488,user_001,,
72bd0382-3073-4c7d-9282-572a1189b87f,2024-02-14,2024-02-14,Sainsbury's,5411,Groceries,Supermarket,-39.52,GBP,-2566.19,POS,London,GB,1045,user_001,,
2cbff39e-9148-4bcd-9767-87c4cc434265,2024-02-15,2024-02-16,O2 UK,4814,Bills,Mobile,-53.46,GBP,-2619.65,Direct Debit,Slough,GB,9074,user_001,rec_95042d8101,
ca8553c1-7771-41c5-929c-7e415339f436,2024-02-15,2024-02-19,Deliveroo,5812,Food & Drink,Delivery,-12.75,GBP,-2632.4,E-Com,London,GB,2219,user_001,,
37a10feb-844c-4a59-9093-929cf7f9a6de,2024-02-16,2024-02-19,Deliveroo,5812,Food & Drink,Delivery,-32.64,GBP,-2665.04,E-Com,London,GB,1045,user_001,,
3b56a8f8-cff8-4870-a41e-d94c13a23b9a,2024-02-16,2024-02-19,Tesco,5411,Groceries,Supermarket,-34.96,GBP,-2700.0,POS,London,GB,9074,user_001,,
a6e0fcfa-ff60-441a-ad3f-53b5fe83b817,2024-02-16,2024-02-19,Pret A Manger,5814,Food & Drink,Eating Out,-6.34,GBP,-2706.34,POS,London,GB,9074,user_002,,
b20ab879-d7b0-4bda-95b3-b721bc2cf557,2024-02-16,2024-02-19,Shell,5541,Transport,Fuel,-39.48,GBP,-2745.82,POS,London,GB,9074,user_001,,
08e6d681-ca3c-483a-9465-aa80e98ad83b,2024-02-17,2024-02-19,Tesco,5411,Groceries,Supermarket,-63.02,GBP,-2808.84,POS,London,GB,4488,user_001,,
3189ab37-06cf-41c1-aa1b-c215a756a178,2024-02-17,2024-02-19,Apple.com/bill,5734,Shopping,Electronics,-197.5,GBP,-3006.34,E-Com,Cupertino,US,2219,user_001,,
35c3f373-6b51-434d-83fb-59f18d01627f,2024-02-17,2024-02-19,Waitrose,5411,Groceries,Supermarket,-89.44,GBP,-3095.78,POS,London,GB,9074,user_001,,
d5bfbe5e-d663-4d69-ab66-50aa79d786c8,2024-02-17,2024-02-19,Amazon UK,5942,Shopping,Online Retail,-26.39,GBP,-3122.17,E-Com,London,GB,4488,user_001,,
da16cb23-5cba-4526-a821-a00f4db60ad5,2024-02-17,2024-02-19,Uber UK,4121,Transport,Ride Hailing,-18.81,GBP,-3140.98,E-Com,London,GB,9074,user_001,,
e80e91a2-6dc4-4155-9f69-0e90661a449a,2024-02-17,2024-02-19,ATM Withdrawal,6011,Cash,ATM,-77.24,GBP,-3218.22,ATM,London,GB,1045,user_001,,
3953adb9-f487-4840-8da1-85c687e54633,2024-02-18,2024-02-19,Pret A Manger,5814,Food & Drink,Eating Out,-11.8,GBP,-3230.02,POS,London,GB,1045,user_001,,
8d8b0397-bca1-4dc3-8e0b-79275b81763a,2024-02-18,2024-02-20,Pret A Manger,5814,Food & Drink,Eating Out,-7.76,GBP,-3237.78,POS,London,GB,4488,user_001,,
d8593e1b-08cf-4ffd-aa52-77b29d2f8628,2024-02-18,2024-02-19,Deliveroo,5812,Food & Drink,Delivery,-26.0,GBP,-3263.78,E-Com,London,GB,9074,user_001,,
dd6cc3bd-de72-4167-89c7-6aea4a14f593,2024-02-18,2024-02-19,Deliveroo,5812,Food & Drink,Delivery,-25.99,GBP,-3289.77,E-Com,London,GB,9074,user_001,,
336ee607-f3f6-4739-98a8-4aed33a73afa,2024-02-19,2024-02-20,Pret A Manger,5814,Food & Drink,Eating Out,-7.67,GBP,-3297.44,POS,London,GB,2219,user_001,,
6f1aef99-19c9-4c47-aa29-d0b3498c2e49,2024-02-19,2024-02-21,Shell,5541,Transport,Fuel,-32.75,GBP,-3330.19,POS,London,GB,2219,user_001,,
76735623-3f73-435c-a901-792c6c7183f1,2024-02-19,2024-02-21,Spotify,5735,Entertainment,Subscriptions,-8.87,GBP,-3339.06,E-Com,Stockholm,SE,2219,user_001,rec_4c746d2c3b,
86b82fb8-ed8b-408c-aea9-0e264a566d13,2024-02-19,2024-02-19,Amazon UK,5942,Shopping,Online Retail,-9.48,GBP,-3348.54,E-Com,London,GB,4488,user_001,,
94f40770-131f-4f12-a14d-3f7dd14dba11,2024-02-19,2024-02-21,GymBox,7997,Wellness,Gym,-51.88,GBP,-3400.42,Direct Debit,London,GB,1045,user_001,rec_3906953fd2,
f2a140a7-ee05-4fe5-b0bf-c73049ffcba2,2024-02-20,2024-02-20,Waitrose,5411,Groceries,Supermarket,-37.15,GBP,-3437.57,POS,London,GB,9074,user_002,,
4093402a-7db5-4af4-86df-6e79b8e815d9,2024-02-21,2024-02-22,Netflix,7841,Entertainment,Subscriptions,-15.76,GBP,-3453.33,E-Com,Los Gatos,US,1045,user_001,rec_1bfe33738d,
4b434c20-9398-45ad-a159-1aa28fa08134,2024-02-21,2024-02-21,Sainsbury's,5411,Groceries,Supermarket,-26.27,GBP,-3479.6,POS,London,GB,1045,user_001,,
054ac11d-2ce5-408c-b166-11ac37892f9e,2024-02-23,2024-02-23,Sainsbury's,5411,Groceries,Supermarket,-58.57,GBP,-3538.17,POS,London,GB,1045,user_001,,
981643d1-b81d-4e94-a394-043fefabe35c,2024-02-23,2024-02-23,T212 Capital,6011,Income,Salary,2887.47,GBP,-650.7,Credit,London,GB,4488,user_001,rec_2ff8f778d0,
e978c5f3-1f89-4abe-978f-2fd1e3becaea,2024-02-23,2024-02-26,Sainsbury's,5411,Groceries,Supermarket,-28.58,GBP,-679.28,POS,London,GB,4488,user_001,,
8b660060-4226-4db1-b719-4bcefdaae8cf,2024-02-24,2024-02-26,Sainsbury's,5411,Groceries,Supermarket,-17.74,GBP,-697.02,POS,London,GB,9074,user_001,,
e9900909-5e51-4439-9e03-f4d969229c51,2024-02-24,2024-02-26,Local Market,5499,Groceries,Specialty,-13.24,GBP,-710.26,POS,London,GB,9074,user_001,,
d23d42d1-cf08-4633-bc9a-0f3a3a9863b6,2024-02-25,2024-02-26,Deliveroo,5812,Food & Drink,Delivery,-12.18,GBP,-722.44,E-Com,London,GB,4488,user_001,,
da235666-f386-4cfd-aff6-02b54d114494,2024-02-25,2024-02-26,Uber UK,4121,Transport,Ride Hailing,-10.7,GBP,-733.14,E-Com,London,GB,4488,user_001,,
dd93756f-198d-43ec-b81c-87f34ef3805c,2024-02-25,2024-02-26,Tesco,5411,Groceries,Supermarket,-52.25,GBP,-785.39,POS,London,GB,9074,user_001,,
fb1c1751-4694-46cc-ab3b-c747710840de,2024-02-25,2024-02-27,Transport for London,4111,Transport,Transit,-10.89,GBP,-796.28,POS,London,GB,9074,user_002,,
7af59207-10a1-417e-8550-a528c8765e92,2024-02-26,2024-02-26,HM Revenue & Customs,9311,Income,Tax Refund,165.9,GBP,-630.38,Credit,London,GB,9074,user_001,,Refund for Apple.com/bill
2664b68a-cf13-4f7e-8393-0a610c6839f1,2024-02-27,2024-02-29,ATM Withdrawal,6011,Cash,ATM,-63.26,GBP,-693.64,ATM,London,GB,2219,user_001,,
0341fe89-2756-4f40-ac32-940e92047b64,2024-02-28,2024-02-29,Pret A Manger,5814,Food & Drink,Eating Out,-8.56,GBP,-702.2,POS,London,GB,2219,user_002,,
24f91d6a-0be1-4603-92c3-c16e44ddcfb2,2024-02-28,2024-02-29,Waitrose,5411,Groceries,Supermarket,-34.7,GBP,-736.9,POS,London,GB,9074,user_001,,
ff2748ba-58ad-4104-802f-c9c4b4e9418a,2024-02-28,2024-02-29,Sainsbury's,5411,Groceries,Supermarket,-17.18,GBP,-754.08,POS,London,GB,4488,user_001,,
d7581ae8-5dbe-4b3e-b3e5-c7f559cca1f7,2024-02-29,2024-03-01,Uber UK,4121,Transport,Ride Hailing,-26.39,GBP,-780.47,E-Com,London,GB,2219,user_001,,
2947ae0c-0fe1-4b84-bcbc-12f4c110664a,2024-03-01,2024-03-04,Crown Estates Lettings,6513,Housing,Rent,-1554.26,GBP,-2334.73,POS,London,GB,4488,user_001,rec_19f70fbcce,
76c7e58f-f78e-4077-9811-43232ec3f62c,2024-03-01,2024-03-04,Amazon UK,5942,Shopping,Online Retail,-99.02,GBP,-2433.75,E-Com,London,GB,4488,user_001,,
31cc6389-d1be-43bb-9c69-0fd4f97ec941,2024-03-02,2024-03-04,Local Market,5499,Groceries,Specialty,-15.02,GBP,-2448.77,POS,London,GB,9074,user_001,,
4a753618-21c1-49fe-ab6b-986a8a17dd9a,2024-03-02,2024-03-04,Amazon UK,5942,Shopping,Online Retail,-114.22,GBP,-2562.99,E-Com,London,GB,2219,user_001,,
c20ef750-7531-45cb-914c-fdb1e711d2e5,2024-03-02,2024-03-04,Transport for London,4111,Transport,Transit,-5.92,GBP,-2568.91,POS,London,GB,2219,user_002,,
e5b4c962-4cee-49df-bf74-36a60f87f877,2024-03-02,2024-03-04,Waitrose,5411,Groceries,Supermarket,-70.32,GBP,-2639.23,POS,London,GB,1045,user_001,,
f471376a-7ad9-41e2-93dd-81c7b83ddd89,2024-03-02,2024-03-04,Shell,5541,Transport,Fuel,-76.8,GBP,-2716.03,POS,London,GB,1045,user_001,,
8956315e-ef6e-48a7-abd3-004e6dc962e2,2024-03-03,2024-03-04,Tesco,5411,Groceries,Supermarket,-54.78,GBP,-2770.81,POS,London,GB,4488,user_001,,
995d45b1-4033-4791-9b83-246fa49b8201,2024-03-03,2024-03-05,Sainsbury's,5411,Groceries,Supermarket,-66.45,GBP,-2837.26,POS,London,GB,9074,user_001,,
929e3c4b-18a0-4043-878e-35c7245c19ce,2024-03-04,2024-03-04,Uber UK,4121,Transport,Ride Hailing,-32.36,GBP,-2869.62,E-Com,London,GB,2219,user_001,,
18922835-4d28-4025-83a6-aac2e2697083,2024-03-05,2024-03-05,Pret A Manger,5814,Food & Drink,Eating Out,-10.38,GBP,-2880.0,POS,London,GB,1045,user_001,,
15dbb5be-378f-40c9-8caf-fb16737f86de,2024-03-06,2024-03-08,Deliveroo,5812,Food & Drink,Delivery,-24.81,GBP,-2904.81,E-Com,London,GB,2219,user_002,,
86250c44-18b5-42e4-85f8-245390097da6,2024-03-06,2024-03-06,Tesco,5411,Groceries,Supermarket,-65.94,GBP,-2970.75,POS,London,GB,4488,user_001,,
cb48b575-b582-4b0a-ac4e-02c5fcd44bc6,2024-03-06,2024-03-06,Deliveroo,5812,Food & Drink,Delivery,-25.03,GBP,-2995.78,E-Com,London,GB,1045,user_002,,
01434d16-b4be-4617-8cbc-59762036bf69,2024-03-07,2024-03-11,Local Market,5499,Groceries,Specialty,-16.48,GBP,-3012.26,POS,London,GB,9074,user_001,,
27869849-b4d1-468c-8f18-5764ebd01183,2024-03-07,2024-03-07,Transport for London,4111,Transport,Transit,-6.58,GBP,-3018.84,POS,London,GB,9074,user_001,,
f3e456e7-bea0-42ec-a829-c3ba53835124,2024-03-07,2024-03-07,Octopus Energy,4900,Utilities,Electricity,-114.49,GBP,-3133.33,Direct Debit,London,GB,9074,user_001,rec_141a4a0666,
8f42ef63-f8ef-4d96-9acf-841be97e8af3,2024-03-08,2024-03-11,Pret A Manger,5814,Food & Drink,Eating Out,-8.0,GBP,-3141.33,POS,London,GB,4488,user_001,,
2d2514f7-fd38-4eca-b068-81e0d4fff748,2024-03-09,2024-03-11,Tesco,5411,Groceries,Supermarket,-70.68,GBP,-3212.01,POS,London,GB,2219,user_001,,
7868cd19-6df4-419c-b766-8e9951284b82,2024-03-09,2024-03-11,Deliveroo,5812,Food & Drink,Delivery,-18.54,GBP,-3230.55,E-Com,London,GB,9074,user_002,,
a95855ea-eabc-428d-86bc-09cd9801563d,2024-03-09,2024-03-11,Pret A Manger,5814,Food & Drink,Eating Out,-8.15,GBP,-3238.7,POS,London,GB,1045,user_001,,
c76fa9f6-52b2-4887-81e2-514801b85410,2024-03-09,2024-03-11,Deliveroo,5812,Food & Drink,Delivery,-29.92,GBP,-3268.62,E-Com,London,GB,1045,user_001,,
d56d9a78-59ba-471f-ba11-807d5a269f7f,2024-03-09,2024-03-11,Sainsbury's,5411,Groceries,Supermarket,-63.6,GBP,-3332.22,POS,London,GB,9074,user_001,,
036844d5-baf0-4f42-849e-5eef07a8518e,2024-03-10,2024-03-11,Shell,5541,Transport,Fuel,-89.43,GBP,-3421.65,POS,London,GB,4488,user_001,,
409784c3-a4f9-478b-b1de-450f2643e365,2024-03-10,2024-03-11,Tesco,5411,Groceries,Supermarket,-43.97,GBP,-3465.62,POS,London,GB,4488,user_002,,
906d61e3-2809-47ef-9563-4d3f46a39141,2024-03-10,2024-03-11,Tesco,5411,Groceries,Supermarket,-78.31,GBP,-3543.93,POS,London,GB,4488,user_002,,
b2ceea34-e192-4abc-a891-7815fb15ed25,2024-03-10,2024-03-11,Deliveroo,5812,Food & Drink,Delivery,-32.4,GBP,-3576.33,E-Com,London,GB,4488,user_001,,
23c0a8cb-3c8d-48fe-b5f7-c633ab1a4e8f,2024-03-11,2024-03-13,Uber UK,4121,Transport,Ride Hailing,-11.83,GBP,-3588.16,E-Com,London,GB,1045,user_001,,
5636c2e5-81f7-42d3-b660-8b1fe4d48bfc,2024-03-11,2024-03-11,Amazon UK,5942,Shopping,Online Retail,-14.15,GBP,-3602.31,E-Com,London,GB,4488,user_001,,
7723afbb-2f5b-4e0b-b6de-eb0a202af9f1,2024-03-11,2024-03-13,Waitrose,5411,Groceries,Supermarket,-61.87,GBP,-3664.18,POS,London,GB,1045,user_001,,
83b4daff-b841-49ca-bd82-77e9b3490c3f,2024-03-11,2024-03-12,Transport for London,4111,Transport,Transit,-11.56,GBP,-3675.74,POS,London,GB,2219,user_001,,
95951f1c-1cb1-40bc-bdd3-32dc49f74ba8,2024-03-11,2024-03-12,Transport for London,4111,Transport,Transit,-3.93,GBP,-3679.67,POS,London,GB,9074,user_001,,
a1bfd6f7-fcd3-4930-8116-b2dc63e95495,2024-03-11,2024-03-11,Thames Water,4900,Utilities,Water,-35.43,GBP,-3715.1,Direct Debit,Reading,GB,2219,user_001,rec_3a34d62842,
c14a954d-383d-412f-834d-3c41e86c4c02,2024-03-11,2024-03-11,Waitrose,5411,Groceries,Supermarket,-28.86,GBP,-3743.96,POS,London,GB,9074,user_002,,
014d7860-a6c1-4827-98d0-789e67394abd,2024-03-13,2024-03-15,ATM Withdrawal,6011,Cash,ATM,-83.06,GBP,-3827.02,ATM,London,GB,2219,user_001,,
458059f6-7f7d-42aa-946e-215e7a571d4a,2024-03-13,2024-03-14,City Council Tax,9399,Utilities,Council Tax,-167.17,GBP,-3994.19,Direct Debit,London,GB,9074,user_001,rec_f531495db5,
de76e73d-d9e0-4cef-a6e4-f16fb74d82bc,2024-03-13,2024-03-14,Transport for London,4111,Transport,Transit,-8.15,GBP,-4002.34,POS,London,GB,9074,user_001,,
0586bf75-bc09-4f6f-a384-cb8535c5ef9c,2024-03-15,2024-03-18,Deliveroo,5812,Food & Drink,Delivery,-29.04,GBP,-4031.38,E-Com,London,GB,4488,user_001,,
5bf00ca4-4a9a-4bb7-b36e-3e7b9fb37b77,2024-03-15,2024-03-18,Uber UK,4121,Transport,Ride Hailing,-27.25,GBP,-4058.63,E-Com,London,GB,4488,user_001,,
a96e47f3-cc2a-413f-9a90-df6e287ffab7,2024-03-15,2024-03-18,O2 UK,4814,Bills,Mobile,-44.27,GBP,-4102.9,Direct Debit,Slough,GB,2219,user_002,rec_d2dce4c42f,
3f7ad32b-2e88-4ce6-88b0-a4e03a09f25b,2024-03-16,2024-03-18,Uber UK,4121,Transport,Ride Hailing,-17.63,GBP,-4120.53,E-Com,London,GB,1045,user_001,,
408bb3f5-8f16-45c0-8bd7-7c233c2cf301,2024-03-16,2024-03-18,Amazon UK,5942,Shopping,Online Retail,-58.24,GBP,-4178.77,E-Com,London,GB,9074,user_001,,
8e8fb270-6cbb-4690-a12c-134b8e7b55c3,2024-03-16,2024-03-18,Uber UK,4121,Transport,Ride Hailing,-14.78,GBP,-4193.55,E-Com,London,GB,9074,user_001,,
02a03139-968f-4d72-acb9-aa7ac0f9a339,2024-03-17,2024-03-18,Deliveroo,5812,Food & Drink,Delivery,-24.68,GBP,-4218.23,E-Com,London,GB,9074,user_001,,
294ba372-f3ba-4561-b358-4f6322ba7352,2024-03-17,2024-03-19,Apple.com/bill,5734,Shopping,Electronics,-12.93,USD,-4231.16,E-Com,Cupertino,US,2219,user_001,,FX purchase 16.1 USD @ rate 1.25
4080de8a-9e86-4db9-9749-6d9feffed939,2024-03-17,2024-03-18,Apple.com/bill,5734,Shopping,Electronics,-98.0,USD,-4329.16,E-Com,Cupertino,US,9074,user_001,,FX purchase 119.03 USD @ rate 1.21
67544ca3-ba8c-4751-9527-a2ad1d5f04f6,2024-03-17,2024-03-18,Transport for London,4111,Transport,Transit,-8.01,GBP,-4337.17,POS,London,GB,2219,user_001,,
763e3d86-b0e1-4c33-abfa-dab3bb24a80f,2024-03-17,2024-03-18,Pret A Manger,5814,Food & Drink,Eating Out,-8.81,GBP,-4345.98,POS,London,GB,9074,user_001,,
a6574952-d0c2-4703-ae06-7ea8c686eb96,2024-03-17,2024-03-18,Local Market,5499,Groceries,Specialty,-18.94,GBP,-4364.92,POS,London,GB,1045,user_001,,
78dc09c3-9347-4281-b3d0-614f0e2e91e0,2024-03-18,2024-03-18,GymBox,7997,Wellness,Gym,-62.89,GBP,-4427.81,Direct Debit,London,GB,4488,user_001,rec_3906953fd2,
83d5bde4-9627-44a2-8de1-c65a98e62600,2024-03-18,2024-03-20,Uber UK,4121,Transport,Ride Hailing,-10.07,GBP,-4437.88,E-Com,London,GB,1045,user_001,,
ec17cb0f-8c77-407f-b3a7-0cd7b9d14f38,2024-03-18,2024-03-19,Tesco,5411,Groceries,Supermarket,-55.71,GBP,-4493.59,POS,London,GB,1045,user_001,,
899e4247-6f71-4307-a337-c5b33ef1054d,2024-03-19,2024-03-21,Spotify,5735,Entertainment,Subscriptions,-8.18,GBP,-4501.77,E-Com,Stockholm,SE,2219,user_002,rec_34b6e9e33f,
f460227f-2306-427e-9a76-391b87e92c1e,2024-03-19,2024-03-21,Pret A Manger,5814,Food & Drink,Eating Out,-6.3,GBP,-4508.07,POS,London,GB,1045,user_001,,
1bf1f5fb-a141-48ca-b363-94bd48c2a4f1,2024-03-20,2024-03-22,Shell,5541,Transport,Fuel,-69.75,GBP,-4577.82,POS,London,GB,4488,user_002,,
4e3a7594-284e-4b5e-a84b-c66e58c69848,2024-03-20,2024-03-20,Deliveroo,5812,Food & Drink,Delivery,-29.4,GBP,-4607.22,E-Com,London,GB,2219,user_001,,
c787d1ec-9432-4b4a-9d7d-ce186912cbd1,2024-03-20,2024-03-22,Transport for London,4111,Transport,Transit,-9.84,GBP,-4617.06,POS,London,GB,1045,user_001,,
63399b48-d86b-4c65-aa9b-c8cf0351b105,2024-03-21,2024-03-22,Local Market,5499,Groceries,Specialty,-20.82,GBP,-4637.88,POS,London,GB,1045,user_001,,
e86308ea-9db4-4d16-a84f-6f8ab775d278,2024-03-21,2024-03-25,Netflix,7841,Entertainment,Subscriptions,-10.08,GBP,-4647.96,E-Com,Los Gatos,US,4488,user_001,rec_1bfe33738d,
1b73a22b-7bea-40cc-9b76-7499380937d1,2024-03-22,2024-03-22,Amazon UK,5942,Shopping,Online Retail,-60.37,GBP,-4708.33,E-Com,London,GB,1045,user_001,,
3f652467-0ee8-4aad-8d21-bbbe56731dc6,2024-03-22,2024-03-22,Apple.com/bill,5734,Shopping,Electronics,-138.86,USD,-4847.19,E-Com,Cupertino,US,1045,user_001,,FX purchase 166.47 USD @ rate 1.20
114c4a82-02ad-48b9-8736-30ccffe86195,2024-03-23,2024-03-25,Tesco,5411,Groceries,Supermarket,-68.77,GBP,-4915.96,POS,London,GB,2219,user_002,,
24dcadcf-38ed-4d44-8595-44ab31e4e1c0,2024-03-23,2024-03-25,Airbnb,7011,Travel,Accommodation,-257.51,EUR,-5173.47,E-Com,Dublin,IE,4488,user_002,,Holiday booking
429377ae-fd0a-4c5a-8ac0-24aea81ed298,2024-03-23,2024-03-25,Uber UK,4121,Transport,Ride Hailing,-19.8,GBP,-5193.27,E-Com,London,GB,9074,user_002,,
5593f902-6ef7-4d64-bf69-00097c3d4af3,2024-03-23,2024-03-25,Uber UK,4121,Transport,Ride Hailing,-22.22,GBP,-5215.49,E-Com,London,GB,9074,user_001,,
7b667cd4-fcce-4284-b477-3f4ceb7479a9,2024-03-23,2024-03-25,Shell,5541,Transport,Fuel,-78.55,GBP,-5294.04,POS,London,GB,4488,user_001,,
f741b5d5-66bf-4c27-b003-bb646142d57d,2024-03-23,2024-03-25,Deliveroo,5812,Food & Drink,Delivery,-19.43,GBP,-5313.47,E-Com,London,GB,9074,user_001,,
559d72da-5a64-4e95-aca1-a5a5ca1b7dc4,2024-03-24,2024-03-26,Shell,5541,Transport,Fuel,-39.01,GBP,-5352.48,POS,London,GB,2219,user_002,,
a8433563-a33f-4d55-837d-31652f22973a,2024-03-24,2024-03-25,Uber UK,4121,Transport,Ride Hailing,-16.55,GBP,-5369.03,E-Com,London,GB,9074,user_002,,
f80aac80-535d-4159-af0e-84fe57e03a68,2024-03-24,2024-03-25,Waitrose,5411,Groceries,Supermarket,-27.43,GBP,-5396.46,POS,London,GB,1045,user_001,,
222e090a-412a-41fc-ae09-9cf1206b4de2,2024-03-25,2024-03-27,Shell,5541,Transport,Fuel,-65.98,GBP,-5462.44,POS,London,GB,2219,user_001,,
51d61b89-71db-4301-87ec-0a75a9da323e,2024-03-25,2024-03-27,Pret A Manger,5814,Food & Drink,Eating Out,-10.57,GBP,-5473.01,POS,London,GB,4488,user_001,,
82559579-b231-4d02-a1c3-710db71f16b7,2024-03-25,2024-03-25,Apple.com/bill,5734,Shopping,Electronics,-22.27,GBP,-5495.28,E-Com,Cupertino,US,4488,user_001,,
909582a1-7d0b-4ade-8949-13462754bce0,2024-03-25,2024-03-25,T212 Capital,6011,Income,Salary,3432.09,GBP,-2063.19,Credit,London,GB,1045,user_001,rec_2ff8f778d0,
4a49647f-2e06-4731-b4cb-3ca0a96b843f,2024-03-26,2024-03-27,Uber UK,4121,Transport,Ride Hailing,-14.56,GBP,-2077.75,E-Com,London,GB,2219,user_001,,
8405e6b2-05c5-403c-b2b5-ce501d8edde7,2024-03-26,2024-03-26,Shell,5541,Transport,Fuel,-78.42,GBP,-2156.17,POS,London,GB,2219,user_002,,
044ac7fd-819b-4d46-b4a2-29591173a17a,2024-03-27,2024-03-28,Sainsbury's,5411,Groceries,Supermarket,-57.19,GBP,-2213.36,POS,London,GB,4488,user_001,,
48696ec1-413d-40f0-b913-4afe19332812,2024-03-28,2024-04-01,Apple.com/bill,5734,Shopping,Electronics,-38.77,GBP,-2252.13,E-Com,Cupertino,US,4488,user_001,,
91ae1822-208d-41ec-9acd-8b5ba82a4c98,2024-03-28,2024-03-28,Waitrose,5411,Groceries,Supermarket,-40.83,GBP,-2292.96,POS,London,GB,2219,user_001,,
1a4a3123-3b4f-469d-b872-e7d9cdb38bd8,2024-03-29,2024-03-29,Deliveroo,5812,Food & Drink,Delivery,-16.2,GBP,-2309.16,E-Com,London,GB,4488,user_001,,
4209a273-34e0-4519-b6c0-2b30e44c54dd,2024-03-29,2024-04-01,Uber UK,4121,Transport,Ride Hailing,-25.85,GBP,-2335.01,E-Com,London,GB,9074,user_001,,
776fd58a-00d2-44a9-abce-29842f551111,2024-03-29,2024-04-01,Apple.com/bill,5734,Shopping,Electronics,-15.51,GBP,-2350.52,E-Com,Cupertino,US,9074,user_001,,
53d87705-3d3f-4631-b91f-781a7a63eca0,2024-03-30,2024-04-01,Deliveroo,5812,Food & Drink,Delivery,-19.98,GBP,-2370.5,E-Com,London,GB,9074,user_001,,
6766ab9f-f17e-458a-af2d-1be0d861b838,2024-03-30,2024-04-01,Pret A Manger,5814,Food & Drink,Eating Out,-8.35,GBP,-2378.85,POS,London,GB,9074,user_001,,
6a9d4506-2883-4823-a931-3ee372a80dcb,2024-03-30,2024-04-01,Waitrose,5411,Groceries,Supermarket,-77.68,GBP,-2456.53,POS,London,GB,2219,user_001,,
f49803b3-a470-4f33-a0f4-d67e684b346a,2024-03-30,2024-04-01,Shell,5541,Transport,Fuel,-34.1,GBP,-2490.63,POS,London,GB,4488,user_001,,
12f378e1-c35a-4845-b00f-3d28f14a665f,2024-03-31,2024-04-02,Pret A Manger,5814,Food & Drink,Eating Out,-10.24,GBP,-2500.87,POS,London,GB,1045,user_001,,
51861fa3-e8bb-43c4-99b2-f7bc04dfead4,2024-03-31,2024-04-01,Shell,5541,Transport,Fuel,-61.26,GBP,-2562.13,POS,London,GB,2219,user_001,,
6e6306e0-0dc0-4eba-a3a4-bec243bb319e,2024-03-31,2024-04-01,Amazon UK,5942,Shopping,Online Retail,-71.04,GBP,-2633.17,E-Com,London,GB,4488,user_001,,
88ef9976-e34e-448f-a67c-d1f49e19d8a0,2024-03-31,2024-04-02,Sainsbury's,5411,Groceries,Supermarket,-23.21,GBP,-2656.38,POS,London,GB,9074,user_001,,
b678a216-a102-4fe5-be81-95164f29d9da,2024-03-31,2024-04-02,Amazon UK,5942,Shopping,Online Retail,-9.63,GBP,-2666.01,E-Com,London,GB,1045,user_001,,
edc34b14-d0b1-4364-8894-ca50ad3bf772,2024-03-31,2024-04-01,Tesco,5411,Groceries,Supermarket,-73.81,GBP,-2739.82,POS,London,GB,2219,user_001,,
f6c6586d-5995-4454-9f2b-ab98915ea10f,2024-03-31,2024-04-01,Waitrose,5411,Groceries,Supermarket,-35.11,GBP,-2774.93,POS,London,GB,9074,user_001,,
28b67d54-8d9c-4f58-b7bb-809e92a6b6fe,2024-04-01,2024-04-03,ATM Withdrawal,6011,Cash,ATM,-68.93,GBP,-2843.86,ATM,London,GB,9074,user_002,,
a0e7055d-93cf-4fa8-9a09-367f25a883bf,2024-04-01,2024-04-01,Crown Estates Lettings,6513,Housing,Rent,-1529.38,GBP,-4373.24,POS,London,GB,9074,user_001,rec_19f70fbcce,
99bbce2a-a605-49ed-a397-62a9d1f71440,2024-04-02,2024-04-04,Deliveroo,5812,Food & Drink,Delivery,-21.2,GBP,-4394.44,E-Com,London,GB,9074,user_001,,
e42827b3-64e5-463a-a92c-26115be6bc83,2024-04-02,2024-04-04,Uber UK,4121,Transport,Ride Hailing,-26.91,GBP,-4421.35,E-Com,London,GB,9074,user_001,,
0c8aa8a6-5c3d-46d6-9309-43ffc1f54a32,2024-04-03,2024-04-04,Pret A Manger,5814,Food & Drink,Eating Out,-9.72,GBP,-4431.07,POS,London,GB,9074,user_001,,
7b0027fe-3d44-43eb-b6ce-3f3a37bf7784,2024-04-03,2024-04-05,Apple.com/bill,5734,Shopping,Electronics,-5.91,GBP,-4436.98,E-Com,Cupertino,US,1045,user_001,,
875a0d96-80e2-404e-bcd7-bf7f352ee4a0,2024-04-05,2024-04-08,Apple.com/bill,5734,Shopping,Electronics,-176.29,GBP,-4613.27,E-Com,Cupertino,US,2219,user_001,,
b5f9415c-a759-4d7c-80e7-152039e35f74,2024-04-05,2024-04-08,Pret A Manger,5814,Food & Drink,Eating Out,-8.51,GBP,-4621.78,POS,London,GB,1045,user_001,,
36d9c0bf-9d07-465f-9835-2fda34778480,2024-04-06,2024-04-08,Amazon UK,5942,Shopping,Online Retail,-43.69,GBP,-4665.47,E-Com,London,GB,9074,user_001,,
b73367c8-8399-471e-8a95-311d37edb888,2024-04-06,2024-04-08,Uber UK,4121,Transport,Ride Hailing,-15.42,GBP,-4680.89,E-Com,London,GB,1045,user_001,,
0bb8c54a-8e89-4c10-bc83-ad432692e5f5,2024-04-07,2024-04-08,Shell,5541,Transport,Fuel,-32.07,GBP,-4712.96,POS,London,GB,1045,user_001,,
65db291f-cbca-4760-bfed-3084812afd46,2024-04-07,2024-04-08,HM Revenue & Customs,9311,Income,Tax Refund,8.42,GBP,-4704.54,Credit,London,GB,1045,user_001,,Refund for Amazon UK
6b9877a9-7236-48f2-9690-ed967ac4d01e,2024-04-07,2024-04-09,Apple.com/bill,5734,Shopping,Electronics,-50.93,USD,-4755.47,E-Com,Cupertino,US,2219,user_001,,FX purchase 62.41 USD @ rate 1.23
993c8650-a480-4d17-9c99-e2e9944a11e4,2024-04-07,2024-04-09,Pret A Manger,5814,Food & Drink,Eating Out,-8.16,GBP,-4763.63,POS,London,GB,4488,user_001,,
9f20ebf1-5551-4031-b7f2-6ae756aa8cdf,2024-04-07,2024-04-08,Sainsbury's,5411,Groceries,Supermarket,-36.07,GBP,-4799.7,POS,London,GB,9074,user_002,,
a83f8103-e09f-49fb-a994-c37f411e045e,2024-04-07,2024-04-08,Tesco,5411,Groceries,Supermarket,-39.81,GBP,-4839.51,POS,London,GB,1045,user_001,,
383a1716-a94e-4b33-bbcd-28ded267090e,2024-04-08,2024-04-10,Waitrose,5411,Groceries,Supermarket,-86.0,GBP,-4925.51,POS,London,GB,4488,user_001,,
91354520-b562-4ad6-96fe-36946a4e3509,2024-04-08,2024-04-10,Octopus Energy,4900,Utilities,Electricity,-114.51,GBP,-5040.02,Direct Debit,London,GB,9074,user_001,rec_141a4a0666,
b86b4cfd-5fb0-4c2f-9a1d-e537352d27c2,2024-04-08,2024-04-08,Pret A Manger,5814,Food & Drink,Eating Out,-5.78,GBP,-5045.8,POS,London,GB,2219,user_001,,
dbc4a91d-f2ed-4feb-85e4-931a7dd49457,2024-04-08,2024-04-08,Waitrose,5411,Groceries,Supermarket,-59.68,GBP,-5105.48,POS,London,GB,1045,user_001,,
dc92d221-8f39-419e-b64b-da1d49730e5a,2024-04-08,2024-04-08,Shell,5541,Transport,Fuel,-85.07,GBP,-5190.55,POS,London,GB,2219,user_002,,
46249ae4-a0d0-44ed-a5a7-2f02628ea5d5,2024-04-09,2024-04-09,Waitrose,5411,Groceries,Supermarket,-77.48,GBP,-5268.03,POS,London,GB,1045,user_001,,
970fddc6-23b2-427d-915e-96097460e147,2024-04-10,2024-04-12,Amazon UK,5942,Shopping,Online Retail,-48.96,GBP,-5316.99,E-Com,London,GB,2219,user_001,,
d17b2394-9719-4ed0-983c-f2f1e372e981,2024-04-10,2024-04-10,Deliveroo,5812,Food & Drink,Delivery,-33.23,GBP,-5350.22,E-Com,London,GB,2219,user_001,,
dfecb94a-ad01-4a65-918f-fc2c57865e0d,2024-04-10,2024-04-12,Sainsbury's,5411,Groceries,Supermarket,-35.51,GBP,-5385.73,POS,London,GB,9074,user_001,,
9eb53d01-0513-4df9-b567-e698c81400b6,2024-04-11,2024-04-15,Tesco,5411,Groceries,Supermarket,-72.05,GBP,-5457.78,POS,London,GB,1045,user_002,,
b0251b5a-8204-432c-9601-af0f2682f389,2024-04-11,2024-04-11,Thames Water,4900,Utilities,Water,-35.48,GBP,-5493.26,Direct Debit,Reading,GB,9074,user_001,rec_3a34d62842,
07225e70-6d71-45a6-89f9-3cb8f8d09022,2024-04-12,2024-04-15,Shell,5541,Transport,Fuel,-43.91,GBP,-5537.17,POS,London,GB,9074,user_001,,
04b6c135-b0f3-48d5-9d04-d999ce43ebe4,2024-04-13,2024-04-15,Local Market,5499,Groceries,Specialty,-9.96,GBP,-5547.13,POS,London,GB,4488,user_001,,
1e91205d-bb49-42b6-91d4-28078debf4fc,2024-04-13,2024-04-15,Airline Refund,4511,Travel,Refund,21.04,GBP,-5526.09,Credit,London,GB,1045,user_001,,Refund for Uber UK
056673f7-b391-4800-b0ed-970945a36836,2024-04-14,2024-04-15,Transport for London,4111,Transport,Transit,-4.44,GBP,-5530.53,POS,London,GB,9074,user_002,,
15974802-4ae8-44d3-a133-99863af7bc89,2024-04-14,2024-04-15,Apple.com/bill,5734,Shopping,Electronics,-27.26,USD,-5557.79,E-Com,Cupertino,US,2219,user_001,,FX purchase 34.27 USD @ rate 1.26
2bdafa77-aa2a-41cc-b0a1-84e5728e3d0b,2024-04-14,2024-04-15,Local Market,5499,Groceries,Specialty,-18.88,GBP,-5576.67,POS,London,GB,2219,user_001,,
6f22e10e-37fe-4288-af81-8b05ec6d259b,2024-04-14,2024-04-16,Pret A Manger,5814,Food & Drink,Eating Out,-9.66,GBP,-5586.33,POS,London,GB,4488,user_001,,
06a1e45a-5a66-4b52-9614-026971a198d0,2024-04-15,2024-04-15,Tesco,5411,Groceries,Supermarket,-70.61,GBP,-5656.94,POS,London,GB,2219,user_002,,
0770ecf7-fd38-41af-82a2-1accfe34103f,2024-04-15,2024-04-16,City Council Tax,9399,Utilities,Council Tax,-176.2,GBP,-5833.14,Direct Debit,London,GB,4488,user_001,rec_f531495db5,
5ec93f5c-052e-4331-acc6-ddc08678c693,2024-04-15,2024-04-17,Uber UK,4121,Transport,Ride Hailing,-23.91,GBP,-5857.05,E-Com,London,GB,2219,user_001,,
a5aa3961-0c5a-401b-9ff7-c675807efbc3,2024-04-15,2024-04-15,Transport for London,4111,Transport,Transit,-5.47,GBP,-5862.52,POS,London,GB,4488,user_001,,
c1674f74-c3f1-4511-8121-d71889e836f2,2024-04-15,2024-04-17,O2 UK,4814,Bills,Mobile,-49.69,GBP,-5912.21,Direct Debit,Slough,GB,4488,user_001,rec_95042d8101,
7e97abc2-afbe-436c-bee8-c9d0beeb360f,2024-04-16,2024-04-17,Shell,5541,Transport,Fuel,-62.42,GBP,-5974.63,POS,London,GB,4488,user_001,,
bcf05612-d90c-4eaf-9803-97ad00d63716,2024-04-16,2024-04-18,Transport for London,4111,Transport,Transit,-5.77,GBP,-5980.4,POS,London,GB,2219,user_001,,
27e665a8-1089-4184-b65c-ad45918d8c84,2024-04-17,2024-04-18,GymBox,7997,Wellness,Gym,-50.45,GBP,-6030.85,Direct Debit,London,GB,2219,user_001,rec_3906953fd2,
e1d9d0b3-36db-45a4-adf8-b138d41b319a,2024-04-17,2024-04-18,Waitrose,5411,Groceries,Supermarket,-72.0,GBP,-6102.85,POS,London,GB,1045,user_002,,
366f23a8-b799-4a40-8852-c5529bc8dfbe,2024-04-18,2024-04-19,Sainsbury's,5411,Groceries,Supermarket,-63.28,GBP,-6166.13,POS,London,GB,4488,user_002,,
5fd4c3e5-3d85-4633-9d7e-ac7a7f6b354f,2024-04-18,2024-04-18,Amazon UK,5942,Shopping,Online Retail,-51.86,GBP,-6217.99,E-Com,London,GB,9074,user_001,,
6209c4a7-f244-474a-b705-8b420ad50b7d,2024-04-18,2024-04-19,Local Market,5499,Groceries,Specialty,-19.19,GBP,-6237.18,POS,London,GB,9074,user_001,,
b694af76-6431-437b-ba47-76c0160dd6bd,2024-04-18,2024-04-18,Uber UK,4121,Transport,Ride Hailing,-9.85,GBP,-6247.03,E-Com,London,GB,2219,user_001,,
f2769a3e-5233-441f-a94c-9b4db08053ad,2024-04-18,2024-04-18,Waitrose,5411,Groceries,Supermarket,-38.9,GBP,-6285.93,POS,London,GB,4488,user_002,,
5ed5deb1-5055-4c6f-81a9-3393d4bde309,2024-04-19,2024-04-19,Spotify,5735,Entertainment,Subscriptions,-8.52,GBP,-6294.45,E-Com,Stockholm,SE,2219,user_001,rec_4c746d2c3b,
388d8e5d-fb1f-497e-8ce0-08480e721b3b,2024-04-20,2024-04-22,Uber UK,4121,Transport,Ride Hailing,-20.47,GBP,-6314.92,E-Com,London,GB,4488,user_001,,
87dbd41f-0875-45c1-9dae-e744e385cebd,2024-04-20,2024-04-22,Local Market,5499,Groceries,Specialty,-13.95,GBP,-6328.87,POS,London,GB,4488,user_001,,
b7f687e9-7676-46d8-ad39-bede59ed78bd,2024-04-20,2024-04-22,Sainsbury's,5411,Groceries,Supermarket,-28.55,GBP,-6357.42,POS,London,GB,4488,user_001,,
329b4d6b-bb03-43cc-b017-4c2a1fa7d348,2024-04-21,2024-04-22,Transport for London,4111,Transport,Transit,-11.13,GBP,-6368.55,POS,London,GB,1045,user_001,,
c093c2a6-9de3-471b-bb8e-aaf988626264,2024-04-21,2024-04-23,Sainsbury's,5411,Groceries,Supermarket,-40.34,GBP,-6408.89,POS,London,GB,9074,user_001,,
145efe3c-9318-47e3-b412-602d96cc9a28,2024-04-22,2024-04-24,Transport for London,4111,Transport,Transit,-10.56,GBP,-6419.45,POS,London,GB,2219,user_001,,
49c733da-43ad-4271-b76e-411f7b6934c0,2024-04-22,2024-04-23,Local Market,5499,Groceries,Specialty,-12.13,GBP,-6431.58,POS,London,GB,1045,user_001,,
6f6b3575-3e0c-46ba-9511-ae6fce7d6090,2024-04-22,2024-04-22,Amazon UK,5942,Shopping,Online Retail,-63.68,GBP,-6495.26,E-Com,London,GB,2219,user_002,,
e0db00a0-eb43-414b-96fb-3a4b3b5f9989,2024-04-22,2024-04-23,Netflix,7841,Entertainment,Subscriptions,-11.2,GBP,-6506.46,E-Com,Los Gatos,US,4488,user_002,rec_d9322c1382,
ec4de9ba-e145-4b93-ae44-07e0ceabfdb3,2024-04-22,2024-04-24,Shell,5541,Transport,Fuel,-31.55,GBP,-6538.01,POS,London,GB,2219,user_001,,
98935fc8-2dab-4776-9a87-6ba293d2ed25,2024-04-23,2024-04-24,Transport for London,4111,Transport,Transit,-4.29,GBP,-6542.3,POS,London,GB,9074,user_001,,
bfc72e07-2a4f-49ed-9a82-9439e3623298,2024-04-23,2024-04-23,Amazon UK,5942,Shopping,Online Retail,-108.99,GBP,-6651.29,E-Com,London,GB,2219,user_001,,
26d4416b-0ba3-4903-8c05-0ce1e80e3aff,2024-04-24,2024-04-24,Amazon UK,5942,Shopping,Online Retail,-93.95,GBP,-6745.24,E-Com,London,GB,2219,user_001,,
cdb75913-6635-46b7-80ce-18227f5dc7a4,2024-04-24,2024-04-26,Amazon UK,5942,Shopping,Online Retail,-76.09,GBP,-6821.33,E-Com,London,GB,2219,user_001,,
e4d57335-9451-41f2-9b5c-fd663df240a4,2024-04-24,2024-04-25,Deliveroo,5812,Food & Drink,Delivery,-23.22,GBP,-6844.55,E-Com,London,GB,9074,user_001,,
971a7724-9335-4807-81fa-1b3e59b4b5fa,2024-04-25,2024-04-25,ATM Withdrawal,6011,Cash,ATM,-119.32,GBP,-6963.87,ATM,London,GB,4488,user_001,,
c84e7d5b-be25-4441-b061-bf901a860142,2024-04-25,2024-04-25,T212 Capital,6011,Income,Salary,2944.28,GBP,-4019.59,Credit,London,GB,4488,user_001,rec_2ff8f778d0,
112870a9-9f13-406b-a15b-e4bb41960005,2024-04-26,2024-04-29,Sainsbury's,5411,Groceries,Supermarket,-56.92,GBP,-4076.51,POS,London,GB,4488,user_001,,
a3ef54ac-07dc-4428-9d0e-4150ba05d1af,2024-04-26,2024-04-26,Apple.com/bill,5734,Shopping,Electronics,-4.96,GBP,-4081.47,E-Com,Cupertino,US,9074,user_001,,
a4decea9-5e3a-4ca5-a48e-6228082c4716,2024-04-26,2024-04-26,Deliveroo,5812,Food & Drink,Delivery,-21.39,GBP,-4102.86,E-Com,London,GB,1045,user_001,,
f1ad6198-045d-4500-a61c-6f40c0e435c9,2024-04-26,2024-04-26,Sainsbury's,5411,Groceries,Supermarket,-32.11,GBP,-4134.97,POS,London,GB,2219,user_002,,
080f0e36-f315-4bfd-8e6c-0456b011a658,2024-04-27,2024-04-29,Pret A Manger,5814,Food & Drink,Eating Out,-5.76,GBP,-4140.73,POS,London,GB,1045,user_002,,
2e9e4e81-0834-421b-9610-88cdc02afba6,2024-04-27,2024-04-29,Deliveroo,5812,Food & Drink,Delivery,-21.86,GBP,-4162.59,E-Com,London,GB,9074,user_001,,
d6562535-0d5c-4383-9466-89858c91af40,2024-04-27,2024-04-29,Local Market,5499,Groceries,Specialty,-11.93,GBP,-4174.52,POS,London,GB,4488,user_001,,
29204bc7-6d08-4ee6-8ede-c80b7b9c3168,2024-04-28,2024-04-30,Apple.com/bill,5734,Shopping,Electronics,-101.31,GBP,-4275.83,E-Com,Cupertino,US,4488,user_002,,
5aa28280-55d9-46e2-9435-e51039d9c261,2024-04-28,2024-04-29,Transport for London,4111,Transport,Transit,-11.8,GBP,-4287.63,POS,London,GB,1045,user_001,,
5f3bee5a-e2d1-422d-9068-fc26986374db,2024-04-28,2024-04-29,Transport for London,4111,Transport,Transit,-3.71,GBP,-4291.34,POS,London,GB,4488,user_001,,
71156651-53e2-49b0-9d21-e3385060e255,2024-04-28,2024-04-30,Local Market,5499,Groceries,Specialty,-8.02,GBP,-4299.36,POS,London,GB,1045,user_001,,
e6aa803c-156a-4d93-b252-355b785a7593,2024-04-28,2024-04-30,Transport for London,4111,Transport,Transit,-9.81,GBP,-4309.17,POS,London,GB,2219,user_002,,
f61f287f-5311-4e00-8db4-427836539fdb,2024-04-28,2024-04-29,Transport for London,4111,Transport,Transit,-9.75,GBP,-4318.92,POS,London,GB,4488,user_001,,
a9ec68f6-117d-4cb2-aeb0-6a0ef7a56251,2024-04-29,2024-04-30,Pret A Manger,5814,Food & Drink,Eating Out,-7.75,GBP,-4326.67,POS,London,GB,2219,user_001,,
c623cb5f-965f-4826-8815-6c2630db0ecb,2024-04-29,2024-05-01,Apple.com/bill,5734,Shopping,Electronics,-98.24,USD,-4424.91,E-Com,Cupertino,US,4488,user_001,,FX purchase 121.45 USD @ rate 1.24
65d7b0d4-7cac-49e5-9cde-0c60df64bca8,2024-04-30,2024-05-02,Tesco,5411,Groceries,Supermarket,-43.85,GBP,-4468.76,POS,London,GB,4488,user_002,,
a9dfe7b7-8349-4380-b83c-80bc8fd6385e,2024-04-30,2024-04-30,Amazon UK,5942,Shopping,Online Retail,-62.11,GBP,-4530.87,E-Com,London,GB,2219,user_002,,
9ef06f5d-eab6-4e09-a488-08f0ed7d86d5,2024-05-01,2024-05-01,Crown Estates Lettings,6513,Housing,Rent,-1604.7,GBP,-6135.57,POS,London,GB,2219,user_002,rec_fc2ae06846,
dbb021ce-53f2-4b39-a31e-69e65501368b,2024-05-01,2024-05-03,Uber UK,4121,Transport,Ride Hailing,-35.62,GBP,-6171.19,E-Com,London,GB,2219,user_001,,
46468611-85c1-4b38-b8b3-b1280a0305ab,2024-05-02,2024-05-06,Deliveroo,5812,Food & Drink,Delivery,-20.9,GBP,-6192.09,E-Com,London,GB,2219,user_001,,
855600f4-6df2-4a52-bfae-12029964e3be,2024-05-02,2024-05-06,Apple.com/bill,5734,Shopping,Electronics,-63.04,GBP,-6255.13,E-Com,Cupertino,US,4488,user_001,,
10b5ee2e-65e5-4e05-a91b-3201f58631aa,2024-05-03,2024-05-06,Shell,5541,Transport,Fuel,-75.72,GBP,-6330.85,POS,London,GB,2219,user_002,,
60b8b760-6b61-4fc3-922c-68709c9aeb10,2024-05-03,2024-05-06,Tesco,5411,Groceries,Supermarket,-25.4,GBP,-6356.25,POS,London,GB,4488,user_001,,
838f1615-cbbc-4a7a-b6e7-2956efcc009f,2024-05-03,2024-05-03,Uber UK,4121,Transport,Ride Hailing,-13.37,GBP,-6369.62,E-Com,London,GB,9074,user_002,,
84847c12-4e4d-4f0b-9dfd-7c151633d988,2024-05-03,2024-05-06,Local Market,5499,Groceries,Specialty,-17.97,GBP,-6387.59,POS,London,GB,9074,user_001,,
a34ae349-d542-4f12-9255-7dfbd6c1e36f,2024-05-03,2024-05-06,Apple.com/bill,5734,Shopping,Electronics,-58.42,USD,-6446.01,E-Com,Cupertino,US,1045,user_002,,FX purchase 71.96 USD @ rate 1.23
5eaec5c7-7a77-4389-b70d-5b8f08418d9c,2024-05-04,2024-05-06,Sainsbury's,5411,Groceries,Supermarket,-41.66,GBP,-6487.67,POS,London,GB,1045,user_001,,
93857720-288d-4957-982d-16a3bbeab6ce,2024-05-04,2024-05-06,Sainsbury's,5411,Groceries,Supermarket,-19.06,GBP,-6506.73,POS,London,GB,9074,user_001,,
a0000d70-1985-4661-8e20-adf8db6245f1,2024-05-04,2024-05-06,Apple.com/bill,5734,Shopping,Electronics,-143.53,GBP,-6650.26,E-Com,Cupertino,US,1045,user_002,,
b0da6c78-fa4a-4338-bcca-4f1910b6927f,2024-05-05,2024-05-06,Pret A Manger,5814,Food & Drink,Eating Out,-6.18,GBP,-6656.44,POS,London,GB,9074,user_001,,
dfd9846c-47f0-418d-ab0c-dda20d29f556,2024-05-05,2024-05-06,Deliveroo,5812,Food & Drink,Delivery,-28.16,GBP,-6684.6,E-Com,London,GB,1045,user_001,,
18f836d2-2ab6-4002-8d56-6243091f1f50,2024-05-06,2024-05-06,Deliveroo,5812,Food & Drink,Delivery,-26.31,GBP,-6710.91,E-Com,London,GB,1045,user_001,,
f5d24ca4-266e-40eb-8553-4ddfe4ed67a0,2024-05-06,2024-05-07,Local Market,5499,Groceries,Specialty,-8.72,GBP,-6719.63,POS,London,GB,9074,user_001,,
c600ae27-5ec0-4896-83ff-5cdc4536e41a,2024-05-07,2024-05-07,Octopus Energy,4900,Utilities,Electricity,-142.9,GBP,-6862.53,Direct Debit,London,GB,4488,user_002,rec_09c3f12b18,
0b65ee82-606f-479d-b860-979c2fcbe910,2024-05-08,2024-05-08,Transport for London,4111,Transport,Transit,-9.04,GBP,-6871.57,POS,London,GB,4488,user_001,,
ab1e59ed-f209-47f6-8048-9fd383539c70,2024-05-08,2024-05-09,Uber UK,4121,Transport,Ride Hailing,-35.5,GBP,-6907.07,E-Com,London,GB,4488,user_002,,
18c6c3d8-1e2d-45c1-abb0-aba8b475f2e6,2024-05-09,2024-05-09,Tesco,5411,Groceries,Supermarket,-73.97,GBP,-6981.04,POS,London,GB,9074,user_001,,
24578e2e-4532-48e2-b249-9fc2e15bcec4,2024-05-09,2024-05-10,Sainsbury's,5411,Groceries,Supermarket,-62.91,GBP,-7043.95,POS,London,GB,1045,user_001,,
87482cbc-cc1b-4a63-816c-51bce91e9040,2024-05-09,2024-05-13,Uber UK,4121,Transport,Ride Hailing,-9.21,GBP,-7053.16,E-Com,London,GB,9074,user_001,,
ddc8a087-c2dd-4f3f-9a1a-482c38a88db0,2024-05-09,2024-05-09,British Airways,4511,Travel,Flights,-212.47,EUR,-7265.63,E-Com,London,GB,1045,user_001,,Holiday booking
3e0d0b05-5838-4821-aa0f-b24b2cf26565,2024-05-10,2024-05-13,Apple.com/bill,5734,Shopping,Electronics,-79.58,USD,-7345.21,E-Com,Cupertino,US,9074,user_001,,FX purchase 98.08 USD @ rate 1.23
a23df285-3717-44ca-9135-bbf4d494e311,2024-05-10,2024-05-10,Amazon UK,5942,Shopping,Online Retail,-38.86,GBP,-7384.07,E-Com,London,GB,1045,user_002,,
f802ee6d-fb2f-4331-83c3-dad74decb05a,2024-05-10,2024-05-13,Local Market,5499,Groceries,Specialty,-16.93,GBP,-7401.0,POS,London,GB,9074,user_001,,
09a64149-855e-47c7-ac45-843d4153f77c,2024-05-11,2024-05-13,Local Market,5499,Groceries,Specialty,-19.62,GBP,-7420.62,POS,London,GB,9074,user_001,,
48ca8f53-a8f4-4261-93e0-fd131927aa72,2024-05-11,2024-05-13,Pret A Manger,5814,Food & Drink,Eating Out,-7.89,GBP,-7428.51,POS,London,GB,2219,user_002,,
514c4076-a3c2-4f91-86c7-4c47ea364b5b,2024-05-11,2024-05-13,Waitrose,5411,Groceries,Supermarket,-47.3,GBP,-7475.81,POS,London,GB,1045,user_001,,
616c6933-1cab-4eeb-90a2-3d98601f129d,2024-05-11,2024-05-13,Amazon UK,5942,Shopping,Online Retail,-112.97,GBP,-7588.78,E-Com,London,GB,9074,user_001,,
7377822f-64f1-4e27-8d95-fba72b64ae3c,2024-05-11,2024-05-13,Waitrose,5411,Groceries,Supermarket,-68.72,GBP,-7657.5,POS,London,GB,4488,user_002,,
a563499a-26bf-4543-b48a-475e7f8adede,2024-05-11,2024-05-13,Transport for London,4111,Transport,Transit,-11.14,GBP,-7668.64,POS,London,GB,9074,user_001,,
bd3f4344-34e8-4fae-9efc-93427d25456a,2024-05-11,2024-05-13,Amazon UK,5942,Shopping,Online Retail,-33.56,GBP,-7702.2,E-Com,London,GB,4488,user_001,,
54eff31e-6616-43c3-a823-4ed5ee79fea5,2024-05-12,2024-05-14,Amazon UK,5942,Shopping,Online Retail,-108.07,GBP,-7810.27,E-Com,London,GB,4488,user_001,,
65ab0e9c-fddb-45cc-aa95-1236e4a749ce,2024-05-12,2024-05-14,Apple.com/bill,5734,Shopping,Electronics,-34.43,GBP,-7844.7,E-Com,Cupertino,US,1045,user_001,,
8b9758fc-4dce-4068-8b40-c6d5ca5f2b90,2024-05-12,2024-05-13,Sainsbury's,5411,Groceries,Supermarket,-49.94,GBP,-7894.64,POS,London,GB,9074,user_001,,
28e36fc0-8419-4d29-8121-ce263cc0a7be,2024-05-13,2024-05-13,Waitrose,5411,Groceries,Supermarket,-73.16,GBP,-7967.8,POS,London,GB,2219,user_002,,
414eba07-7852-4d31-96f4-26c8ff15cd4f,2024-05-13,2024-05-14,Apple.com/bill,5734,Shopping,Electronics,-8.62,USD,-7976.42,E-Com,Cupertino,US,2219,user_001,,FX purchase 11.33 USD @ rate 1.31
4b5fc8ce-4646-4052-87d8-4361c0075294,2024-05-13,2024-05-13,Pret A Manger,5814,Food & Drink,Eating Out,-11.48,GBP,-7987.9,POS,London,GB,4488,user_002,,
69d16289-2d2f-4021-808c-bb81525ab3ed,2024-05-13,2024-05-14,Thames Water,4900,Utilities,Water,-41.13,GBP,-8029.03,Direct Debit,Reading,GB,2219,user_002,rec_954d02400c,
9a6f18ae-f35c-4dce-92bf-cf1714aa94aa,2024-05-13,2024-05-14,Apple.com/bill,5734,Shopping,Electronics,-41.69,GBP,-8070.72,E-Com,Cupertino,US,4488,user_001,,
ac761929-fbd2-4cad-b0e0-acc5d8c07cf9,2024-05-13,2024-05-13,City Council Tax,9399,Utilities,Council Tax,-184.61,GBP,-8255.33,Direct Debit,London,GB,2219,user_002,rec_6feaa5d43f,
3fb7cfb4-211e-453b-a427-179b1b5c08d8,2024-05-14,2024-05-15,Apple.com/bill,5734,Shopping,Electronics,-184.91,USD,-8440.24,E-Com,Cupertino,US,2219,user_002,,FX purchase 228.04 USD @ rate 1.23
4328c492-dea6-44ac-8f04-9f47b31870ba,2024-05-15,2024-05-17,O2 UK,4814,Bills,Mobile,-38.68,GBP,-8478.92,Direct Debit,Slough,GB,1045,user_001,rec_95042d8101,
4f68ff81-87d7-4264-80d0-a811ff1ad248,2024-05-15,2024-05-16,Transport for London,4111,Transport,Transit,-7.81,GBP,-8486.73,POS,London,GB,2219,user_001,,
5c58f8a9-d331-4319-b3ab-289d66301934,2024-05-15,2024-05-17,Amazon UK,5942,Shopping,Online Retail,-99.11,GBP,-8585.84,E-Com,London,GB,2219,user_001,,
6c5dc0a8-1846-4b9b-b6ea-b3e1f58321d1,2024-05-16,2024-05-16,Deliveroo,5812,Food & Drink,Delivery,-33.15,GBP,-8618.99,E-Com,London,GB,4488,user_002,,
98d87a06-617f-4ddf-9f14-fede29b38805,2024-05-16,2024-05-16,HM Revenue & Customs,9311,Income,Tax Refund,23.59,GBP,-8595.4,Credit,London,GB,4488,user_001,,Refund for Uber UK
e1fdaa33-921a-41cd-b65a-c7df1de0966c,2024-05-16,2024-05-20,Transport for London,4111,Transport,Transit,-5.73,GBP,-8601.13,POS,London,GB,2219,user_001,,
ff98b271-8d1f-489f-8afb-aaab460d43ff,2024-05-16,2024-05-16,Amazon UK,5942,Shopping,Online Retail,-109.43,GBP,-8710.56,E-Com,London,GB,1045,user_001,,
0698a907-5f7c-4da0-8d90-25269af3f16d,2024-05-17,2024-05-17,Transport for London,4111,Transport,Transit,-11.08,GBP,-8721.64,POS,London,GB,4488,user_002,,
08022bc6-8dc9-4f59-ad7d-870544130ce5,2024-05-17,2024-05-17,GymBox,7997,Wellness,Gym,-46.97,GBP,-8768.61,Direct Debit,London,GB,2219,user_001,rec_3906953fd2,
f40370f1-57e0-494d-ac9b-d3a0b603c47b,2024-05-17,2024-05-17,Shell,5541,Transport,Fuel,-37.33,GBP,-8805.94,POS,London,GB,9074,user_001,,
1d2e5224-679b-4e0f-b006-aef4e8ac92ad,2024-05-18,2024-05-20,Shell,5541,Transport,Fuel,-87.48,GBP,-8893.42,POS,London,GB,1045,user_001,,
2812c962-19ee-4533-bf57-5c313989b86b,2024-05-18,2024-05-20,Deliveroo,5812,Food & Drink,Delivery,-17.82,GBP,-8911.24,E-Com,London,GB,4488,user_001,,
3b5072d5-65f2-421f-aa9d-5736105894e2,2024-05-18,2024-05-20,Apple.com/bill,5734,Shopping,Electronics,-55.35,GBP,-8966.59,E-Com,Cupertino,US,1045,user_001,,
8265b9e7-9eb7-4ce0-a5c1-74edc54fd1da,2024-05-18,2024-05-20,Deliveroo,5812,Food & Drink,Delivery,-23.42,GBP,-8990.01,E-Com,London,GB,9074,user_001,,
938749d7-6326-417d-8915-f8e9e3e31f1b,2024-05-19,2024-05-21,Sainsbury's,5411,Groceries,Supermarket,-44.88,GBP,-9034.89,POS,London,GB,1045,user_002,,
a73d6c4f-57f9-4f83-8fca-268d9d369675,2024-05-19,2024-05-20,Shell,5541,Transport,Fuel,-69.62,GBP,-9104.51,POS,London,GB,9074,user_001,,
b2e43d6c-cf73-4699-9429-f7662a467180,2024-05-19,2024-05-20,Pret A Manger,5814,Food & Drink,Eating Out,-9.77,GBP,-9114.28,POS,London,GB,1045,user_001,,
c03d476a-fd99-430b-84b7-3cd1d9b83a16,2024-05-19,2024-05-20,Amazon UK,5942,Shopping,Online Retail,-111.27,GBP,-9225.55,E-Com,London,GB,9074,user_001,,
e19c04bc-b80d-4dc3-a67d-44ffe49c7d3b,2024-05-19,2024-05-21,Pret A Manger,5814,Food & Drink,Eating Out,-11.07,GBP,-9236.62,POS,London,GB,4488,user_001,,
59d20ee8-8139-4402-9fdd-8cfea3dc5179,2024-05-20,2024-05-21,Spotify,5735,Entertainment,Subscriptions,-9.2,GBP,-9245.82,E-Com,Stockholm,SE,9074,user_001,rec_4c746d2c3b,
6a461b7b-6f9f-4d02-94e5-41ec0320cf1e,2024-05-21,2024-05-23,Netflix,7841,Entertainment,Subscriptions,-11.01,USD,-9256.83,E-Com,Los Gatos,US,9074,user_001,rec_1bfe33738d,FX purchase 13.42 USD @ rate 1.22
4bdadcda-4bfe-47c3-913d-d1b74b5a26f4,2024-05-22,2024-05-24,Local Market,5499,Groceries,Specialty,-16.03,GBP,-9272.86,POS,London,GB,2219,user_001,,
ec19e576-54a6-4ebb-a806-a3f254f1cb79,2024-05-22,2024-05-24,Tesco,5411,Groceries,Supermarket,-43.74,GBP,-9316.6,POS,London,GB,1045,user_002,,
05e71c27-f53a-4bd2-86d2-0c9b301ed2a4,2024-05-24,2024-05-27,Waitrose,5411,Groceries,Supermarket,-23.56,GBP,-9340.16,POS,London,GB,9074,user_001,,
1a76a9c0-18d9-4520-91a5-8016c73c0333,2024-05-24,2024-05-24,T212 Capital,6011,Income,Salary,3067.62,GBP,-6272.54,Credit,London,GB,4488,user_001,rec_2ff8f778d0,
9fb775ce-d60f-4984-902c-86a819168b77,2024-05-24,2024-05-27,Apple.com/bill,5734,Shopping,Electronics,-83.87,GBP,-6356.41,E-Com,Cupertino,US,4488,user_001,,
bac93f9b-9a84-4004-ba47-2a343df90b3f,2024-05-24,2024-05-27,Pret A Manger,5814,Food & Drink,Eating Out,-9.49,GBP,-6365.9,POS,London,GB,2219,user_001,,
d5ce057e-ceea-4d22-a275-f938df113388,2024-05-24,2024-05-24,Shell,5541,Transport,Fuel,-51.5,GBP,-6417.4,POS,London,GB,1045,user_002,,
1640ebbb-b6df-4fe1-a08d-f37997a142c6,2024-05-25,2024-05-27,Pret A Manger,5814,Food & Drink,Eating Out,-11.75,GBP,-6429.15,POS,London,GB,4488,user_001,,
95dd46c0-7bce-4179-a8d4-8a9947c36908,2024-05-25,2024-05-27,Pret A Manger,5814,Food & Drink,Eating Out,-8.41,GBP,-6437.56,POS,London,GB,1045,user_001,,
e2f7e2d5-cbd8-4741-a75e-bc64913b8db1,2024-05-25,2024-05-27,HM Revenue & Customs,9311,Income,Tax Refund,14.24,GBP,-6423.32,Credit,London,GB,9074,user_002,,Refund for Deliveroo
18ef7b99-9c08-43bd-8093-d626e5c9cf9c,2024-05-26,2024-05-27,Sainsbury's,5411,Groceries,Supermarket,-47.4,GBP,-6470.72,POS,London,GB,2219,user_002,,
aced1d7a-1c3c-4f75-ba30-227621227d22,2024-05-26,2024-05-27,Uber UK,4121,Transport,Ride Hailing,-8.46,GBP,-6479.18,E-Com,London,GB,4488,user_002,,
ef22a372-2272-4ee1-85f0-aced5bfb5050,2024-05-26,2024-05-28,Apple.com/bill,5734,Shopping,Electronics,-69.63,GBP,-6548.81,E-Com,Cupertino,US,9074,user_001,,
8762a897-a017-4584-9eb8-deee9ffb1d12,2024-05-27,2024-05-28,Deliveroo,5812,Food & Drink,Delivery,-24.88,GBP,-6573.69,E-Com,London,GB,2219,user_001,,
baeadee0-0d38-4530-853b-9df7344488f5,2024-05-27,2024-05-27,Waitrose,5411,Groceries,Supermarket,-56.76,GBP,-6630.45,POS,London,GB,9074,user_001,,
e929474f-6045-4d56-8786-7db4e3c5d55d,2024-05-27,2024-05-28,Sainsbury's,5411,Groceries,Supermarket,-20.83,GBP,-6651.28,POS,London,GB,1045,user_001,,
270a686e-d8dc-4f13-97ae-8cd5da58a753,2024-05-29,2024-05-31,Pret A Manger,5814,Food & Drink,Eating Out,-8.95,GBP,-6660.23,POS,London,GB,4488,user_001,,
a93915aa-1139-4ef9-a4ef-5fe6d2385d08,2024-05-29,2024-05-31,Waitrose,5411,Groceries,Supermarket,-68.47,GBP,-6728.7,POS,London,GB,4488,user_002,,
ba786b15-ffa0-42a8-b1d6-3699b17ca070,2024-05-29,2024-05-30,Deliveroo,5812,Food & Drink,Delivery,-18.02,GBP,-6746.72,E-Com,London,GB,1045,user_001,,
c36eff3e-ad42-4936-87e8-97c2a4e2cfbd,2024-05-29,2024-05-30,Uber UK,4121,Transport,Ride Hailing,-28.76,GBP,-6775.48,E-Com,London,GB,1045,user_001,,
3de6a7be-008e-4a10-b322-dfdcaa3ecc24,2024-05-30,2024-05-30,HM Revenue & Customs,9311,Income,Tax Refund,64.71,GBP,-6710.77,Credit,London,GB,4488,user_001,,Refund for Shell
9e50d09a-9c96-4aca-858b-4d0e54062eb7,2024-05-30,2024-05-31,Local Market,5499,Groceries,Specialty,-15.69,GBP,-6726.46,POS,London,GB,9074,user_001,,
f4ea71e9-e580-4cc7-8875-57696145e20a,2024-05-30,2024-05-30,Shell,5541,Transport,Fuel,-54.18,GBP,-6780.64,POS,London,GB,9074,user_001,,
16859c27-4c64-4d29-8a57-e141bdd9f6d3,2024-05-31,2024-05-31,Waitrose,5411,Groceries,Supermarket,-34.94,GBP,-6815.58,POS,London,GB,2219,user_001,,
14eb82b6-d921-4178-8adb-d2a3bd192a8f,2024-06-01,2024-06-03,Sainsbury's,5411,Groceries,Supermarket,-45.03,GBP,-6860.61,POS,London,GB,9074,user_001,,
61965265-6f46-4045-823b-30316c6f053d,2024-06-01,2024-06-03,Sainsbury's,5411,Groceries,Supermarket,-36.78,GBP,-6897.39,POS,London,GB,1045,user_001,,
d93b8a3d-4fcf-42a9-85ec-0e05e91113ce,2024-06-01,2024-06-03,Waitrose,5411,Groceries,Supermarket,-81.77,GBP,-6979.16,POS,London,GB,4488,user_001,,
2dd8d38f-3dcf-4667-90f2-179f50ac5cc2,2024-06-02,2024-06-03,Uber UK,4121,Transport,Ride Hailing,-29.52,GBP,-7008.68,E-Com,London,GB,4488,user_001,,
6f7a8ccb-4dfd-4df0-851b-8e3b5b64a53f,2024-06-02,2024-06-03,ATM Withdrawal,6011,Cash,ATM,-94.49,GBP,-7103.17,ATM,London,GB,4488,user_001,,
82b5a09f-4f45-4284-8598-53d55bf1fd70,2024-06-02,2024-06-04,Sainsbury's,5411,Groceries,Supermarket,-28.6,GBP,-7131.77,POS,London,GB,1045,user_001,,
b8149139-7e00-4465-b4bc-809f3bf3712a,2024-06-02,2024-06-03,Uber UK,4121,Transport,Ride Hailing,-22.89,GBP,-7154.66,E-Com,London,GB,9074,user_001,,
685b9f69-0c66-468f-aee7-a9ebe680d20c,2024-06-03,2024-06-03,Local Market,5499,Groceries,Specialty,-12.09,GBP,-7166.75,POS,London,GB,1045,user_001,,
6e087051-6eda-4f29-b04e-82557615b451,2024-06-03,2024-06-04,Crown Estates Lettings,6513,Housing,Rent,-1580.95,GBP,-8747.7,POS,London,GB,2219,user_001,rec_19f70fbcce,
a3b9a06c-4b1c-45e7-b292-e83a416c6bd8,2024-06-03,2024-06-05,Pret A Manger,5814,Food & Drink,Eating Out,-8.1,GBP,-8755.8,POS,London,GB,9074,user_001,,
ad83b546-8c38-429b-8c95-33de4846240e,2024-06-03,2024-06-04,Sainsbury's,5411,Groceries,Supermarket,-57.77,GBP,-8813.57,POS,London,GB,4488,user_001,,
b967913f-7783-4de1-b5a3-789f3bef3579,2024-06-03,2024-06-05,Pret A Manger,5814,Food & Drink,Eating Out,-9.47,GBP,-8823.04,POS,London,GB,2219,user_001,,
d35557ca-4e50-440a-9ed8-f3d374d41a46,2024-06-03,2024-06-03,Pret A Manger,5814,Food & Drink,Eating Out,-9.13,GBP,-8832.17,POS,London,GB,1045,user_001,,
31baf4b1-c17f-499b-830b-adcf2eab1a07,2024-06-04,2024-06-04,Deliveroo,5812,Food & Drink,Delivery,-19.64,GBP,-8851.81,E-Com,London,GB,1045,user_001,,
73802548-b3fd-4bb1-bfed-c1c687ea4161,2024-06-05,2024-06-05,HM Revenue & Customs,9311,Income,Tax Refund,7.9,GBP,-8843.91,Credit,London,GB,9074,user_001,,Refund for Pret A Manger
96d6df8b-ea04-4145-9278-310d0d704f10,2024-06-05,2024-06-06,Transport for London,4111,Transport,Transit,-11.12,GBP,-8855.03,POS,London,GB,2219,user_002,,
d4013f22-a58d-4013-a771-da9608a0bf74,2024-06-05,2024-06-07,Local Market,5499,Groceries,Specialty,-10.69,GBP,-8865.72,POS,London,GB,4488,user_001,,
05c09819-f3d1-4334-8a1a-f15fc3863580,2024-06-06,2024-06-06,Waitrose,5411,Groceries,Supermarket,-50.73,GBP,-8916.45,POS,London,GB,1045,user_002,,
1a7f2623-6514-48d1-b577-44213d23c0ab,2024-06-06,2024-06-07,Uber UK,4121,Transport,Ride Hailing,-29.49,GBP,-8945.94,E-Com,London,GB,1045,user_001,,
3ef9a624-311d-46a2-8393-bc6a657e6f6b,2024-06-06,2024-06-10,Uber UK,4121,Transport,Ride Hailing,-27.89,GBP,-8973.83,E-Com,London,GB,1045,user_001,,
3ebab5e0-a059-4d0a-b9c2-6d89b15b5eee,2024-06-07,2024-06-10,Apple.com/bill,5734,Shopping,Electronics,-116.51,GBP,-9090.34,E-Com,Cupertino,US,2219,user_001,,
467fdabc-f346-4b03-9a26-cafdf123e143,2024-06-07,2024-06-10,Apple.com/bill,5734,Shopping,Electronics,-21.66,USD,-9112.0,E-Com,Cupertino,US,1045,user_001,,FX purchase 26.41 USD @ rate 1.22
50d50ed7-ffac-4f55-98db-0ea4bd6572e6,2024-06-07,2024-06-07,Octopus Energy,4900,Utilities,Electricity,-141.87,GBP,-9253.87,Direct Debit,London,GB,4488,user_001,rec_141a4a0666,
8ef1f1d1-3a26-49c1-9708-eeaaeae173f3,2024-06-07,2024-06-10,ATM Withdrawal,6011,Cash,ATM,-114.97,GBP,-9368.84,ATM,London,GB,1045,user_001,,
b3b61a3d-88b5-455c-a3de-b7103735d4ef,2024-06-07,2024-06-10,Shell,5541,Transport,Fuel,-60.22,GBP,-9429.06,POS,London,GB,2219,user_001,,
cba20873-41bd-440b-b9b7-a3edfee1a9fb,2024-06-07,2024-06-07,Amazon UK,5942,Shopping,Online Retail,-53.57,GBP,-9482.63,E-Com,London,GB,1045,user_001,,
f67bbc01-089d-43f4-b1e6-12044bd21886,2024-06-07,2024-06-07,Apple.com/bill,5734,Shopping,Electronics,-117.22,GBP,-9599.85,E-Com,Cupertino,US,4488,user_002,,
39272152-64bc-47ed-be80-e736d0bbdfa6,2024-06-08,2024-06-10,Pret A Manger,5814,Food & Drink,Eating Out,-9.84,GBP,-9609.69,POS,London,GB,9074,user_001,,
9555c4ff-4659-4411-84e4-e76de61202b7,2024-06-08,2024-06-10,Amazon UK,5942,Shopping,Online Retail,-108.38,GBP,-9718.07,E-Com,London,GB,2219,user_001,,
a9eb70dd-e95f-4581-8396-92e4e65cfd84,2024-06-08,2024-06-10,Transport for London,4111,Transport,Transit,-10.42,GBP,-9728.49,POS,London,GB,1045,user_001,,
ca539aad-0860-4516-8897-8c93735d15e3,2024-06-08,2024-06-10,Local Market,5499,Groceries,Specialty,-7.95,GBP,-9736.44,POS,London,GB,9074,user_001,,
0aff4d72-e84d-435e-9c51-b522264f821c,2024-06-09,2024-06-10,Pret A Manger,5814,Food & Drink,Eating Out,-7.62,GBP,-9744.06,POS,London,GB,2219,user_001,,
8728f367-1735-4ae6-8d11-c9685b8cafec,2024-06-10,2024-06-10,Amazon UK,5942,Shopping,Online Retail,-99.37,GBP,-9843.43,E-Com,London,GB,1045,user_001,,
d628e8a0-f2de-453b-a148-f6706cc49078,2024-06-10,2024-06-10,Amazon UK,5942,Shopping,Online Retail,-10.14,GBP,-9853.57,E-Com,London,GB,9074,user_001,,
de2ed8ad-fbc3-43fb-8403-f1f34570f5d1,2024-06-10,2024-06-12,Pret A Manger,5814,Food & Drink,Eating Out,-11.49,GBP,-9865.06,POS,London,GB,4488,user_001,,
136ee1c1-123d-4b60-8bcf-e017aea32df9,2024-06-11,2024-06-12,Uber UK,4121,Transport,Ride Hailing,-14.75,GBP,-9879.81,E-Com,London,GB,2219,user_001,,
3bc7d47d-65e5-44f9-9291-d9b961987494,2024-06-11,2024-06-12,Thames Water,4900,Utilities,Water,-38.37,GBP,-9918.18,Direct Debit,Reading,GB,1045,user_001,rec_3a34d62842,
d38c6a6d-4d04-4228-a492-d36390afed57,2024-06-12,2024-06-13,Apple.com/bill,5734,Shopping,Electronics,-64.59,USD,-9982.77,E-Com,Cupertino,US,4488,user_002,,FX purchase 84.05 USD @ rate 1.30
31dafcee-91d4-4d6f-a023-8ed28bc99a16,2024-06-13,2024-06-17,Waitrose,5411,Groceries,Supermarket,-39.34,GBP,-10022.11,POS,London,GB,4488,user_001,,
6e61ea1b-bc66-4124-a3c2-996578d37eb4,2024-06-13,2024-06-17,Uber UK,4121,Transport,Ride Hailing,-21.84,GBP,-10043.95,E-Com,London,GB,9074,user_001,,
f38c2d65-2960-4f89-af99-d3d7e8132047,2024-06-13,2024-06-17,City Council Tax,9399,Utilities,Council Tax,-162.89,GBP,-10206.84,Direct Debit,London,GB,9074,user_002,rec_6feaa5d43f,
40040618-6223-4c8d-b935-354e3a021458,2024-06-14,2024-06-17,Apple.com/bill,5734,Shopping,Electronics,-60.29,USD,-10267.13,E-Com,Cupertino,US,9074,user_001,,FX purchase 75.26 USD @ rate 1.25
7deec045-b42f-4687-8603-409820b74cfb,2024-06-14,2024-06-14,Apple.com/bill,5734,Shopping,Electronics,-115.12,USD,-10382.25,E-Com,Cupertino,US,9074,user_001,,FX purchase 140.86 USD @ rate 1.22
85529c1e-5ed1-41ac-98c5-037b3d6672fd,2024-06-14,2024-06-17,Uber UK,4121,Transport,Ride Hailing,-29.46,GBP,-10411.71,E-Com,London,GB,1045,user_001,,
63c6a56c-9952-4320-ad01-10fafa3dea41,2024-06-15,2024-06-17,Uber UK,4121,Transport,Ride Hailing,-33.28,GBP,-10444.99,E-Com,London,GB,2219,user_001,,
aa8bca40-4330-4cfc-8ded-b17abb0e6b36,2024-06-15,2024-06-17,Sainsbury's,5411,Groceries,Supermarket,-64.99,GBP,-10509.98,POS,London,GB,4488,user_001,,
b1a3a792-da0b-42c0-8996-5957eaf901d4,2024-06-15,2024-06-17,Deliveroo,5812,Food & Drink,Delivery,-17.15,GBP,-10527.13,E-Com,London,GB,9074,user_001,,
e32483c2-f77a-492a-bb0f-c5cb3dcc9f7d,2024-06-15,2024-06-17,Amazon UK,5942,Shopping,Online Retail,-20.94,GBP,-10548.07,E-Com,London,GB,1045,user_002,,
37608b4e-40ef-4051-a22e-7f00031e9707,2024-06-16,2024-06-18,Local Market,5499,Groceries,Specialty,-13.38,GBP,-10561.45,POS,London,GB,4488,user_001,,
c9abd3ee-35ec-4c35-b6f1-8c0183e7e839,2024-06-16,2024-06-18,Transport for London,4111,Transport,Transit,-3.67,GBP,-10565.12,POS,London,GB,1045,user_001,,
d79033ee-d93b-425c-b17d-7b77cfdb331a,2024-06-16,2024-06-17,Shell,5541,Transport,Fuel,-47.89,GBP,-10613.01,POS,London,GB,1045,user_002,,
e2249c4d-4a3b-44b4-82fd-7dd2b3e61a6f,2024-06-16,2024-06-17,Apple.com/bill,5734,Shopping,Electronics,-187.39,GBP,-10800.4,E-Com,Cupertino,US,1045,user_001,,
2bae9b47-dc42-408f-bf7f-74fc675a52db,2024-06-17,2024-06-19,Amazon UK,5942,Shopping,Online Retail,-47.73,GBP,-10848.13,E-Com,London,GB,9074,user_001,,
3c4cc6c1-4984-499c-8cff-75aaa81ae1aa,2024-06-17,2024-06-17,O2 UK,4814,Bills,Mobile,-46.57,GBP,-10894.7,Direct Debit,Slough,GB,2219,user_001,rec_95042d8101,
8096970e-1c25-47b7-abe3-6611542fe11d,2024-06-17,2024-06-19,GymBox,7997,Wellness,Gym,-62.26,GBP,-10956.96,Direct Debit,London,GB,1045,user_001,rec_3906953fd2,
08e81655-adb1-422b-a1be-e5a53971f191,2024-06-18,2024-06-18,Tesco,5411,Groceries,Supermarket,-79.29,GBP,-11036.25,POS,London,GB,2219,user_001,,
a31c6709-e2bd-4224-bfde-3668f671f571,2024-06-18,2024-06-19,Local Market,5499,Groceries,Specialty,-15.65,GBP,-11051.9,POS,London,GB,1045,user_001,,
6b585c9f-b35d-45ac-91a6-d268f7da1b51,2024-06-19,2024-06-19,Spotify,5735,Entertainment,Subscriptions,-9.21,EUR,-11061.11,E-Com,Stockholm,SE,2219,user_001,rec_4c746d2c3b,FX purchase 10.65 EUR @ rate 1.16
c513d989-7beb-4501-9b75-abba14992911,2024-06-19,2024-06-19,HM Revenue & Customs,9311,Income,Tax Refund,17.35,GBP,-11043.76,Credit,London,GB,4488,user_001,,Refund for Sainsbury's
cabde641-c884-4f76-b003-fadf1a767725,2024-06-20,2024-06-21,Uber UK,4121,Transport,Ride Hailing,-26.82,GBP,-11070.58,E-Com,London,GB,1045,user_001,,
ff0a95f2-f61e-479b-b838-75b409bef79e,2024-06-20,2024-06-24,Pret A Manger,5814,Food & Drink,Eating Out,-7.9,GBP,-11078.48,POS,London,GB,4488,user_002,,
6fbc3552-3006-410d-86f7-39ff51ba9187,2024-06-21,2024-06-21,Deliveroo,5812,Food & Drink,Delivery,-19.27,GBP,-11097.75,E-Com,London,GB,9074,user_002,,
daf4d500-f801-4f08-a292-8726d3b76b98,2024-06-21,2024-06-24,Netflix,7841,Entertainment,Subscriptions,-14.91,USD,-11112.66,E-Com,Los Gatos,US,4488,user_001,rec_1bfe33738d,FX purchase 19.09 USD @ rate 1.28
f1bff5a0-18e9-4d3d-b8ac-f025e9d300e3,2024-06-21,2024-06-24,Transport for London,4111,Transport,Transit,-11.23,GBP,-11123.89,POS,London,GB,9074,user_001,,
c6268c66-cd44-4b34-99b4-18e5d3c0593e,2024-06-22,2024-06-24,Shell,5541,Transport,Fuel,-83.74,GBP,-11207.63,POS,London,GB,9074,user_001,,
e085cfa0-1a8b-4600-8ba5-2b0e5d4df96b,2024-06-22,2024-06-24,Sainsbury's,5411,Groceries,Supermarket,-37.59,GBP,-11245.22,POS,London,GB,1045,user_001,,
ee8b6321-c591-4fef-8154-007c956b935f,2024-06-22,2024-06-24,Pret A Manger,5814,Food & Drink,Eating Out,-7.26,GBP,-11252.48,POS,London,GB,1045,user_001,,
15a0a7cd-f076-41a2-b4f8-487d22ffabb8,2024-06-23,2024-06-24,Sainsbury's,5411,Groceries,Supermarket,-30.92,GBP,-11283.4,POS,London,GB,9074,user_001,,
41069fd2-d6c2-41e7-a522-0fce12ecc166,2024-06-23,2024-06-24,Shell,5541,Transport,Fuel,-82.02,GBP,-11365.42,POS,London,GB,2219,user_002,,
41fef10e-6e89-43b9-b4e4-1e3b8a2c0e36,2024-06-23,2024-06-24,Sainsbury's,5411,Groceries,Supermarket,-48.65,GBP,-11414.07,POS,London,GB,2219,user_002,,
77a6dad2-f837-4daa-b5e8-c00a73446796,2024-06-23,2024-06-24,Waitrose,5411,Groceries,Supermarket,-31.55,GBP,-11445.62,POS,London,GB,4488,user_001,,
7953ad5d-5237-473d-8887-56af556e4c3a,2024-06-23,2024-06-24,Sainsbury's,5411,Groceries,Supermarket,-52.39,GBP,-11498.01,POS,London,GB,9074,user_001,,
8b68c173-977c-420a-982a-1e6707023df7,2024-06-23,2024-06-25,Deliveroo,5812,Food & Drink,Delivery,-15.67,GBP,-11513.68,E-Com,London,GB,2219,user_001,,
335d922d-4640-4f8f-9448-bd3c4b85a532,2024-06-24,2024-06-25,Amazon UK,5942,Shopping,Online Retail,-23.64,GBP,-11537.32,E-Com,London,GB,4488,user_001,,
8d6d9a04-c9ad-4e30-a4d4-4f3c4ac99f2a,2024-06-25,2024-06-25,T212 Capital,6011,Income,Salary,3368.89,GBP,-8168.43,Credit,London,GB,1045,user_001,rec_2ff8f778d0,
c742e7a9-5494-4829-90be-cb0ccfd2342e,2024-06-25,2024-06-26,Shell,5541,Transport,Fuel,-30.08,GBP,-8198.51,POS,London,GB,1045,user_002,,
cb12fd4a-971c-4def-b01f-f7f14b575e14,2024-06-25,2024-06-27,Transport for London,4111,Transport,Transit,-8.49,GBP,-8207.0,POS,London,GB,4488,user_001,,
dfb81a5a-c2a6-4903-99fe-12f63dbde7a3,2024-06-25,2024-06-27,Uber UK,4121,Transport,Ride Hailing,-21.36,GBP,-8228.36,E-Com,London,GB,4488,user_001,,
f0d5a42d-fdce-49b6-a0fa-4279dcf99447,2024-06-25,2024-06-26,Uber UK,4121,Transport,Ride Hailing,-20.33,GBP,-8248.69,E-Com,London,GB,2219,user_001,,
8f14bb48-11f3-49c5-b588-6d923684a994,2024-06-26,2024-06-28,Amazon UK,5942,Shopping,Online Retail,-104.49,GBP,-8353.18,E-Com,London,GB,1045,user_001,,
2e9e92b2-ce55-432b-9357-19d91da489fb,2024-06-27,2024-06-27,HM Revenue & Customs,9311,Income,Tax Refund,5.47,GBP,-8347.71,Credit,London,GB,4488,user_001,,Refund for Spotify
41f76901-a93a-4c16-8541-d27b7bca1954,2024-06-27,2024-07-01,Transport for London,4111,Transport,Transit,-11.2,GBP,-8358.91,POS,London,GB,2219,user_001,,
a0ded7d5-f055-48e8-aee8-3ab6ee110feb,2024-06-27,2024-06-28,Shell,5541,Transport,Fuel,-61.14,GBP,-8420.05,POS,London,GB,1045,user_001,,
07983f45-8329-4f4b-94c7-0c5e6bac32d2,2024-06-28,2024-07-01,Deliveroo,5812,Food & Drink,Delivery,-17.45,GBP,-8437.5,E-Com,London,GB,4488,user_001,,
aee27401-7996-417b-a664-96c5dde5d3f7,2024-06-28,2024-07-01,Deliveroo,5812,Food & Drink,Delivery,-20.81,GBP,-8458.31,E-Com,London,GB,4488,user_001,,
539bf237-ba57-4d2c-bfe8-98179cb13112,2024-06-29,2024-07-01,Pret A Manger,5814,Food & Drink,Eating Out,-11.25,GBP,-8469.56,POS,London,GB,2219,user_001,,
5ea2daf1-04a2-4ef8-a221-1752c05398be,2024-06-29,2024-07-01,Amazon UK,5942,Shopping,Online Retail,-54.95,GBP,-8524.51,E-Com,London,GB,2219,user_001,,
d855db5e-cbb9-4218-995a-2c611d15d164,2024-06-29,2024-07-01,Local Market,5499,Groceries,Specialty,-12.82,GBP,-8537.33,POS,London,GB,1045,user_002,,
e658016b-e17a-454f-aef5-8f45d414e02a,2024-06-29,2024-07-01,Amazon UK,5942,Shopping,Online Retail,-62.86,GBP,-8600.19,E-Com,London,GB,4488,user_001,,
18c0c534-1213-4b32-b86b-0a1d19665216,2024-06-30,2024-07-01,Sainsbury's,5411,Groceries,Supermarket,-55.69,GBP,-8655.88,POS,London,GB,2219,user_002,,
23de76ba-81d2-4c6f-98a3-5dc5121f4347,2024-06-30,2024-07-02,Deliveroo,5812,Food & Drink,Delivery,-28.3,GBP,-8684.18,E-Com,London,GB,1045,user_001,,
bfec1583-aa31-44e8-959e-1b13e6853863,2024-06-30,2024-07-01,HM Revenue & Customs,9311,Income,Tax Refund,35.43,GBP,-8648.75,Credit,London,GB,9074,user_001,,Refund for Sainsbury's
ee0f922f-8a67-4aa5-9585-d82fa1fc9452,2024-06-30,2024-07-02,Transport for London,4111,Transport,Transit,-11.54,GBP,-8660.29,POS,London,GB,1045,user_001,,
09d1c723-8a46-4b19-b42d-2038bedcccb6,2024-07-01,2024-07-02,Crown Estates Lettings,6513,Housing,Rent,-1587.8,GBP,-10248.09,POS,London,GB,1045,user_001,rec_19f70fbcce,
095cc01f-d69f-4250-9012-37cf398d9340,2024-07-02,2024-07-04,Apple.com/bill,5734,Shopping,Electronics,-135.47,USD,-10383.56,E-Com,Cupertino,US,2219,user_001,,FX purchase 168.27 USD @ rate 1.24
166c32e1-eb2b-4e08-a426-ddeef1d8ed3f,2024-07-02,2024-07-03,Local Market,5499,Groceries,Specialty,-6.04,GBP,-10389.6,POS,London,GB,9074,user_002,,
647ef58c-c805-4e89-a3d6-2a42553d76bf,2024-07-02,2024-07-02,Waitrose,5411,Groceries,Supermarket,-26.43,GBP,-10416.03,POS,London,GB,1045,user_001,,
9b7212ec-4c28-4db2-9e08-4c7a59143bb0,2024-07-03,2024-07-05,Shell,5541,Transport,Fuel,-57.31,GBP,-10473.34,POS,London,GB,4488,user_001,,
d07fc855-bab2-43b2-93b5-1304b7b588c6,2024-07-03,2024-07-03,Airline Refund,4511,Travel,Refund,59.07,GBP,-10414.27,Credit,London,GB,2219,user_001,,Refund for GymBox
5cd72bb0-c9ab-4f04-a5db-4160eba8a922,2024-07-04,2024-07-05,Apple.com/bill,5734,Shopping,Electronics,-76.45,USD,-10490.72,E-Com,Cupertino,US,1045,user_001,,FX purchase 96.02 USD @ rate 1.26
6706132b-4048-4cdc-aa2b-b00b0ff9a3ff,2024-07-04,2024-07-05,Apple.com/bill,5734,Shopping,Electronics,-55.83,USD,-10546.55,E-Com,Cupertino,US,9074,user_001,,FX purchase 71.8 USD @ rate 1.29
7ebddfa3-68ff-4304-a288-bf633a91c764,2024-07-04,2024-07-08,Local Market,5499,Groceries,Specialty,-10.36,GBP,-10556.91,POS,London,GB,2219,user_001,,
1c4d998e-d6c7-4d34-856a-b49790787b2d,2024-07-05,2024-07-08,Amazon UK,5942,Shopping,Online Retail,-48.16,GBP,-10605.07,E-Com,London,GB,1045,user_002,,
cab7b009-1a4e-4dfe-9624-2429caef7e8e,2024-07-05,2024-07-08,Local Market,5499,Groceries,Specialty,-6.08,GBP,-10611.15,POS,London,GB,1045,user_001,,
23c919dd-5458-4dfc-80ee-b0d89bb42017,2024-07-06,2024-07-08,Deliveroo,5812,Food & Drink,Delivery,-17.98,GBP,-10629.13,E-Com,London,GB,4488,user_001,,
50e20089-3e64-4aef-8b57-2b8ad39c19ea,2024-07-06,2024-07-08,Amazon UK,5942,Shopping,Online Retail,-94.56,GBP,-10723.69,E-Com,London,GB,1045,user_001,,
8802d2ff-af96-464d-adc1-b1c56b483d26,2024-07-06,2024-07-08,Uber UK,4121,Transport,Ride Hailing,-31.31,GBP,-10755.0,E-Com,London,GB,9074,user_001,,
37347e69-eeda-4251-9701-96e8783b2bb6,2024-07-07,2024-07-08,Deliveroo,5812,Food & Drink,Delivery,-31.06,GBP,-10786.06,E-Com,London,GB,9074,user_001,,
4a1f4015-ed57-43d9-b1ab-f849be2a7e32,2024-07-07,2024-07-09,Transport for London,4111,Transport,Transit,-6.99,GBP,-10793.05,POS,London,GB,4488,user_001,,
7457313d-bf48-407e-a85e-0a37c0834688,2024-07-07,2024-07-08,Shell,5541,Transport,Fuel,-36.59,GBP,-10829.64,POS,London,GB,1045,user_001,,
c52ea923-9a28-4336-9efb-cc867350e9fc,2024-07-08,2024-07-10,Deliveroo,5812,Food & Drink,Delivery,-15.65,GBP,-10845.29,E-Com,London,GB,9074,user_001,,
edbe6e33-bd59-4ca1-ae97-62aafe71e6ba,2024-07-08,2024-07-10,Octopus Energy,4900,Utilities,Electricity,-136.13,GBP,-10981.42,Direct Debit,London,GB,4488,user_001,rec_141a4a0666,
99e7d466-7d1e-4fb7-89eb-9388ab8cbbd5,2024-07-09,2024-07-11,Deliveroo,5812,Food & Drink,Delivery,-12.56,GBP,-10993.98,E-Com,London,GB,2219,user_001,,
ab773d68-ce01-4780-beba-bb06184e6e4e,2024-07-09,2024-07-09,Sainsbury's,5411,Groceries,Supermarket,-42.56,GBP,-11036.54,POS,London,GB,4488,user_001,,
cceeb982-7779-41a5-920f-de287dfca8c4,2024-07-09,2024-07-09,HM Revenue & Customs,9311,Income,Tax Refund,13.17,GBP,-11023.37,Credit,London,GB,1045,user_001,,Refund for Deliveroo
e95eeae5-a009-44f0-83eb-c787f885f91f,2024-07-09,2024-07-10,Amazon UK,5942,Shopping,Online Retail,-39.17,GBP,-11062.54,E-Com,London,GB,1045,user_001,,
f1d08f2a-a9c1-4155-b32a-c1a2f1b1b77d,2024-07-09,2024-07-09,Shell,5541,Transport,Fuel,-81.08,GBP,-11143.62,POS,London,GB,1045,user_001,,
18bd0f42-c337-4296-b83d-02d7d141f73b,2024-07-10,2024-07-10,Deliveroo,5812,Food & Drink,Delivery,-19.11,GBP,-11162.73,E-Com,London,GB,2219,user_001,,
2f015214-1c67-485e-b3a5-1699edae57e7,2024-07-11,2024-07-12,Thames Water,4900,Utilities,Water,-36.72,GBP,-11199.45,Direct Debit,Reading,GB,9074,user_002,rec_954d02400c,
47d6fb13-bbbf-462b-9531-219d26d20e3b,2024-07-11,2024-07-11,Local Market,5499,Groceries,Specialty,-11.01,GBP,-11210.46,POS,London,GB,9074,user_001,,
f9c02c90-ece5-4a44-8b6a-da2470b2562b,2024-07-11,2024-07-11,Amazon UK,5942,Shopping,Online Retail,-101.0,GBP,-11311.46,E-Com,London,GB,4488,user_002,,
0acbe84c-d6dc-43c9-8b7d-cc8aa7176138,2024-07-12,2024-07-12,Apple.com/bill,5734,Shopping,Electronics,-166.59,GBP,-11478.05,E-Com,Cupertino,US,4488,user_001,,
1b25525e-db94-4632-b9e7-ef9abe33d716,2024-07-12,2024-07-12,Waitrose,5411,Groceries,Supermarket,-51.23,GBP,-11529.28,POS,London,GB,4488,user_001,,
8dbd5e57-27ca-48b3-8580-00e3ab1c2c20,2024-07-12,2024-07-15,Waitrose,5411,Groceries,Supermarket,-68.18,GBP,-11597.46,POS,London,GB,9074,user_001,,
b7a898fe-0669-4e14-975d-e59a6e03059a,2024-07-12,2024-07-12,Pret A Manger,5814,Food & Drink,Eating Out,-5.93,GBP,-11603.39,POS,London,GB,1045,user_002,,
47727410-bf18-462b-a249-bc50fcd06b32,2024-07-13,2024-07-15,Transport for London,4111,Transport,Transit,-10.66,GBP,-11614.05,POS,London,GB,4488,user_002,,
a9b1f87e-9150-4bcf-9915-5d10207a3fd0,2024-07-13,2024-07-15,Transport for London,4111,Transport,Transit,-8.25,GBP,-11622.3,POS,London,GB,9074,user_001,,
f1178d8d-e7a4-44a1-8069-3648cc523e2b,2024-07-13,2024-07-15,Uber UK,4121,Transport,Ride Hailing,-15.59,GBP,-11637.89,E-Com,London,GB,1045,user_002,,
fd88949f-8889-4ad9-bce6-a0539e75f771,2024-07-13,2024-07-15,Transport for London,4111,Transport,Transit,-11.72,GBP,-11649.61,POS,London,GB,9074,user_001,,
0578e0a2-de30-456d-b62f-bdd30187621e,2024-07-14,2024-07-15,Apple.com/bill,5734,Shopping,Electronics,-174.78,USD,-11824.39,E-Com,Cupertino,US,1045,user_001,,FX purchase 215.0 USD @ rate 1.23
11eba84f-f54e-435c-9090-d9ff1932fb14,2024-07-14,2024-07-15,Waitrose,5411,Groceries,Supermarket,-38.65,GBP,-11863.04,POS,London,GB,9074,user_002,,
3f219f28-3fc2-4e7c-b4b3-a70d7b20a62d,2024-07-14,2024-07-16,Amazon UK,5942,Shopping,Online Retail,-106.91,GBP,-11969.95,E-Com,London,GB,1045,user_001,,
5379b5f9-af63-47a0-b93e-57658c380675,2024-07-14,2024-07-15,Waitrose,5411,Groceries,Supermarket,-43.95,GBP,-12013.9,POS,London,GB,1045,user_001,,
724b6b21-a13f-4bc6-a45f-b454fa51993f,2024-07-14,2024-07-16,Local Market,5499,Groceries,Specialty,-10.81,GBP,-12024.71,POS,London,GB,1045,user_001,,
7390c903-4a86-4faa-9820-a67ecb76b0e6,2024-07-14,2024-07-15,Local Market,5499,Groceries,Specialty,-15.26,GBP,-12039.97,POS,London,GB,1045,user_001,,
7398a432-f1b9-4be1-a879-9d58373de15e,2024-07-14,2024-07-16,Amazon UK,5942,Shopping,Online Retail,-12.18,GBP,-12052.15,E-Com,London,GB,4488,user_002,,
2582287f-24db-49f7-8437-3cf8d4294da1,2024-07-15,2024-07-16,O2 UK,4814,Bills,Mobile,-42.55,GBP,-12094.7,Direct Debit,Slough,GB,9074,user_001,rec_95042d8101,
6e752383-aa75-4c52-84ed-596917ebe982,2024-07-15,2024-07-15,Deliveroo,5812,Food & Drink,Delivery,-18.42,GBP,-12113.12,E-Com,London,GB,4488,user_001,,
b6ac7abb-faba-4ffc-b615-fbd668b167fd,2024-07-15,2024-07-17,City Council Tax,9399,Utilities,Council Tax,-181.72,GBP,-12294.84,Direct Debit,London,GB,4488,user_002,rec_6feaa5d43f,
2b0482c4-971d-4f6b-8c80-2215aa153f60,2024-07-16,2024-07-18,Waitrose,5411,Groceries,Supermarket,-28.14,GBP,-12322.98,POS,London,GB,4488,user_001,,
3fb9ed1f-f988-474a-91eb-c937fc812658,2024-07-16,2024-07-18,Transport for London,4111,Transport,Transit,-5.53,GBP,-12328.51,POS,London,GB,9074,user_001,,
55327384-4cc9-4c00-bd86-d996d3a829b7,2024-07-16,2024-07-16,Deliveroo,5812,Food & Drink,Delivery,-21.51,GBP,-12350.02,E-Com,London,GB,1045,user_002,,
ded38f24-5690-41a7-aa0b-f560d7c74ff9,2024-07-16,2024-07-18,Apple.com/bill,5734,Shopping,Electronics,-89.04,GBP,-12439.06,E-Com,Cupertino,US,2219,user_002,,
81e9b8ca-41e0-46c9-995b-a9b7ef2e33e3,2024-07-17,2024-07-17,GymBox,7997,Wellness,Gym,-45.77,GBP,-12484.83,Direct Debit,London,GB,9074,user_001,rec_3906953fd2,
b0365e62-1389-400a-b261-4f8999c25cff,2024-07-18,2024-07-19,Deliveroo,5812,Food & Drink,Delivery,-22.69,GBP,-12507.52,E-Com,London,GB,9074,user_001,,
d2cf6f1e-9efa-4812-b38a-bae7a6cb1471,2024-07-18,2024-07-19,Sainsbury's,5411,Groceries,Supermarket,-51.05,GBP,-12558.57,POS,London,GB,4488,user_001,,
d7e71c50-3f67-46bb-8e44-b874b714fc51,2024-07-18,2024-07-22,Sainsbury's,5411,Groceries,Supermarket,-30.57,GBP,-12589.14,POS,London,GB,2219,user_001,,
51dd4a79-af5d-4a00-aa66-84b2d0c10f86,2024-07-19,2024-07-22,Spotify,5735,Entertainment,Subscriptions,-9.02,GBP,-12598.16,E-Com,Stockholm,SE,2219,user_001,rec_4c746d2c3b,
b151a9e9-d368-4791-9d4a-7a69aa509a21,2024-07-19,2024-07-19,Uber UK,4121,Transport,Ride Hailing,-9.61,GBP,-12607.77,E-Com,London,GB,9074,user_001,,
0bb9c846-ca04-4ccc-8c85-64b649b532a7,2024-07-20,2024-07-22,Transport for London,4111,Transport,Transit,-6.61,GBP,-12614.38,POS,London,GB,2219,user_001,,
6025569f-ddde-4715-a0a4-79eea4d725ed,2024-07-20,2024-07-22,Apple.com/bill,5734,Shopping,Electronics,-70.27,GBP,-12684.65,E-Com,Cupertino,US,4488,user_001,,
1dac2675-9436-47b6-815d-4ab7852e46f3,2024-07-21,2024-07-22,Tesco,5411,Groceries,Supermarket,-58.48,GBP,-12743.13,POS,London,GB,4488,user_001,,
4dc5fe64-6336-44c6-9f8b-6b3782b87fe9,2024-07-21,2024-07-23,Deliveroo,5812,Food & Drink,Delivery,-24.68,GBP,-12767.81,E-Com,London,GB,1045,user_001,,
fbc62c9d-8fd0-4f60-903a-7e4397d37d33,2024-07-21,2024-07-23,Sainsbury's,5411,Groceries,Supermarket,-69.89,GBP,-12837.7,POS,London,GB,2219,user_001,,
4558d790-d007-4145-97b5-cda5f5780c8a,2024-07-22,2024-07-23,Netflix,7841,Entertainment,Subscriptions,-15.17,GBP,-12852.87,E-Com,Los Gatos,US,4488,user_002,rec_d9322c1382,
64c22681-917e-4587-83d3-63b2aa9257e3,2024-07-22,2024-07-24,Sainsbury's,5411,Groceries,Supermarket,-36.97,GBP,-12889.84,POS,London,GB,9074,user_001,,
6a191432-4883-465a-9c7d-449390825894,2024-07-23,2024-07-23,Apple.com/bill,5734,Shopping,Electronics,-206.48,GBP,-13096.32,E-Com,Cupertino,US,2219,user_001,,
6ee670be-6a8e-4867-b050-2f8013a670c3,2024-07-23,2024-07-23,Waitrose,5411,Groceries,Supermarket,-34.14,GBP,-13130.46,POS,London,GB,9074,user_001,,
b686c57e-15a8-4cb1-aa2e-4b9610d776e8,2024-07-23,2024-07-25,Local Market,5499,Groceries,Specialty,-9.96,GBP,-13140.42,POS,London,GB,2219,user_001,,
bcb7937e-4704-497e-8d01-a55b7cc322dd,2024-07-23,2024-07-25,Transport for London,4111,Transport,Transit,-10.96,GBP,-13151.38,POS,London,GB,1045,user_001,,
dfbfe225-34f3-432d-bdf8-617441622479,2024-07-23,2024-07-23,Deliveroo,5812,Food & Drink,Delivery,-19.81,GBP,-13171.19,E-Com,London,GB,2219,user_001,,
bdc6f927-f1e3-479f-bd2c-0b7b12342617,2024-07-24,2024-07-24,Sainsbury's,5411,Groceries,Supermarket,-32.36,GBP,-13203.55,POS,London,GB,1045,user_001,,
c9a7b82b-77de-4bac-a04f-3874a42a5078,2024-07-24,2024-07-24,Local Market,5499,Groceries,Specialty,-17.24,GBP,-13220.79,POS,London,GB,4488,user_001,,
0689be9f-3059-48e8-95ff-0132064a54df,2024-07-25,2024-07-25,T212 Capital,6011,Income,Salary,3240.91,GBP,-9979.88,Credit,London,GB,4488,user_001,rec_2ff8f778d0,
dba882d3-361c-4094-b1ff-0b3febdd65c0,2024-07-25,2024-07-25,Transport for London,4111,Transport,Transit,-7.59,GBP,-9987.47,POS,London,GB,1045,user_001,,
14a6cd35-4716-451b-8d21-365edf5e3e47,2024-07-26,2024-07-26,Apple.com/bill,5734,Shopping,Electronics,-82.56,GBP,-10070.03,E-Com,Cupertino,US,4488,user_001,,
6285558b-d8d3-4289-84e1-a5dad1136ef1,2024-07-26,2024-07-29,Amazon UK,5942,Shopping,Online Retail,-25.26,GBP,-10095.29,E-Com,London,GB,9074,user_001,,
f6bdd7f6-c3dc-4d3e-8ed4-8270a255e4aa,2024-07-26,2024-07-29,Waitrose,5411,Groceries,Supermarket,-65.42,GBP,-10160.71,POS,London,GB,9074,user_002,,
0b30bca8-fad7-45b4-ae90-695cf0bbabb0,2024-07-27,2024-07-29,Tesco,5411,Groceries,Supermarket,-54.92,GBP,-10215.63,POS,London,GB,4488,user_001,,
c6694585-7137-4e2a-8556-d04db093cc32,2024-07-27,2024-07-29,Apple.com/bill,5734,Shopping,Electronics,-16.65,GBP,-10232.28,E-Com,Cupertino,US,9074,user_001,,
21cbc637-653b-4126-bf31-8ea9e5a003db,2024-07-28,2024-07-29,Waitrose,5411,Groceries,Supermarket,-24.55,GBP,-10256.83,POS,London,GB,1045,user_001,,
372d6d09-0a6a-44e3-a4fd-8e75730835d8,2024-07-28,2024-07-30,Transport for London,4111,Transport,Transit,-10.75,GBP,-10267.58,POS,London,GB,1045,user_001,,
7f328c87-dce0-4c97-83a9-a47769589190,2024-07-28,2024-07-29,Pret A Manger,5814,Food & Drink,Eating Out,-6.07,GBP,-10273.65,POS,London,GB,4488,user_001,,
955ab92d-6f88-45ac-ab58-7f3d9dbf6312,2024-07-28,2024-07-29,Sainsbury's,5411,Groceries,Supermarket,-28.54,GBP,-10302.19,POS,London,GB,4488,user_001,,
b2b17246-f2a3-47aa-8804-c097e0fa1cdb,2024-07-28,2024-07-30,Sainsbury's,5411,Groceries,Supermarket,-50.93,GBP,-10353.12,POS,London,GB,2219,user_001,,
069030f1-6610-430f-ac20-070dee596789,2024-07-29,2024-07-31,Tesco,5411,Groceries,Supermarket,-22.24,GBP,-10375.36,POS,London,GB,1045,user_001,,
809d38e0-0e61-497a-8046-66d99f1067e3,2024-07-29,2024-07-30,Tesco,5411,Groceries,Supermarket,-84.14,GBP,-10459.5,POS,London,GB,9074,user_001,,
a50431ce-0509-448f-ac7b-87bfe569eea9,2024-07-29,2024-07-29,Local Market,5499,Groceries,Specialty,-15.23,GBP,-10474.73,POS,London,GB,4488,user_001,,
68e0c7b3-4b0b-4a55-9185-7b1ec1140eb3,2024-07-30,2024-07-30,Local Market,5499,Groceries,Specialty,-11.72,GBP,-10486.45,POS,London,GB,4488,user_001,,
a8544267-a3ec-4b90-ae34-f3006b6188db,2024-07-30,2024-08-01,Tesco,5411,Groceries,Supermarket,-41.7,GBP,-10528.15,POS,London,GB,2219,user_001,,
5e1eed7b-25d9-4480-a7ba-45bf34d5dc4f,2024-07-31,2024-08-01,Local Market,5499,Groceries,Specialty,-17.31,GBP,-10545.46,POS,London,GB,1045,user_002,,
db614fe2-6122-4405-986c-eb3b784472fc,2024-07-31,2024-08-02,Shell,5541,Transport,Fuel,-36.57,GBP,-10582.03,POS,London,GB,1045,user_001,,
0462a6fb-b1b1-4695-906f-d446045b0eca,2024-08-01,2024-08-05,Crown Estates Lettings,6513,Housing,Rent,-1466.04,GBP,-12048.07,POS,London,GB,4488,user_001,rec_19f70fbcce,
936dd930-8d54-4995-9455-3e3b697b7254,2024-08-01,2024-08-05,Transport for London,4111,Transport,Transit,-5.49,GBP,-12053.56,POS,London,GB,1045,user_001,,
1a538cb9-c937-45f9-bbfb-222748c1c428,2024-08-02,2024-08-05,Shell,5541,Transport,Fuel,-75.02,GBP,-12128.58,POS,London,GB,1045,user_001,,
618912b9-d4f4-4f33-851a-5cda0942ca21,2024-08-03,2024-08-05,Waitrose,5411,Groceries,Supermarket,-81.33,GBP,-12209.91,POS,London,GB,4488,user_001,,
bd30b48e-27fe-4f46-a5e7-520bc9145504,2024-08-03,2024-08-05,Deliveroo,5812,Food & Drink,Delivery,-15.03,GBP,-12224.94,E-Com,London,GB,9074,user_001,,
f2fa448d-1696-4538-8450-26c28af101c5,2024-08-03,2024-08-05,Apple.com/bill,5734,Shopping,Electronics,-181.42,GBP,-12406.36,E-Com,Cupertino,US,1045,user_001,,
fcaa449c-5494-4139-9252-b0c0f0dea367,2024-08-03,2024-08-05,Pret A Manger,5814,Food & Drink,Eating Out,-9.11,GBP,-12415.47,POS,London,GB,9074,user_002,,
668352d3-662b-4f75-9a15-ca606d21ac9b,2024-08-04,2024-08-05,Sainsbury's,5411,Groceries,Supermarket,-65.37,GBP,-12480.84,POS,London,GB,4488,user_001,,
aad9c5b6-b4ea-427f-9ac8-56550006c7e6,2024-08-04,2024-08-05,Uber UK,4121,Transport,Ride Hailing,-15.17,GBP,-12496.01,E-Com,London,GB,4488,user_001,,
f9450f26-d1c4-432e-a493-3403ae9465ba,2024-08-04,2024-08-06,Amazon UK,5942,Shopping,Online Retail,-78.22,GBP,-12574.23,E-Com,London,GB,9074,user_001,,
f99942eb-94a0-4406-8051-95bf51030fbb,2024-08-07,2024-08-07,Octopus Energy,4900,Utilities,Electricity,-141.52,GBP,-12715.75,Direct Debit,London,GB,4488,user_001,rec_141a4a0666,
f9e94552-44d8-45e4-a19c-46aaad36611f,2024-08-07,2024-08-07,Pret A Manger,5814,Food & Drink,Eating Out,-8.46,GBP,-12724.21,POS,London,GB,1045,user_001,,
2c5be50d-70de-406a-934e-30df70333180,2024-08-08,2024-08-08,Local Market,5499,Groceries,Specialty,-16.34,GBP,-12740.55,POS,London,GB,9074,user_001,,
4497b1f7-c34d-44bc-b484-0c24e34ee21b,2024-08-08,2024-08-08,Amazon UK,5942,Shopping,Online Retail,-14.38,GBP,-12754.93,E-Com,London,GB,9074,user_001,,
cfb8e15f-c165-427e-b4d3-5949c46e0978,2024-08-08,2024-08-09,Uber UK,4121,Transport,Ride Hailing,-9.91,GBP,-12764.84,E-Com,London,GB,9074,user_001,,
d8175459-9d26-4872-ab70-2bc6491a4d0c,2024-08-08,2024-08-08,Apple.com/bill,5734,Shopping,Electronics,-94.65,GBP,-12859.49,E-Com,Cupertino,US,4488,user_001,,
df922123-8b0d-41ad-a628-754d0102f6b4,2024-08-08,2024-08-08,Apple.com/bill,5734,Shopping,Electronics,-47.53,USD,-12907.02,E-Com,Cupertino,US,4488,user_001,,FX purchase 60.43 USD @ rate 1.27
37a31923-c515-43e1-8190-69b9dedb48de,2024-08-09,2024-08-12,Pret A Manger,5814,Food & Drink,Eating Out,-11.39,GBP,-12918.41,POS,London,GB,2219,user_001,,
1aca43aa-ce8e-4a0c-b7bb-b7c6e2b4da8b,2024-08-10,2024-08-12,Transport for London,4111,Transport,Transit,-8.14,GBP,-12926.55,POS,London,GB,4488,user_001,,
1ba0bc89-3e34-4ff7-8f28-20801cf10819,2024-08-10,2024-08-12,Shell,5541,Transport,Fuel,-41.39,GBP,-12967.94,POS,London,GB,9074,user_001,,
62e1df4d-bdf6-49c0-af89-9e23c744504c,2024-08-10,2024-08-12,Shell,5541,Transport,Fuel,-38.05,GBP,-13005.99,POS,London,GB,1045,user_001,,
1d01e644-7a4a-468b-bf0b-af25c117d191,2024-08-11,2024-08-13,Uber UK,4121,Transport,Ride Hailing,-35.97,GBP,-13041.96,E-Com,London,GB,1045,user_001,,
43c72beb-1e68-436c-a0cf-0f048adad1b9,2024-08-11,2024-08-12,Uber UK,4121,Transport,Ride Hailing,-20.99,GBP,-13062.95,E-Com,London,GB,2219,user_001,,
528cf746-0c85-43b0-9238-c29e5322b09c,2024-08-11,2024-08-12,Deliveroo,5812,Food & Drink,Delivery,-14.62,GBP,-13077.57,E-Com,London,GB,1045,user_001,,
7487ed82-e89e-4ccf-936f-ddc297284a54,2024-08-11,2024-08-13,Pret A Manger,5814,Food & Drink,Eating Out,-10.19,GBP,-13087.76,POS,London,GB,1045,user_002,,
74e55d94-51fd-4e24-a672-cd4d55e65cf6,2024-08-11,2024-08-12,Amazon UK,5942,Shopping,Online Retail,-40.22,GBP,-13127.98,E-Com,London,GB,9074,user_001,,
eee0499a-0fdb-4410-99bb-03e6e8a5fb47,2024-08-11,2024-08-12,Apple.com/bill,5734,Shopping,Electronics,-38.75,USD,-13166.73,E-Com,Cupertino,US,2219,user_001,,FX purchase 49.44 USD @ rate 1.28
3e6bff19-0844-455e-8c14-4ee5ecac2fa2,2024-08-12,2024-08-14,Thames Water,4900,Utilities,Water,-34.52,GBP,-13201.25,Direct Debit,Reading,GB,9074,user_001,rec_3a34d62842,
b996323d-19ba-41cf-a8de-853971766835,2024-08-12,2024-08-14,Amazon UK,5942,Shopping,Online Retail,-31.85,GBP,-13233.1,E-Com,London,GB,4488,user_001,,
c5ac8d36-47d1-4490-8be8-ffc301c9e575,2024-08-13,2024-08-15,City Council Tax,9399,Utilities,Council Tax,-153.46,GBP,-13386.56,Direct Debit,London,GB,4488,user_001,rec_f531495db5,
fd40c85c-a811-4238-8978-24418588958e,2024-08-13,2024-08-14,Pret A Manger,5814,Food & Drink,Eating Out,-6.81,GBP,-13393.37,POS,London,GB,1045,user_001,,
25bca8b5-c980-4bd6-b378-bb2168e2ec31,2024-08-14,2024-08-15,Pret A Manger,5814,Food & Drink,Eating Out,-9.96,GBP,-13403.33,POS,London,GB,4488,user_001,,
f383ec11-b433-4a18-abba-4a05ddd420ea,2024-08-14,2024-08-15,Sainsbury's,5411,Groceries,Supermarket,-43.52,GBP,-13446.85,POS,London,GB,9074,user_001,,
18a8fb64-b118-4870-a8be-912c4a6a474c,2024-08-15,2024-08-19,Pret A Manger,5814,Food & Drink,Eating Out,-10.26,GBP,-13457.11,POS,London,GB,4488,user_001,,
1d90bd96-2d70-4117-9b0b-3724e00106f3,2024-08-15,2024-08-15,Transport for London,4111,Transport,Transit,-6.58,GBP,-13463.69,POS,London,GB,4488,user_001,,
3ca0c619-93fc-4058-b990-6e5f916be7c6,2024-08-15,2024-08-16,O2 UK,4814,Bills,Mobile,-53.91,GBP,-13517.6,Direct Debit,Slough,GB,4488,user_001,rec_95042d8101,
047bf213-f484-4a02-b3f0-bd344822e0ef,2024-08-16,2024-08-16,Uber UK,4121,Transport,Ride Hailing,-34.54,GBP,-13552.14,E-Com,London,GB,2219,user_001,,
c36d008b-d9ab-4463-bbd3-d8ade5c70d04,2024-08-16,2024-08-19,Amazon UK,5942,Shopping,Online Retail,-102.37,GBP,-13654.51,E-Com,London,GB,4488,user_002,,
31876e94-91a4-496f-87da-350c31586060,2024-08-17,2024-08-19,Tesco,5411,Groceries,Supermarket,-82.93,GBP,-13737.44,POS,London,GB,9074,user_001,,
4754db3e-fa61-4d5c-b8af-46d2b7979568,2024-08-17,2024-08-19,Apple.com/bill,5734,Shopping,Electronics,-51.58,GBP,-13789.02,E-Com,Cupertino,US,2219,user_001,,
a7e183e8-337b-4684-9cfe-fedfc62c402f,2024-08-17,2024-08-19,Amazon UK,5942,Shopping,Online Retail,-90.29,GBP,-13879.31,E-Com,London,GB,1045,user_001,,
bb498e0f-33ef-4a08-b105-dcf152bedf5f,2024-08-17,2024-08-19,Tesco,5411,Groceries,Supermarket,-49.79,GBP,-13929.1,POS,London,GB,2219,user_002,,
f53815d8-db5e-4ddd-bf10-167df6090f44,2024-08-18,2024-08-19,Waitrose,5411,Groceries,Supermarket,-39.83,GBP,-13968.93,POS,London,GB,4488,user_001,,
fd7599ff-0ac1-4e87-87f8-2f01729b0f80,2024-08-18,2024-08-20,Pret A Manger,5814,Food & Drink,Eating Out,-8.72,GBP,-13977.65,POS,London,GB,2219,user_001,,
1b11fffe-8634-40d2-8b3e-3a3cb113f4d4,2024-08-19,2024-08-20,Deliveroo,5812,Food & Drink,Delivery,-28.17,GBP,-14005.82,E-Com,London,GB,2219,user_001,,
e7dbad82-52c2-488f-b4f7-ede4a677a6bd,2024-08-19,2024-08-21,Spotify,5735,Entertainment,Subscriptions,-8.3,GBP,-14014.12,E-Com,Stockholm,SE,9074,user_001,rec_4c746d2c3b,
f0bc1930-3bf8-411e-a91f-8748940bd139,2024-08-19,2024-08-20,GymBox,7997,Wellness,Gym,-63.24,GBP,-14077.36,Direct Debit,London,GB,1045,user_001,rec_3906953fd2,
a03c0b27-d242-4013-a901-2488467b6489,2024-08-21,2024-08-23,Netflix,7841,Entertainment,Subscriptions,-10.95,GBP,-14088.31,E-Com,Los Gatos,US,1045,user_001,rec_1bfe33738d,
d0e7523f-d04f-44cf-b6ea-e7605ddeeb4e,2024-08-21,2024-08-23,Tesco,5411,Groceries,Supermarket,-78.03,GBP,-14166.34,POS,London,GB,1045,user_001,,
227252a6-bb5a-4577-8316-8f1031371e2f,2024-08-23,2024-08-26,Sainsbury's,5411,Groceries,Supermarket,-60.8,GBP,-14227.14,POS,London,GB,9074,user_001,,
3160148e-ab44-442e-b7f2-9625515af4d6,2024-08-23,2024-08-23,Airline Refund,4511,Travel,Refund,11.18,GBP,-14215.96,Credit,London,GB,2219,user_001,,Refund for Uber UK
a56a9373-3eb6-48a6-9d66-7dacf75fef2d,2024-08-23,2024-08-26,Uber UK,4121,Transport,Ride Hailing,-27.52,GBP,-14243.48,E-Com,London,GB,1045,user_001,,
cc0c7951-67bb-4857-8d9e-fa624db01103,2024-08-23,2024-08-23,T212 Capital,6011,Income,Salary,3415.36,GBP,-10828.12,Credit,London,GB,2219,user_001,rec_2ff8f778d0,
fc5fd2a4-46a2-445b-aecb-98dbfa91dca9,2024-08-23,2024-08-26,Sainsbury's,5411,Groceries,Supermarket,-41.44,GBP,-10869.56,POS,London,GB,4488,user_001,,
4fb1239e-d58a-4748-906c-4afc0fa5b367,2024-08-24,2024-08-26,Uber UK,4121,Transport,Ride Hailing,-11.74,GBP,-10881.3,E-Com,London,GB,4488,user_002,,
54a9d082-c836-4d14-a27c-b0941d739d51,2024-08-24,2024-08-26,Sainsbury's,5411,Groceries,Supermarket,-55.14,GBP,-10936.44,POS,London,GB,1045,user_002,,
81fd56bd-3ab6-4276-9a62-3878f6e0c4c7,2024-08-24,2024-08-26,Sainsbury's,5411,Groceries,Supermarket,-29.87,GBP,-10966.31,POS,London,GB,4488,user_001,,
850d8b04-2f5f-4765-b901-19aa68e7a9d0,2024-08-24,2024-08-26,Waitrose,5411,Groceries,Supermarket,-48.17,GBP,-11014.48,POS,London,GB,9074,user_002,,
d114a63a-0c8d-45ca-90f9-53165f4b4197,2024-08-24,2024-08-26,Waitrose,5411,Groceries,Supermarket,-34.51,GBP,-11048.99,POS,London,GB,4488,user_002,,
356f3042-2801-4d6a-bea0-106c2b14aff7,2024-08-25,2024-08-26,Waitrose,5411,Groceries,Supermarket,-50.17,GBP,-11099.16,POS,London,GB,2219,user_001,,
792c4e06-bbe0-4f00-bad3-d4e0a2b073fc,2024-08-25,2024-08-26,Transport for London,4111,Transport,Transit,-4.08,GBP,-11103.24,POS,London,GB,1045,user_001,,
a21e9fe5-6170-45e9-8ed1-6c5782a35cc4,2024-08-25,2024-08-26,Deliveroo,5812,Food & Drink,Delivery,-13.33,GBP,-11116.57,E-Com,London,GB,1045,user_002,,
c1bba100-73bc-4f09-ba43-b01d4efbfee5,2024-08-25,2024-08-26,Waitrose,5411,Groceries,Supermarket,-89.11,GBP,-11205.68,POS,London,GB,2219,user_001,,
f691d952-6a47-4ad7-881f-ae2033a48779,2024-08-25,2024-08-26,Pret A Manger,5814,Food & Drink,Eating Out,-11.04,GBP,-11216.72,POS,London,GB,1045,user_001,,
0863d69b-5cb2-44e2-8538-ee9b3b34c796,2024-08-26,2024-08-28,Airbnb,7011,Travel,Accommodation,-140.84,EUR,-11357.56,E-Com,Dublin,IE,1045,user_001,,Business travel
60451bd3-2596-499d-aef2-73d875794404,2024-08-26,2024-08-26,Deliveroo,5812,Food & Drink,Delivery,-26.22,GBP,-11383.78,E-Com,London,GB,2219,user_002,,
f3e968f8-b9a9-4727-a4bc-369da836d4a7,2024-08-26,2024-08-27,Sainsbury's,5411,Groceries,Supermarket,-33.86,GBP,-11417.64,POS,London,GB,4488,user_002,,
70fb9605-bd0a-4d0c-b6a8-3e9c7bc91331,2024-08-27,2024-08-27,Waitrose,5411,Groceries,Supermarket,-28.35,GBP,-11445.99,POS,London,GB,9074,user_001,,
9183ad9c-988f-4e88-9967-ae03b489dc98,2024-08-28,2024-08-29,Uber UK,4121,Transport,Ride Hailing,-27.16,GBP,-11473.15,E-Com,London,GB,2219,user_001,,
bb23eec5-a92e-47cf-8c4e-f5049139bd6c,2024-08-28,2024-08-29,Local Market,5499,Groceries,Specialty,-18.93,GBP,-11492.08,POS,London,GB,1045,user_001,,
cc493b8c-05bc-40bb-a85f-b53fccb735f5,2024-08-28,2024-08-28,Sainsbury's,5411,Groceries,Supermarket,-17.56,GBP,-11509.64,POS,London,GB,1045,user_001,,
85e09408-c160-4a4c-bc7a-2b2027828216,2024-08-29,2024-08-30,Deliveroo,5812,Food & Drink,Delivery,-12.63,GBP,-11522.27,E-Com,London,GB,4488,user_001,,
bb2aae70-26bf-457a-89b4-3085e09fdd3c,2024-08-29,2024-09-02,Tesco,5411,Groceries,Supermarket,-81.18,GBP,-11603.45,POS,London,GB,9074,user_001,,
10a6a3db-a413-4d9a-b485-3f7290238bb5,2024-08-31,2024-09-02,Pret A Manger,5814,Food & Drink,Eating Out,-7.22,GBP,-11610.67,POS,London,GB,9074,user_001,,
1244a124-5fe4-424e-b6b3-d8c667133953,2024-08-31,2024-09-02,Pret A Manger,5814,Food & Drink,Eating Out,-7.33,GBP,-11618.0,POS,London,GB,4488,user_001,,
14faafe0-a17a-46bd-b2b4-17b1987accda,2024-08-31,2024-09-02,Transport for London,4111,Transport,Transit,-6.88,GBP,-11624.88,POS,London,GB,9074,user_001,,
4edd2759-995d-41e0-80fc-f050f8402123,2024-08-31,2024-09-02,Apple.com/bill,5734,Shopping,Electronics,-42.32,GBP,-11667.2,E-Com,Cupertino,US,9074,user_002,,
95609414-3fd3-4649-8938-557c96a82416,2024-08-31,2024-09-02,Uber UK,4121,Transport,Ride Hailing,-21.04,GBP,-11688.24,E-Com,London,GB,2219,user_001,,
a29570bf-d7cc-46a4-b7ed-865eac731161,2024-08-31,2024-09-02,Shell,5541,Transport,Fuel,-67.08,GBP,-11755.32,POS,London,GB,4488,user_001,,
2507f9c6-c710-47af-aeca-80e8dd9e415a,2024-09-01,2024-09-02,Uber UK,4121,Transport,Ride Hailing,-31.34,GBP,-11786.66,E-Com,London,GB,4488,user_001,,
894b9ab6-c1e1-4741-a2fc-c52cc0899b5d,2024-09-01,2024-09-02,Apple.com/bill,5734,Shopping,Electronics,-142.29,GBP,-11928.95,E-Com,Cupertino,US,2219,user_002,,
9190a37d-f667-4aab-a907-f7d7d95e4a19,2024-09-01,2024-09-02,Amazon UK,5942,Shopping,Online Retail,-86.49,GBP,-12015.44,E-Com,London,GB,9074,user_001,,
b7ea4203-d992-42bf-9315-461a320ca0c8,2024-09-01,2024-09-02,Uber UK,4121,Transport,Ride Hailing,-34.49,GBP,-12049.93,E-Com,London,GB,4488,user_001,,
bc221aec-1409-449d-9547-2ec407a842ee,2024-09-01,2024-09-02,Tesco,5411,Groceries,Supermarket,-80.31,GBP,-12130.24,POS,London,GB,9074,user_001,,
29aa9651-396f-4fd8-8118-59c9150fddf7,2024-09-02,2024-09-02,Crown Estates Lettings,6513,Housing,Rent,-1563.01,GBP,-13693.25,POS,London,GB,4488,user_001,rec_19f70fbcce,
3348a6f7-06ce-47c3-a5a4-b78ae6ad395e,2024-09-02,2024-09-04,Shell,5541,Transport,Fuel,-59.07,GBP,-13752.32,POS,London,GB,1045,user_002,,
3a58ab67-e053-4614-8593-1bb5c6408b7d,2024-09-03,2024-09-05,Waitrose,5411,Groceries,Supermarket,-46.51,GBP,-13798.83,POS,London,GB,4488,user_001,,
719d1089-e75a-4b72-be2c-33582bfcb39e,2024-09-03,2024-09-04,Waitrose,5411,Groceries,Supermarket,-45.65,GBP,-13844.48,POS,London,GB,2219,user_001,,
7c6701aa-f433-46a1-8ff1-fae925da8ee6,2024-09-03,2024-09-04,Tesco,5411,Groceries,Supermarket,-67.84,GBP,-13912.32,POS,London,GB,1045,user_001,,
e203214b-f3a8-46ea-9fa6-35566384f7c7,2024-09-03,2024-09-05,Waitrose,5411,Groceries,Supermarket,-77.81,GBP,-13990.13,POS,London,GB,9074,user_001,,
ef4776a2-4f4c-4ed7-8aeb-3b55b63d602b,2024-09-03,2024-09-05,Waitrose,5411,Groceries,Supermarket,-21.36,GBP,-14011.49,POS,London,GB,9074,user_001,,
25f81a4b-4f16-4ce1-8a22-f6561d05b046,2024-09-04,2024-09-06,Transport for London,4111,Transport,Transit,-10.66,GBP,-14022.15,POS,London,GB,4488,user_001,,
8bc26fc6-05e3-4ba2-b9d2-2c71fc83fa00,2024-09-04,2024-09-06,Tesco,5411,Groceries,Supermarket,-33.62,GBP,-14055.77,POS,London,GB,9074,user_001,,
bb111117-1611-4491-8797-329a5df7e262,2024-09-04,2024-09-04,Shell,5541,Transport,Fuel,-45.69,GBP,-14101.46,POS,London,GB,4488,user_001,,
e488376a-fa8e-4e1d-8978-e3cf09e724d1,2024-09-04,2024-09-06,Sainsbury's,5411,Groceries,Supermarket,-61.98,GBP,-14163.44,POS,London,GB,2219,user_001,,
efe3d3d0-a2d8-4815-bccd-c6192ec846ec,2024-09-04,2024-09-06,Uber UK,4121,Transport,Ride Hailing,-30.33,GBP,-14193.77,E-Com,London,GB,2219,user_002,,
16cebad2-889a-4535-8886-d041fb74f10c,2024-09-05,2024-09-05,Transport for London,4111,Transport,Transit,-5.61,GBP,-14199.38,POS,London,GB,4488,user_001,,
2e68ab70-9d1f-4a44-897b-2cbb312ac0ac,2024-09-05,2024-09-09,Shell,5541,Transport,Fuel,-56.33,GBP,-14255.71,POS,London,GB,9074,user_001,,
444cebaf-3092-4aa1-b0d1-e246b4c9ada6,2024-09-05,2024-09-09,Deliveroo,5812,Food & Drink,Delivery,-14.66,GBP,-14270.37,E-Com,London,GB,1045,user_001,,
a318e234-66ea-4614-ae87-2570c38b576f,2024-09-05,2024-09-06,Sainsbury's,5411,Groceries,Supermarket,-33.6,GBP,-14303.97,POS,London,GB,9074,user_001,,
21145a5f-c581-423a-9703-bf67824ca886,2024-09-06,2024-09-09,Shell,5541,Transport,Fuel,-53.4,GBP,-14357.37,POS,London,GB,1045,user_001,,
51295abb-6946-4849-858a-1221e8fcaffc,2024-09-06,2024-09-06,Deliveroo,5812,Food & Drink,Delivery,-28.95,GBP,-14386.32,E-Com,London,GB,2219,user_001,,
61df81ec-cd40-4d31-8a6f-d6d49f929e61,2024-09-06,2024-09-06,Sainsbury's,5411,Groceries,Supermarket,-39.98,GBP,-14426.3,POS,London,GB,1045,user_001,,
e2ab6885-e59e-4425-9755-5d9d1a56797e,2024-09-06,2024-09-09,Uber UK,4121,Transport,Ride Hailing,-16.31,GBP,-14442.61,E-Com,London,GB,2219,user_001,,
3689f66b-384f-4b13-ae27-d307e0aab0e9,2024-09-07,2024-09-09,Waitrose,5411,Groceries,Supermarket,-36.49,GBP,-14479.1,POS,London,GB,1045,user_001,,
a91ab648-7938-4085-83a3-70cffc370324,2024-09-07,2024-09-09,Waitrose,5411,Groceries,Supermarket,-31.63,GBP,-14510.73,POS,London,GB,1045,user_001,,
db9dfc63-e431-4d2c-8a41-279b8efa88ed,2024-09-07,2024-09-09,Waitrose,5411,Groceries,Supermarket,-24.73,GBP,-14535.46,POS,London,GB,2219,user_001,,
6e6bc840-cc0e-4821-939a-555b9c9ff84c,2024-09-08,2024-09-10,Tesco,5411,Groceries,Supermarket,-21.98,GBP,-14557.44,POS,London,GB,1045,user_002,,
94e34e91-8f56-4385-9675-7cb68c1240a0,2024-09-08,2024-09-09,Sainsbury's,5411,Groceries,Supermarket,-37.96,GBP,-14595.4,POS,London,GB,9074,user_001,,
c2ddeb52-8861-4062-94da-fffb81d16bb6,2024-09-08,2024-09-09,Tesco,5411,Groceries,Supermarket,-24.02,GBP,-14619.42,POS,London,GB,1045,user_001,,
f675c1fa-bdd0-4252-9788-cc8f70727859,2024-09-08,2024-09-09,Deliveroo,5812,Food & Drink,Delivery,-33.65,GBP,-14653.07,E-Com,London,GB,4488,user_001,,
4f7adf41-5465-42f2-a2e1-0ef33aa63236,2024-09-09,2024-09-09,Octopus Energy,4900,Utilities,Electricity,-137.12,GBP,-14790.19,Direct Debit,London,GB,2219,user_001,rec_141a4a0666,
5db67f2c-fdcb-44d1-8a83-e0f0dcdc653e,2024-09-09,2024-09-09,Apple.com/bill,5734,Shopping,Electronics,-175.93,GBP,-14966.12,E-Com,Cupertino,US,9074,user_001,,
9e109e4f-97ab-48fa-abb7-d656c966de7e,2024-09-10,2024-09-11,Pret A Manger,5814,Food & Drink,Eating Out,-7.49,GBP,-14973.61,POS,London,GB,9074,user_001,,
f38fae5d-5c2b-4a23-961a-c73d239ea14c,2024-09-10,2024-09-12,Uber UK,4121,Transport,Ride Hailing,-12.9,GBP,-14986.51,E-Com,London,GB,2219,user_001,,
365e49d6-9b9c-4b26-92c5-1fd0476d73dd,2024-09-11,2024-09-11,Tesco,5411,Groceries,Supermarket,-70.98,GBP,-15057.49,POS,London,GB,4488,user_002,,
4144b370-cfd2-4702-9a1a-eceef61d96ed,2024-09-11,2024-09-13,Tesco,5411,Groceries,Supermarket,-29.87,GBP,-15087.36,POS,London,GB,2219,user_001,,
7c16363c-f5f6-4109-b789-ef0c486dfafa,2024-09-11,2024-09-11,Thames Water,4900,Utilities,Water,-32.89,GBP,-15120.25,Direct Debit,Reading,GB,1045,user_001,rec_3a34d62842,
8e2efa12-0ac7-42bd-aff0-793a447aa397,2024-09-11,2024-09-12,Sainsbury's,5411,Groceries,Supermarket,-65.34,GBP,-15185.59,POS,London,GB,9074,user_002,,
c29bceb4-9ddb-4389-aa61-3039f2cd70a8,2024-09-11,2024-09-11,Pret A Manger,5814,Food & Drink,Eating Out,-10.37,GBP,-15195.96,POS,London,GB,9074,user_001,,
127cae36-08d1-4fa2-b25e-9bac32454e19,2024-09-12,2024-09-12,British Airways,4511,Travel,Flights,-199.33,GBP,-15395.29,E-Com,London,GB,1045,user_001,,Business travel
4a7cdba5-8bd0-4388-a75a-8dbaf0b2eb29,2024-09-12,2024-09-16,Apple.com/bill,5734,Shopping,Electronics,-69.62,GBP,-15464.91,E-Com,Cupertino,US,4488,user_001,,
6fe2f06f-1109-4f6b-a1d6-a20165b6c0e2,2024-09-13,2024-09-16,City Council Tax,9399,Utilities,Council Tax,-172.75,GBP,-15637.66,Direct Debit,London,GB,4488,user_001,rec_f531495db5,
bbdcb4fd-1081-4d69-9275-bc67fcd7b146,2024-09-13,2024-09-16,Transport for London,4111,Transport,Transit,-11.78,GBP,-15649.44,POS,London,GB,4488,user_001,,
548ff454-7106-4033-8f44-32ae4c4d5a10,2024-09-14,2024-09-16,Shell,5541,Transport,Fuel,-88.0,GBP,-15737.44,POS,London,GB,2219,user_001,,
3d3befeb-38dc-4de8-a8ef-98a7554136fb,2024-09-15,2024-09-16,Shell,5541,Transport,Fuel,-92.84,GBP,-15830.28,POS,London,GB,2219,user_001,,
3e5cc9db-721b-44bb-bfe6-c67a9813cab1,2024-09-15,2024-09-17,Pret A Manger,5814,Food & Drink,Eating Out,-11.83,GBP,-15842.11,POS,London,GB,9074,user_001,,
890763d4-b05e-4938-a40b-ae27ad3ceec7,2024-09-15,2024-09-16,Local Market,5499,Groceries,Specialty,-19.38,GBP,-15861.49,POS,London,GB,2219,user_001,,
b4fee85a-810a-4b56-af9b-8ae8b3e9d666,2024-09-15,2024-09-16,Tesco,5411,Groceries,Supermarket,-25.2,GBP,-15886.69,POS,London,GB,1045,user_001,,
df0edf8e-7cc0-4ca7-8161-864628c99e17,2024-09-15,2024-09-17,Uber UK,4121,Transport,Ride Hailing,-32.04,GBP,-15918.73,E-Com,London,GB,1045,user_001,,
f5aeaded-6054-4d0c-bf92-e06e85c036e4,2024-09-15,2024-09-17,Waitrose,5411,Groceries,Supermarket,-62.73,GBP,-15981.46,POS,London,GB,9074,user_001,,
4e26ab99-aa78-4660-b545-3a909759b438,2024-09-16,2024-09-17,Pret A Manger,5814,Food & Drink,Eating Out,-5.56,GBP,-15987.02,POS,London,GB,2219,user_001,,
8b4a60da-a3bb-4524-890a-5d3cff35af50,2024-09-16,2024-09-18,O2 UK,4814,Bills,Mobile,-43.61,GBP,-16030.63,Direct Debit,Slough,GB,4488,user_001,rec_95042d8101,
c35a5c6f-a2eb-4bab-8087-bf48b23d2cb2,2024-09-16,2024-09-17,Waitrose,5411,Groceries,Supermarket,-64.28,GBP,-16094.91,POS,London,GB,1045,user_001,,
9631a163-7cd1-47c5-850d-433eb7c3e645,2024-09-17,2024-09-19,Shell,5541,Transport,Fuel,-91.2,GBP,-16186.11,POS,London,GB,4488,user_001,,
ce1c517d-a519-4b42-bf46-432dfd8c3f8a,2024-09-17,2024-09-18,GymBox,7997,Wellness,Gym,-46.61,GBP,-16232.72,Direct Debit,London,GB,4488,user_002,rec_19771e79cd,
e61a54a9-64ee-474c-9ba0-492ec5677805,2024-09-17,2024-09-17,Sainsbury's,5411,Groceries,Supermarket,-33.13,GBP,-16265.85,POS,London,GB,9074,user_001,,
fff48f48-550d-4a7a-9f52-44f3816b6950,2024-09-17,2024-09-18,Tesco,5411,Groceries,Supermarket,-46.89,GBP,-16312.74,POS,London,GB,1045,user_001,,
6d9053a4-e84d-4537-bc6e-386450a569e0,2024-09-18,2024-09-20,Waitrose,5411,Groceries,Supermarket,-51.86,GBP,-16364.6,POS,London,GB,1045,user_001,,
b61d3957-7ebb-4bcc-adae-b228a2545f9a,2024-09-18,2024-09-18,Pret A Manger,5814,Food & Drink,Eating Out,-10.2,GBP,-16374.8,POS,London,GB,1045,user_001,,
8824d320-e970-4857-898c-1ea90a454c2b,2024-09-19,2024-09-20,Sainsbury's,5411,Groceries,Supermarket,-51.53,GBP,-16426.33,POS,London,GB,2219,user_002,,
a80bf703-6d10-42f9-8e2a-c617a29fc329,2024-09-19,2024-09-19,Spotify,5735,Entertainment,Subscriptions,-9.09,GBP,-16435.42,E-Com,Stockholm,SE,1045,user_001,rec_4c746d2c3b,
b81b7d52-2761-4de2-a34c-6ea9eaf243c1,2024-09-19,2024-09-19,Apple.com/bill,5734,Shopping,Electronics,-153.78,GBP,-16589.2,E-Com,Cupertino,US,1045,user_001,,
e24d9706-c152-4bda-93a3-1fe1b7ba942c,2024-09-19,2024-09-20,ATM Withdrawal,6011,Cash,ATM,-107.28,GBP,-16696.48,ATM,London,GB,2219,user_001,,
3c8562f4-b02c-4546-92b2-dd21fd80ebca,2024-09-20,2024-09-20,Sainsbury's,5411,Groceries,Supermarket,-33.31,GBP,-16729.79,POS,London,GB,1045,user_001,,
ee5d3399-c9d2-461d-aa3f-b89e03146a68,2024-09-20,2024-09-23,Shell,5541,Transport,Fuel,-94.93,GBP,-16824.72,POS,London,GB,4488,user_001,,
0c68d3db-1c2b-4492-87bd-fee90ed7b022,2024-09-21,2024-09-23,Sainsbury's,5411,Groceries,Supermarket,-49.87,GBP,-16874.59,POS,London,GB,2219,user_001,,
26ac1933-8897-4d4e-a991-c6ce2860e128,2024-09-21,2024-09-23,Shell,5541,Transport,Fuel,-84.4,GBP,-16958.99,POS,London,GB,2219,user_001,,
5d910c8b-2df9-46e5-842f-b1aa92710efb,2024-09-21,2024-09-23,Transport for London,4111,Transport,Transit,-7.35,GBP,-16966.34,POS,London,GB,9074,user_001,,
3febc94a-400e-4f35-8138-e76337e106eb,2024-09-22,2024-09-24,Waitrose,5411,Groceries,Supermarket,-82.74,GBP,-17049.08,POS,London,GB,4488,user_001,,
75457f66-0c91-426f-a3c4-1417e3e9b628,2024-09-22,2024-09-23,Waitrose,5411,Groceries,Supermarket,-86.26,GBP,-17135.34,POS,London,GB,4488,user_001,,
89406133-0188-49f9-8ab2-87e395468c3e,2024-09-22,2024-09-23,Airline Refund,4511,Travel,Refund,20.56,GBP,-17114.78,Credit,London,GB,4488,user_001,,Refund for Shell
8d2a2abd-b053-4bcf-b800-8e428e31e4ac,2024-09-23,2024-09-23,Local Market,5499,Groceries,Specialty,-6.05,GBP,-17120.83,POS,London,GB,2219,user_001,,
918c260d-5571-4b3c-b56c-1a6ff54c6050,2024-09-23,2024-09-23,Netflix,7841,Entertainment,Subscriptions,-14.41,GBP,-17135.24,E-Com,Los Gatos,US,9074,user_002,rec_d9322c1382,
a1511dc4-00cb-4bb4-b090-db7ce72b9556,2024-09-23,2024-09-24,Transport for London,4111,Transport,Transit,-6.98,GBP,-17142.22,POS,London,GB,1045,user_001,,
564d76a2-1349-415b-bce9-a039496a45e7,2024-09-24,2024-09-26,Apple.com/bill,5734,Shopping,Electronics,-129.04,GBP,-17271.26,E-Com,Cupertino,US,2219,user_001,,
d5ecf97c-8456-4cf8-af32-6d851056442f,2024-09-24,2024-09-26,Apple.com/bill,5734,Shopping,Electronics,-21.79,GBP,-17293.05,E-Com,Cupertino,US,4488,user_002,,
098d6a42-da71-486f-a343-1b5099b2f7d5,2024-09-25,2024-09-25,Uber UK,4121,Transport,Ride Hailing,-8.92,GBP,-17301.97,E-Com,London,GB,4488,user_001,,
157b3b62-24c0-45d8-91ef-dff5fc508511,2024-09-25,2024-09-25,T212 Capital,6011,Income,Salary,3173.44,GBP,-14128.53,Credit,London,GB,4488,user_001,rec_2ff8f778d0,
25493ca5-039a-48ea-b5b6-1191873c7642,2024-09-25,2024-09-26,Sainsbury's,5411,Groceries,Supermarket,-45.58,GBP,-14174.11,POS,London,GB,4488,user_001,,
62989979-7344-4e54-9c34-4c067f95228e,2024-09-25,2024-09-26,Uber UK,4121,Transport,Ride Hailing,-16.54,GBP,-14190.65,E-Com,London,GB,1045,user_001,,
ac9c646b-4702-4587-8219-e58bf97a7a06,2024-09-25,2024-09-26,Shell,5541,Transport,Fuel,-37.28,GBP,-14227.93,POS,London,GB,9074,user_001,,
82fa38a1-2c64-4a66-9970-8cb69e6ccd15,2024-09-26,2024-09-30,Transport for London,4111,Transport,Transit,-8.8,GBP,-14236.73,POS,London,GB,1045,user_001,,
575550c1-3d4b-4992-bb7b-06049308d65f,2024-09-27,2024-09-27,Sainsbury's,5411,Groceries,Supermarket,-33.0,GBP,-14269.73,POS,London,GB,4488,user_002,,
82fa20d9-ac4f-4113-8b55-e693642cd5d2,2024-09-27,2024-09-27,Sainsbury's,5411,Groceries,Supermarket,-42.19,GBP,-14311.92,POS,London,GB,4488,user_002,,
99a19c10-35a1-4135-8b17-b0a41a770d40,2024-09-27,2024-09-30,Transport for London,4111,Transport,Transit,-11.82,GBP,-14323.74,POS,London,GB,9074,user_002,,
c011491a-7aac-409f-9031-402249f018e9,2024-09-27,2024-09-30,Shell,5541,Transport,Fuel,-88.53,GBP,-14412.27,POS,London,GB,2219,user_001,,
f8f0be52-6e33-45e0-9d53-1c0d2aacfbcc,2024-09-27,2024-09-30,Sainsbury's,5411,Groceries,Supermarket,-50.55,GBP,-14462.82,POS,London,GB,4488,user_001,,
1b64bb1e-67a5-40f6-b30c-48fb953b293c,2024-09-28,2024-09-30,Shell,5541,Transport,Fuel,-51.59,GBP,-14514.41,POS,London,GB,9074,user_001,,
4485c3d6-cae4-4cdf-a18a-8b924b407698,2024-09-28,2024-09-30,Waitrose,5411,Groceries,Supermarket,-66.3,GBP,-14580.71,POS,London,GB,4488,user_001,,
7c2550f8-ec49-44ed-bd94-2a9d9d7e319e,2024-09-28,2024-09-30,Uber UK,4121,Transport,Ride Hailing,-21.6,GBP,-14602.31,E-Com,London,GB,9074,user_001,,
6dbb54dd-061f-455e-bc9e-4313ee8e8bf5,2024-09-29,2024-10-01,Sainsbury's,5411,Groceries,Supermarket,-64.79,GBP,-14667.1,POS,London,GB,4488,user_001,,
b1384227-4173-48ca-b821-d236f6b890ef,2024-09-29,2024-10-01,Waitrose,5411,Groceries,Supermarket,-59.22,GBP,-14726.32,POS,London,GB,4488,user_001,,
b35bdb74-9887-46d3-9f3e-f2368a145bec,2024-09-29,2024-09-30,Shell,5541,Transport,Fuel,-64.88,GBP,-14791.2,POS,London,GB,4488,user_001,,
f769c402-7962-4351-a376-1d4dc1801790,2024-09-29,2024-10-01,Sainsbury's,5411,Groceries,Supermarket,-62.14,GBP,-14853.34,POS,London,GB,2219,user_001,,
571a5a74-852b-475a-8591-e8d0f8dcf115,2024-09-30,2024-10-01,Uber UK,4121,Transport,Ride Hailing,-11.11,GBP,-14864.45,E-Com,London,GB,1045,user_001,,
8475b9d2-43dc-4ec6-b9e3-a32cd48640c1,2024-09-30,2024-09-30,Apple.com/bill,5734,Shopping,Electronics,-209.14,GBP,-15073.59,E-Com,Cupertino,US,2219,user_001,,
176ab214-a38c-4bbf-b264-da040696f173,2024-10-01,2024-10-02,Local Market,5499,Groceries,Specialty,-13.59,GBP,-15087.18,POS,London,GB,2219,user_001,,
d58a68af-9cc6-4278-8271-2fde6a991ac9,2024-10-01,2024-10-02,Crown Estates Lettings,6513,Housing,Rent,-1625.92,GBP,-16713.1,POS,London,GB,4488,user_002,rec_fc2ae06846,
a8423ae7-a012-4a3e-aa1d-561a708ff8bf,2024-10-02,2024-10-04,Waitrose,5411,Groceries,Supermarket,-78.04,GBP,-16791.14,POS,London,GB,4488,user_001,,
952581e2-494d-4f05-a0c0-3d77d7c79856,2024-10-03,2024-10-04,Apple.com/bill,5734,Shopping,Electronics,-44.43,GBP,-16835.57,E-Com,Cupertino,US,4488,user_001,,
b7023a46-cac9-4f38-a4e9-0e5b9eb8379e,2024-10-04,2024-10-04,Uber UK,4121,Transport,Ride Hailing,-33.83,GBP,-16869.4,E-Com,London,GB,9074,user_001,,
cec3c4b3-5bbe-4153-90df-a35f993b02c1,2024-10-04,2024-10-07,Waitrose,5411,Groceries,Supermarket,-77.43,GBP,-16946.83,POS,London,GB,1045,user_001,,
6be6fa77-6acb-4cff-b35a-1c72751ad82a,2024-10-05,2024-10-07,Amazon UK,5942,Shopping,Online Retail,-23.56,GBP,-16970.39,E-Com,London,GB,9074,user_001,,
6f524004-35de-4f0e-9c3a-1ab0b281f8ea,2024-10-05,2024-10-07,Amazon UK,5942,Shopping,Online Retail,-15.83,GBP,-16986.22,E-Com,London,GB,9074,user_002,,
612f4039-ec45-40da-a513-83fa7e0daea3,2024-10-06,2024-10-08,Amazon UK,5942,Shopping,Online Retail,-74.94,GBP,-17061.16,E-Com,London,GB,9074,user_001,,
6c8a0b33-3a2f-4a87-a30f-0899686c81e5,2024-10-06,2024-10-07,Uber UK,4121,Transport,Ride Hailing,-9.71,GBP,-17070.87,E-Com,London,GB,1045,user_001,,
6deff7e5-7e9f-45d5-a5d3-10f45e9d6b99,2024-10-07,2024-10-07,Tesco,5411,Groceries,Supermarket,-82.31,GBP,-17153.18,POS,London,GB,2219,user_001,,
7547fc0a-7952-4e60-8848-a43a661077bf,2024-10-07,2024-10-09,Octopus Energy,4900,Utilities,Electricity,-132.21,GBP,-17285.39,Direct Debit,London,GB,4488,user_001,rec_141a4a0666,
d7801cdd-3a4c-4ffb-8951-738aa942715b,2024-10-07,2024-10-07,Tesco,5411,Groceries,Supermarket,-68.17,GBP,-17353.56,POS,London,GB,4488,user_002,,
df96d9fc-feab-4548-9760-a14e71a1e76a,2024-10-07,2024-10-07,Tesco,5411,Groceries,Supermarket,-39.38,GBP,-17392.94,POS,London,GB,9074,user_001,,
e24ea0a5-fa8f-4b49-ad7c-29bfd5e198fe,2024-10-08,2024-10-08,British Airways,4511,Travel,Flights,-381.01,EUR,-17773.95,E-Com,London,GB,9074,user_001,,Holiday booking
514c7e2b-10ed-4661-a4f4-2febb3eb6b97,2024-10-10,2024-10-14,Local Market,5499,Groceries,Specialty,-20.44,GBP,-17794.39,POS,London,GB,1045,user_001,,
ae61f0a8-cd48-42b0-9157-ab9ddf1aa762,2024-10-10,2024-10-10,Local Market,5499,Groceries,Specialty,-6.79,GBP,-17801.18,POS,London,GB,9074,user_002,,
d075ef46-6bc8-45c1-8724-1cebe83e4118,2024-10-10,2024-10-10,Uber UK,4121,Transport,Ride Hailing,-25.36,GBP,-17826.54,E-Com,London,GB,1045,user_001,,
d21691df-79a0-4c55-b610-1b53c556b0cd,2024-10-10,2024-10-10,Tesco,5411,Groceries,Supermarket,-75.28,GBP,-17901.82,POS,London,GB,2219,user_001,,
a7d7a0fa-5d01-4410-a974-fcae3ac66ad5,2024-10-11,2024-10-14,Thames Water,4900,Utilities,Water,-41.6,GBP,-17943.42,Direct Debit,Reading,GB,2219,user_001,rec_3a34d62842,
33bac96a-d256-4b6a-b385-51ef8c5fda45,2024-10-12,2024-10-14,Apple.com/bill,5734,Shopping,Electronics,-110.0,USD,-18053.42,E-Com,Cupertino,US,4488,user_001,,FX purchase 132.53 USD @ rate 1.20
702fabdd-b008-484a-87af-a305a93dc344,2024-10-12,2024-10-14,Sainsbury's,5411,Groceries,Supermarket,-61.31,GBP,-18114.73,POS,London,GB,2219,user_001,,
b7ae04a0-5ca1-45a2-bcbb-df7c103997b1,2024-10-12,2024-10-14,Apple.com/bill,5734,Shopping,Electronics,-202.21,USD,-18316.94,E-Com,Cupertino,US,2219,user_002,,FX purchase 253.74 USD @ rate 1.25
dc100c49-c64d-4c4e-9bd4-aedf8fa80230,2024-10-12,2024-10-14,Sainsbury's,5411,Groceries,Supermarket,-36.66,GBP,-18353.6,POS,London,GB,9074,user_001,,
02652971-89d4-4764-bf5e-b4662a1f938f,2024-10-13,2024-10-15,Local Market,5499,Groceries,Specialty,-20.75,GBP,-18374.35,POS,London,GB,1045,user_002,,
266dbf04-6d4a-47a1-abf6-e6cd42449183,2024-10-13,2024-10-15,Pret A Manger,5814,Food & Drink,Eating Out,-9.87,GBP,-18384.22,POS,London,GB,4488,user_002,,
6871a167-61ba-4fd5-ac16-323a84377a11,2024-10-13,2024-10-14,Local Market,5499,Groceries,Specialty,-18.83,GBP,-18403.05,POS,London,GB,1045,user_001,,
e2129358-2fe6-4b9d-a5af-bd818796d39e,2024-10-13,2024-10-14,Local Market,5499,Groceries,Specialty,-20.19,GBP,-18423.24,POS,London,GB,9074,user_002,,
e68a125e-075a-40d1-a9e5-7ff5ab93d7ab,2024-10-13,2024-10-14,Tesco,5411,Groceries,Supermarket,-24.08,GBP,-18447.32,POS,London,GB,9074,user_001,,
6f466b54-22ab-4cd2-acd4-2903816bbb0e,2024-10-14,2024-10-14,City Council Tax,9399,Utilities,Council Tax,-167.1,GBP,-18614.42,Direct Debit,London,GB,1045,user_001,rec_f531495db5,
033924d3-54aa-4455-98d4-4f246ea2fda3,2024-10-15,2024-10-17,O2 UK,4814,Bills,Mobile,-41.9,GBP,-18656.32,Direct Debit,Slough,GB,2219,user_001,rec_95042d8101,
27c86486-c3cd-4460-bde0-0bbc7d8fd86e,2024-10-15,2024-10-17,Deliveroo,5812,Food & Drink,Delivery,-21.22,GBP,-18677.54,E-Com,London,GB,9074,user_001,,
31664434-9d7b-4f55-8c06-cab5f1b08240,2024-10-15,2024-10-17,Pret A Manger,5814,Food & Drink,Eating Out,-5.53,GBP,-18683.07,POS,London,GB,4488,user_001,,
9245a3af-719a-4f94-bc82-05ae5cd54170,2024-10-15,2024-10-17,Waitrose,5411,Groceries,Supermarket,-66.84,GBP,-18749.91,POS,London,GB,1045,user_001,,
aff1108b-4753-4b3b-b555-6d6904667ed7,2024-10-16,2024-10-17,Pret A Manger,5814,Food & Drink,Eating Out,-9.0,GBP,-18758.91,POS,London,GB,1045,user_001,,
317c0004-1f4b-4d59-a96b-90897db8f658,2024-10-17,2024-10-17,HM Revenue & Customs,9311,Income,Tax Refund,17.63,GBP,-18741.28,Credit,London,GB,1045,user_001,,Refund for Uber UK
3b575b3d-9237-4b52-97bd-b22395b40ff4,2024-10-17,2024-10-21,Pret A Manger,5814,Food & Drink,Eating Out,-9.03,GBP,-18750.31,POS,London,GB,1045,user_002,,
65ae0f85-2677-453d-9c02-74b8a4d16154,2024-10-17,2024-10-17,GymBox,7997,Wellness,Gym,-61.97,GBP,-18812.28,Direct Debit,London,GB,2219,user_001,rec_3906953fd2,
e254825f-f4c7-4e22-989a-94fa7ca81767,2024-10-17,2024-10-17,Pret A Manger,5814,Food & Drink,Eating Out,-9.25,GBP,-18821.53,POS,London,GB,9074,user_001,,
a74a0f87-0435-41ab-ba5a-14b6fb9dcd02,2024-10-18,2024-10-21,Transport for London,4111,Transport,Transit,-10.39,GBP,-18831.92,POS,London,GB,4488,user_001,,
2a26fb24-fd4b-4d9c-bd41-77a1b121d1e0,2024-10-19,2024-10-21,Apple.com/bill,5734,Shopping,Electronics,-80.97,USD,-18912.89,E-Com,Cupertino,US,4488,user_001,,FX purchase 97.8 USD @ rate 1.21
aaeba8ef-69c5-48f0-83ae-edc4b901ad77,2024-10-19,2024-10-21,Uber UK,4121,Transport,Ride Hailing,-17.49,GBP,-18930.38,E-Com,London,GB,4488,user_002,,
ce9b6fe1-7367-450b-a5ba-02194e421820,2024-10-19,2024-10-21,Uber UK,4121,Transport,Ride Hailing,-11.79,GBP,-18942.17,E-Com,London,GB,9074,user_002,,
53cc0723-e298-4dc2-9e85-53ca5eeb1725,2024-10-20,2024-10-21,Transport for London,4111,Transport,Transit,-4.25,GBP,-18946.42,POS,London,GB,1045,user_001,,
61004fdd-f3d5-4d71-aadc-40d9d5593940,2024-10-20,2024-10-22,Pret A Manger,5814,Food & Drink,Eating Out,-8.21,GBP,-18954.63,POS,London,GB,4488,user_001,,
67caedbd-d3ed-480b-bf16-4363148032e6,2024-10-20,2024-10-22,Uber UK,4121,Transport,Ride Hailing,-11.93,GBP,-18966.56,E-Com,London,GB,1045,user_002,,
a05325f5-0872-4433-8dd7-012af11c2c62,2024-10-20,2024-10-21,Local Market,5499,Groceries,Specialty,-12.24,GBP,-18978.8,POS,London,GB,4488,user_001,,
b09c4019-ef79-45e6-96a5-06cba0e83e6f,2024-10-20,2024-10-21,Uber UK,4121,Transport,Ride Hailing,-9.24,GBP,-18988.04,E-Com,London,GB,4488,user_001,,
bcc6d53d-9eb0-4186-ad21-9019daec7a8e,2024-10-20,2024-10-21,Deliveroo,5812,Food & Drink,Delivery,-27.36,GBP,-19015.4,E-Com,London,GB,4488,user_001,,
1754136e-98cb-4fee-8ec7-3bb50c3e9b5a,2024-10-21,2024-10-21,Netflix,7841,Entertainment,Subscriptions,-14.13,GBP,-19029.53,E-Com,Los Gatos,US,4488,user_001,rec_1bfe33738d,
35b41799-b06f-4ad5-b577-6671743b7756,2024-10-21,2024-10-21,Spotify,5735,Entertainment,Subscriptions,-9.84,EUR,-19039.37,E-Com,Stockholm,SE,9074,user_001,rec_4c746d2c3b,FX purchase 11.25 EUR @ rate 1.14
f1e50525-f571-4a9c-85a1-5d82ada2b8fe,2024-10-21,2024-10-21,Airline Refund,4511,Travel,Refund,36.24,GBP,-19003.13,Credit,London,GB,9074,user_001,,Refund for Sainsbury's
33aecacc-c64e-45dd-be22-80b185c3714e,2024-10-22,2024-10-24,Waitrose,5411,Groceries,Supermarket,-21.88,GBP,-19025.01,POS,London,GB,1045,user_001,,
41d91198-d420-463e-b189-57f186346d3a,2024-10-23,2024-10-24,Shell,5541,Transport,Fuel,-90.86,GBP,-19115.87,POS,London,GB,9074,user_001,,
f07744e5-84e9-4751-b821-ded6999da833,2024-10-24,2024-10-25,Deliveroo,5812,Food & Drink,Delivery,-18.42,GBP,-19134.29,E-Com,London,GB,1045,user_001,,
b06687ef-7531-434b-a988-175ff6803f2a,2024-10-25,2024-10-25,T212 Capital,6011,Income,Salary,2862.89,GBP,-16271.4,Credit,London,GB,2219,user_001,rec_2ff8f778d0,
c82568a6-2271-46fa-b7f3-a094c925d86f,2024-10-25,2024-10-25,Tesco,5411,Groceries,Supermarket,-56.4,GBP,-16327.8,POS,London,GB,2219,user_001,,
7f496fbb-94ac-4a82-83be-df128748e35b,2024-10-26,2024-10-28,Tesco,5411,Groceries,Supermarket,-26.61,GBP,-16354.41,POS,London,GB,1045,user_001,,
86a24fba-9934-4ba5-886c-9244876680d1,2024-10-26,2024-10-28,Shell,5541,Transport,Fuel,-35.14,GBP,-16389.55,POS,London,GB,1045,user_001,,
974798a1-9b64-4a0c-ae10-2f46fe8b7e2f,2024-10-26,2024-10-28,Shell,5541,Transport,Fuel,-60.41,GBP,-16449.96,POS,London,GB,1045,user_001,,
a82a2dca-ed03-49dd-9c88-9d2a6560c291,2024-10-26,2024-10-28,Sainsbury's,5411,Groceries,Supermarket,-44.65,GBP,-16494.61,POS,London,GB,1045,user_002,,
ad3fe679-702e-4b47-a037-96838912a449,2024-10-26,2024-10-28,Amazon UK,5942,Shopping,Online Retail,-98.05,GBP,-16592.66,E-Com,London,GB,4488,user_001,,
d50bb35e-0495-4a25-a08f-a7bf07d51de7,2024-10-26,2024-10-28,Tesco,5411,Groceries,Supermarket,-27.9,GBP,-16620.56,POS,London,GB,4488,user_001,,
e05723d4-2d1c-4a18-8bee-ca8d67a63534,2024-10-26,2024-10-28,Sainsbury's,5411,Groceries,Supermarket,-33.01,GBP,-16653.57,POS,London,GB,4488,user_001,,
e9e1009d-045f-46f2-a120-c5be896e3403,2024-10-26,2024-10-28,Shell,5541,Transport,Fuel,-82.91,GBP,-16736.48,POS,London,GB,9074,user_001,,
bd0effc6-03d6-45bb-8a28-2b4ab149e15a,2024-10-27,2024-10-29,Shell,5541,Transport,Fuel,-68.49,GBP,-16804.97,POS,London,GB,2219,user_001,,
ea5b193f-fd3a-4690-85d0-a51ab09eb350,2024-10-27,2024-10-28,Transport for London,4111,Transport,Transit,-9.72,GBP,-16814.69,POS,London,GB,1045,user_001,,
5620cc47-9fe9-48f5-af89-3a13fc2d1735,2024-10-28,2024-10-28,Local Market,5499,Groceries,Specialty,-11.13,GBP,-16825.82,POS,London,GB,2219,user_001,,
99bc7795-3b62-4758-9b9b-4d89c11bb9bb,2024-10-29,2024-10-31,Deliveroo,5812,Food & Drink,Delivery,-17.04,GBP,-16842.86,E-Com,London,GB,2219,user_001,,
266858df-6f3a-4bd4-80d5-b20be0687e02,2024-10-30,2024-10-30,Uber UK,4121,Transport,Ride Hailing,-25.51,GBP,-16868.37,E-Com,London,GB,9074,user_001,,
545131de-691b-414f-a7bb-8b3788da125b,2024-10-30,2024-10-31,Transport for London,4111,Transport,Transit,-6.46,GBP,-16874.83,POS,London,GB,9074,user_001,,
1496ed31-82f1-4fe8-951b-0d868b88c8a4,2024-10-31,2024-10-31,Amazon UK,5942,Shopping,Online Retail,-18.33,GBP,-16893.16,E-Com,London,GB,9074,user_001,,
1fb28e9f-062e-46c0-b56f-9e006a8f2b2f,2024-10-31,2024-10-31,Sainsbury's,5411,Groceries,Supermarket,-19.91,GBP,-16913.07,POS,London,GB,4488,user_001,,
2336536d-c685-497d-9df5-a0a940b943db,2024-11-01,2024-11-01,Amazon UK,5942,Shopping,Online Retail,-35.61,GBP,-16948.68,E-Com,London,GB,9074,user_001,,
35ad2cae-26d6-44d4-b8c2-106ba5e8ad77,2024-11-01,2024-11-01,Waitrose,5411,Groceries,Supermarket,-88.4,GBP,-17037.08,POS,London,GB,2219,user_002,,
4f22c338-e976-4c2f-bb3b-92cc62e97b57,2024-11-01,2024-11-01,Uber UK,4121,Transport,Ride Hailing,-19.27,GBP,-17056.35,E-Com,London,GB,9074,user_001,,
5fe7607d-a766-4d39-87df-3f5a442cc3d4,2024-11-01,2024-11-04,Apple.com/bill,5734,Shopping,Electronics,-119.31,USD,-17175.66,E-Com,Cupertino,US,9074,user_001,,FX purchase 143.91 USD @ rate 1.21
88c02fb8-b386-4264-9038-7f5d45ccd0fb,2024-11-01,2024-11-01,Amazon UK,5942,Shopping,Online Retail,-103.42,GBP,-17279.08,E-Com,London,GB,2219,user_002,,
c71edbcf-6f5b-4780-9590-a737c23a5d90,2024-11-01,2024-11-04,Crown Estates Lettings,6513,Housing,Rent,-1524.26,GBP,-18803.34,POS,London,GB,1045,user_001,rec_19f70fbcce,
2f5bb308-96e3-4a79-92af-e3fd97d6510f,2024-11-02,2024-11-04,Local Market,5499,Groceries,Specialty,-17.62,GBP,-18820.96,POS,London,GB,1045,user_001,,
43af27c6-4ebe-41a8-a0d0-ff6008716016,2024-11-02,2024-11-04,Tesco,5411,Groceries,Supermarket,-63.18,GBP,-18884.14,POS,London,GB,9074,user_002,,
649ef706-83a9-47d5-ae31-82625f41e1ae,2024-11-02,2024-11-04,Sainsbury's,5411,Groceries,Supermarket,-14.15,GBP,-18898.29,POS,London,GB,4488,user_001,,
8fc5b5af-678b-4d73-8a92-fc2822ae4390,2024-11-02,2024-11-04,Sainsbury's,5411,Groceries,Supermarket,-60.36,GBP,-18958.65,POS,London,GB,9074,user_001,,
d9b1d41e-d29b-4dbc-aed2-9416a331d179,2024-11-02,2024-11-04,Pret A Manger,5814,Food & Drink,Eating Out,-9.52,GBP,-18968.17,POS,London,GB,1045,user_001,,
de7e51eb-7107-4eb9-9bb0-54d651c33854,2024-11-02,2024-11-04,Waitrose,5411,Groceries,Supermarket,-30.43,GBP,-18998.6,POS,London,GB,9074,user_001,,
0428b4eb-63d9-4cca-998a-6189f6b66a14,2024-11-03,2024-11-04,Amazon UK,5942,Shopping,Online Retail,-68.3,GBP,-19066.9,E-Com,London,GB,1045,user_001,,
a561e09b-d881-4606-856f-07c52d464097,2024-11-03,2024-11-05,Sainsbury's,5411,Groceries,Supermarket,-65.35,GBP,-19132.25,POS,London,GB,1045,user_002,,
cc54615b-2699-46c6-8584-d2c64f62c235,2024-11-03,2024-11-04,Sainsbury's,5411,Groceries,Supermarket,-54.73,GBP,-19186.98,POS,London,GB,1045,user_001,,
82dc5fc0-a88b-4473-9f73-28e46a1bb7ce,2024-11-04,2024-11-05,Uber UK,4121,Transport,Ride Hailing,-32.75,GBP,-19219.73,E-Com,London,GB,2219,user_001,,
be78599b-5345-4132-8242-20a11b1124da,2024-11-06,2024-11-08,Apple.com/bill,5734,Shopping,Electronics,-35.43,USD,-19255.16,E-Com,Cupertino,US,1045,user_001,,FX purchase 44.21 USD @ rate 1.25
7118902a-be1a-4e1d-9178-4b267214b2da,2024-11-07,2024-11-08,Octopus Energy,4900,Utilities,Electricity,-110.31,GBP,-19365.47,Direct Debit,London,GB,9074,user_001,rec_141a4a0666,
fc89fb9c-53a0-458e-b755-f4c12333ec5b,2024-11-07,2024-11-07,Amazon UK,5942,Shopping,Online Retail,-43.26,GBP,-19408.73,E-Com,London,GB,4488,user_002,,
3b78bcf4-6410-4dc3-93a0-f626ae244ab6,2024-11-08,2024-11-08,Uber UK,4121,Transport,Ride Hailing,-26.17,GBP,-19434.9,E-Com,London,GB,4488,user_001,,
612a1e13-4fbb-445d-9805-621431be8857,2024-11-08,2024-11-11,Uber UK,4121,Transport,Ride Hailing,-22.42,GBP,-19457.32,E-Com,London,GB,2219,user_001,,
707a90c5-a665-4184-898c-abce5d40742c,2024-11-09,2024-11-11,Uber UK,4121,Transport,Ride Hailing,-18.24,GBP,-19475.56,E-Com,London,GB,4488,user_001,,
0ab9e082-ea8b-4b93-b762-cfac43aee86d,2024-11-10,2024-11-12,Deliveroo,5812,Food & Drink,Delivery,-21.76,GBP,-19497.32,E-Com,London,GB,4488,user_002,,
2064b021-6dab-4888-88f3-4492e590300a,2024-11-10,2024-11-12,Shell,5541,Transport,Fuel,-56.16,GBP,-19553.48,POS,London,GB,4488,user_001,,
2d071017-a660-4b11-adf1-208d79a0613b,2024-11-10,2024-11-12,Uber UK,4121,Transport,Ride Hailing,-28.44,GBP,-19581.92,E-Com,London,GB,9074,user_001,,
522a889c-61e2-4b50-a2d7-b36dadc0e528,2024-11-10,2024-11-12,Deliveroo,5812,Food & Drink,Delivery,-33.32,GBP,-19615.24,E-Com,London,GB,4488,user_001,,
a7329da0-cda4-4741-afaa-9491d127c950,2024-11-10,2024-11-11,Local Market,5499,Groceries,Specialty,-8.84,GBP,-19624.08,POS,London,GB,2219,user_001,,
c6fc4ad8-dc76-4c0e-a589-9c98f1b89126,2024-11-10,2024-11-11,Tesco,5411,Groceries,Supermarket,-33.61,GBP,-19657.69,POS,London,GB,9074,user_001,,
4757b5db-f27c-4da9-ab9a-0e3befdee634,2024-11-11,2024-11-13,ATM Withdrawal,6011,Cash,ATM,-96.85,GBP,-19754.54,ATM,London,GB,9074,user_001,,
4d81dbd8-9953-4be8-b631-d406452e6d61,2024-11-11,2024-11-11,Thames Water,4900,Utilities,Water,-35.32,GBP,-19789.86,Direct Debit,Reading,GB,9074,user_001,rec_3a34d62842,
73d7ef78-8fa4-440d-8bab-ec50ccd60321,2024-11-11,2024-11-12,Local Market,5499,Groceries,Specialty,-7.89,GBP,-19797.75,POS,London,GB,4488,user_002,,
5703673e-1602-4abe-b508-a54ed8b4acbc,2024-11-12,2024-11-12,Sainsbury's,5411,Groceries,Supermarket,-52.77,GBP,-19850.52,POS,London,GB,9074,user_001,,
dd8a887b-4524-4d05-abc0-d4f64ebbe31f,2024-11-12,2024-11-14,Apple.com/bill,5734,Shopping,Electronics,-97.16,GBP,-19947.68,E-Com,Cupertino,US,1045,user_001,,
1dfa2da4-3bbf-4b49-ad41-01449355b0ea,2024-11-13,2024-11-14,City Council Tax,9399,Utilities,Council Tax,-166.59,GBP,-20114.27,Direct Debit,London,GB,4488,user_001,rec_f531495db5,
20d816b3-13b2-4d9c-9115-b415ae828d0a,2024-11-13,2024-11-15,Local Market,5499,Groceries,Specialty,-14.71,GBP,-20128.98,POS,London,GB,9074,user_001,,
408e2fc4-60bd-4dea-8ccb-f71a4898b323,2024-11-13,2024-11-13,Airline Refund,4511,Travel,Refund,5.2,GBP,-20123.78,Credit,London,GB,4488,user_001,,Refund for Pret A Manger
9d49792f-85ac-484e-8a57-4f17d6fc87d1,2024-11-14,2024-11-15,Uber UK,4121,Transport,Ride Hailing,-21.32,GBP,-20145.1,E-Com,London,GB,1045,user_001,,
a1b288a1-0a68-4754-95e4-73f466125d85,2024-11-14,2024-11-14,Apple.com/bill,5734,Shopping,Electronics,-98.89,GBP,-20243.99,E-Com,Cupertino,US,9074,user_001,,
bf6d6879-f84a-48c7-828d-a7f11254708a,2024-11-14,2024-11-14,Apple.com/bill,5734,Shopping,Electronics,-92.75,GBP,-20336.74,E-Com,Cupertino,US,4488,user_001,,
afb2ce46-aceb-4b04-8a15-cffbdfdff8b7,2024-11-15,2024-11-18,O2 UK,4814,Bills,Mobile,-40.1,GBP,-20376.84,Direct Debit,Slough,GB,2219,user_002,rec_d2dce4c42f,
3ba6a4bc-4272-4462-94e0-3a5bf90ca540,2024-11-16,2024-11-18,Pret A Manger,5814,Food & Drink,Eating Out,-9.79,GBP,-20386.63,POS,London,GB,4488,user_001,,
b343513e-6592-441e-9068-7f92b3d6796c,2024-11-16,2024-11-18,Tesco,5411,Groceries,Supermarket,-74.9,GBP,-20461.53,POS,London,GB,2219,user_001,,
0d9abfff-cbd3-4d40-9e08-40e4f9584a79,2024-11-17,2024-11-18,Uber UK,4121,Transport,Ride Hailing,-11.37,GBP,-20472.9,E-Com,London,GB,1045,user_001,,
c06f057a-4a30-4808-bfaf-7b5192f08900,2024-11-17,2024-11-18,Shell,5541,Transport,Fuel,-76.67,GBP,-20549.57,POS,London,GB,4488,user_001,,
c3e8528c-b919-4ddc-aa42-82783aec83ab,2024-11-17,2024-11-18,Transport for London,4111,Transport,Transit,-7.61,GBP,-20557.18,POS,London,GB,2219,user_001,,
e4ab750d-ccbb-456e-be6e-ecb48ee11ffb,2024-11-17,2024-11-19,Apple.com/bill,5734,Shopping,Electronics,-3.55,GBP,-20560.73,E-Com,Cupertino,US,2219,user_001,,
257b2c56-dc36-48d2-9f08-9941ff1c314c,2024-11-18,2024-11-18,Apple.com/bill,5734,Shopping,Electronics,-141.81,GBP,-20702.54,E-Com,Cupertino,US,2219,user_001,,
896cbe31-71b1-43b8-b198-f9ca69c561b7,2024-11-18,2024-11-18,Local Market,5499,Groceries,Specialty,-8.98,GBP,-20711.52,POS,London,GB,4488,user_001,,
e080f4a9-4db2-486f-b604-58f937bcf0f0,2024-11-18,2024-11-18,GymBox,7997,Wellness,Gym,-53.52,GBP,-20765.04,Direct Debit,London,GB,1045,user_001,rec_3906953fd2,
07b613fc-62bc-4186-9d8c-17c4d93cf0a5,2024-11-19,2024-11-19,ATM Withdrawal,6011,Cash,ATM,-114.52,GBP,-20879.56,ATM,London,GB,2219,user_002,,
3d711267-c7b4-4d9d-a6e5-abdc6f08d545,2024-11-19,2024-11-19,Pret A Manger,5814,Food & Drink,Eating Out,-11.12,GBP,-20890.68,POS,London,GB,9074,user_002,,
be11dd2d-9aa8-4520-b3ac-8601f983070f,2024-11-19,2024-11-20,Spotify,5735,Entertainment,Subscriptions,-8.03,GBP,-20898.71,E-Com,Stockholm,SE,9074,user_001,rec_4c746d2c3b,
260e2721-f814-426e-8077-140d60b26346,2024-11-20,2024-11-22,Uber UK,4121,Transport,Ride Hailing,-22.15,GBP,-20920.86,E-Com,London,GB,1045,user_002,,
711d5b01-eb46-4b2c-93cb-dc7a9035fc88,2024-11-20,2024-11-21,Shell,5541,Transport,Fuel,-39.1,GBP,-20959.96,POS,London,GB,2219,user_001,,
7ba2b172-7c17-4899-a0df-cbead8a751bb,2024-11-20,2024-11-20,Waitrose,5411,Groceries,Supermarket,-31.46,GBP,-20991.42,POS,London,GB,2219,user_001,,
8f2b6cc0-6756-43b5-b633-108236c9128e,2024-11-20,2024-11-22,Amazon UK,5942,Shopping,Online Retail,-102.61,GBP,-21094.03,E-Com,London,GB,4488,user_001,,
9853762b-d2ed-46ae-83ab-1f5cdef62fbc,2024-11-20,2024-11-22,Amazon UK,5942,Shopping,Online Retail,-48.28,GBP,-21142.31,E-Com,London,GB,2219,user_001,,
b11bc00e-8938-489b-9399-2d2509a0f047,2024-11-20,2024-11-22,Sainsbury's,5411,Groceries,Supermarket,-56.62,GBP,-21198.93,POS,London,GB,4488,user_001,,
400ea86b-3455-44a6-801e-da45a3384647,2024-11-21,2024-11-21,Apple.com/bill,5734,Shopping,Electronics,-70.74,GBP,-21269.67,E-Com,Cupertino,US,1045,user_001,,
b484f9b3-4d37-42a8-898d-ec5f4f2aae60,2024-11-21,2024-11-21,Netflix,7841,Entertainment,Subscriptions,-15.86,GBP,-21285.53,E-Com,Los Gatos,US,1045,user_001,rec_1bfe33738d,
3ec1d360-5e48-4029-af23-500a573da9dc,2024-11-22,2024-11-22,Uber UK,4121,Transport,Ride Hailing,-28.05,GBP,-21313.58,E-Com,London,GB,2219,user_002,,
5d359ae0-fc8e-437b-b7a5-ff42315aaec0,2024-11-22,2024-11-25,Transport for London,4111,Transport,Transit,-7.27,GBP,-21320.85,POS,London,GB,4488,user_001,,
5f7e446d-c4f2-4e44-a2b7-ebf0f3644b7e,2024-11-22,2024-11-25,Amazon UK,5942,Shopping,Online Retail,-109.37,GBP,-21430.22,E-Com,London,GB,1045,user_002,,
6c005fd5-3c05-4daf-b4dc-a39010a489a2,2024-11-23,2024-11-25,Local Market,5499,Groceries,Specialty,-18.16,GBP,-21448.38,POS,London,GB,9074,user_001,,
e0d32392-fc0b-4db3-a280-5b9239142a78,2024-11-23,2024-11-25,Sainsbury's,5411,Groceries,Supermarket,-49.96,GBP,-21498.34,POS,London,GB,4488,user_001,,
fdc6ae84-adec-4543-9af4-e5a950c0023e,2024-11-23,2024-11-25,Tesco,5411,Groceries,Supermarket,-80.05,GBP,-21578.39,POS,London,GB,4488,user_001,,
26d60d5b-5948-4c46-9408-bde6a6fca08f,2024-11-24,2024-11-26,Local Market,5499,Groceries,Specialty,-8.91,GBP,-21587.3,POS,London,GB,1045,user_001,,
271860d4-0bcf-4ca7-8aef-afc5f98ed11c,2024-11-24,2024-11-25,Local Market,5499,Groceries,Specialty,-10.11,GBP,-21597.41,POS,London,GB,4488,user_001,,
545c8fb0-def0-44bb-a512-7055d4b68094,2024-11-24,2024-11-25,Deliveroo,5812,Food & Drink,Delivery,-28.75,GBP,-21626.16,E-Com,London,GB,1045,user_001,,
5c6c6fe2-367d-4c6c-8f97-239c4cfac535,2024-11-24,2024-11-25,Shell,5541,Transport,Fuel,-79.25,GBP,-21705.41,POS,London,GB,1045,user_002,,
5fc6f27b-590e-41df-8625-0a96a71c3cf9,2024-11-24,2024-11-26,Amazon UK,5942,Shopping,Online Retail,-42.13,GBP,-21747.54,E-Com,London,GB,9074,user_001,,
b671fe96-d6b1-4759-b30f-3541d3aed478,2024-11-24,2024-11-25,Tesco,5411,Groceries,Supermarket,-63.23,GBP,-21810.77,POS,London,GB,4488,user_001,,
db366c39-89f0-47ad-a9e3-be8867f14d29,2024-11-24,2024-11-25,Apple.com/bill,5734,Shopping,Electronics,-151.15,GBP,-21961.92,E-Com,Cupertino,US,4488,user_001,,
bf4b9ae8-fed3-403c-bc07-651f93966b50,2024-11-25,2024-11-26,Apple.com/bill,5734,Shopping,Electronics,-119.31,GBP,-22081.23,E-Com,Cupertino,US,9074,user_001,,
df0119ce-783a-4367-8f2c-6cdd5b9bef4e,2024-11-25,2024-11-25,T212 Capital,6011,Income,Salary,2998.58,GBP,-19082.65,Credit,London,GB,1045,user_001,rec_2ff8f778d0,
398b1f49-3804-4255-acaf-e38616ede858,2024-11-26,2024-11-27,Waitrose,5411,Groceries,Supermarket,-25.51,GBP,-19108.16,POS,London,GB,9074,user_001,,
7a232180-fd33-4f7c-9c9f-9ca0e97e81b7,2024-11-26,2024-11-28,Local Market,5499,Groceries,Specialty,-7.59,GBP,-19115.75,POS,London,GB,1045,user_001,,
8cf91030-f037-42e5-a4de-0cf195eec909,2024-11-26,2024-11-27,Local Market,5499,Groceries,Specialty,-11.66,GBP,-19127.41,POS,London,GB,1045,user_001,,
70974067-589a-4dba-897e-e65b42c4ae2c,2024-11-27,2024-11-27,Transport for London,4111,Transport,Transit,-7.9,GBP,-19135.31,POS,London,GB,9074,user_001,,
99eb5eff-23e2-405a-a7f4-d3988612eaea,2024-11-27,2024-11-27,Uber UK,4121,Transport,Ride Hailing,-26.9,GBP,-19162.21,E-Com,London,GB,1045,user_001,,
c7b3c483-5c38-477e-a9c5-c73e2dd94848,2024-11-27,2024-11-29,Tesco,5411,Groceries,Supermarket,-32.29,GBP,-19194.5,POS,London,GB,1045,user_002,,
0b04c294-0c0a-42f9-a97e-ca71c2dca3ef,2024-11-28,2024-11-28,HM Revenue & Customs,9311,Income,Tax Refund,6.15,GBP,-19188.35,Credit,London,GB,4488,user_001,,Refund for Uber UK
7c964cc0-ae2b-431a-8f5c-249d18ec4c6b,2024-11-28,2024-11-29,Waitrose,5411,Groceries,Supermarket,-84.79,GBP,-19273.14,POS,London,GB,4488,user_001,,
d692e751-30e4-48ef-8047-08be4fa9b63c,2024-11-28,2024-11-28,HM Revenue & Customs,9311,Income,Tax Refund,2.78,GBP,-19270.36,Credit,London,GB,9074,user_001,,Refund for Apple.com/bill
1a293446-4857-478b-86e1-b40d378e05c1,2024-11-30,2024-12-02,Transport for London,4111,Transport,Transit,-6.16,GBP,-19276.52,POS,London,GB,4488,user_001,,
b9b4fdc7-bf2f-4b39-acca-3f231ddfe47c,2024-11-30,2024-12-02,Sainsbury's,5411,Groceries,Supermarket,-50.48,GBP,-19327.0,POS,London,GB,1045,user_001,,
bee08268-ee0c-42b5-b11e-6dfa2795680e,2024-11-30,2024-12-02,Amazon UK,5942,Shopping,Online Retail,-76.31,GBP,-19403.31,E-Com,London,GB,1045,user_001,,
e9255bf3-a561-4a92-bfe2-98785cfdf657,2024-11-30,2024-12-02,Amazon UK,5942,Shopping,Online Retail,-86.67,GBP,-19489.98,E-Com,London,GB,2219,user_001,,
6ac597f0-782c-4740-aa1f-78781a6d30b3,2024-12-01,2024-12-03,Sainsbury's,5411,Groceries,Supermarket,-22.98,GBP,-19512.96,POS,London,GB,4488,user_001,,
876fc834-2666-4e61-92b5-3b9f65c50a82,2024-12-01,2024-12-02,Deliveroo,5812,Food & Drink,Delivery,-19.67,GBP,-19532.63,E-Com,London,GB,9074,user_002,,
a4ac8da5-9684-472c-a4fc-7c11f13083f3,2024-12-01,2024-12-03,Apple.com/bill,5734,Shopping,Electronics,-103.42,GBP,-19636.05,E-Com,Cupertino,US,1045,user_001,,
6f753b65-06b8-4d6c-9e90-94cd028cab07,2024-12-02,2024-12-04,Crown Estates Lettings,6513,Housing,Rent,-1647.91,GBP,-21283.96,POS,London,GB,1045,user_001,rec_19f70fbcce,
d5ad8d47-324c-4d67-985e-6966b6d26316,2024-12-02,2024-12-04,Pret A Manger,5814,Food & Drink,Eating Out,-6.35,GBP,-21290.31,POS,London,GB,2219,user_001,,
fea12efd-5fbe-49af-ae67-c1a172a0ea58,2024-12-03,2024-12-04,Amazon UK,5942,Shopping,Online Retail,-87.69,GBP,-21378.0,E-Com,London,GB,2219,user_001,,
c947e3e3-7efc-4cf6-a82b-214711c0fe1c,2024-12-04,2024-12-04,ATM Withdrawal,6011,Cash,ATM,-68.36,GBP,-21446.36,ATM,London,GB,9074,user_001,,
c50d5814-c808-4b18-bc40-03365e03b54a,2024-12-05,2024-12-05,Sainsbury's,5411,Groceries,Supermarket,-29.47,GBP,-21475.83,POS,London,GB,2219,user_002,,
40bd3300-b25a-44c5-929d-c5f21753008f,2024-12-06,2024-12-09,Sainsbury's,5411,Groceries,Supermarket,-20.71,GBP,-21496.54,POS,London,GB,9074,user_001,,
41999593-80d1-49a0-b42f-bdf6f05e48c8,2024-12-07,2024-12-09,Amazon UK,5942,Shopping,Online Retail,-65.5,GBP,-21562.04,E-Com,London,GB,4488,user_001,,
43653cf6-3de6-4ed8-915a-7a3e3817928c,2024-12-07,2024-12-09,Transport for London,4111,Transport,Transit,-8.94,GBP,-21570.98,POS,London,GB,1045,user_001,,
d45053d6-b69d-479d-90d9-db0a19a7b98a,2024-12-07,2024-12-09,Waitrose,5411,Groceries,Supermarket,-69.1,GBP,-21640.08,POS,London,GB,9074,user_001,,
f7bb52a7-cc58-4506-839c-e3307346f4c0,2024-12-07,2024-12-09,Shell,5541,Transport,Fuel,-80.34,GBP,-21720.42,POS,London,GB,9074,user_001,,
0dc0b984-09a7-431d-85cb-3fa66d462941,2024-12-08,2024-12-10,Amazon UK,5942,Shopping,Online Retail,-76.4,GBP,-21796.82,E-Com,London,GB,1045,user_001,,
2f349f32-bd11-4ed0-85e2-57ff95467868,2024-12-08,2024-12-09,Amazon UK,5942,Shopping,Online Retail,-99.76,GBP,-21896.58,E-Com,London,GB,9074,user_001,,
76920034-f51b-42a4-b2a8-232dd44aef24,2024-12-08,2024-12-10,Amazon UK,5942,Shopping,Online Retail,-60.35,GBP,-21956.93,E-Com,London,GB,9074,user_002,,
11a55d21-0662-4e0a-b4ac-819cd6cc952c,2024-12-09,2024-12-09,Octopus Energy,4900,Utilities,Electricity,-114.19,GBP,-22071.12,Direct Debit,London,GB,9074,user_001,rec_141a4a0666,
2c8bedc0-088d-4329-b051-1b1a3039079e,2024-12-09,2024-12-10,Local Market,5499,Groceries,Specialty,-9.13,GBP,-22080.25,POS,London,GB,4488,user_001,,
54e66188-0eb6-4d84-a8a3-7e2d7b429d50,2024-12-09,2024-12-09,Transport for London,4111,Transport,Transit,-6.85,GBP,-22087.1,POS,London,GB,4488,user_001,,
2fdb8845-a7f5-47d6-a607-f7c6db7c975b,2024-12-10,2024-12-10,Deliveroo,5812,Food & Drink,Delivery,-22.89,GBP,-22109.99,E-Com,London,GB,4488,user_001,,
3bc7b209-4f43-445d-b8bd-17904d99f257,2024-12-10,2024-12-12,Transport for London,4111,Transport,Transit,-4.61,GBP,-22114.6,POS,London,GB,1045,user_002,,
bcdf1435-271d-4af4-a7bf-13b22b124ff8,2024-12-10,2024-12-12,Shell,5541,Transport,Fuel,-55.38,GBP,-22169.98,POS,London,GB,4488,user_001,,
339e9c49-6516-49b5-9bd4-ff1688289b27,2024-12-11,2024-12-11,Amazon UK,5942,Shopping,Online Retail,-75.44,GBP,-22245.42,E-Com,London,GB,4488,user_001,,
735fd934-46d9-4a6f-b242-568af6ed1296,2024-12-11,2024-12-13,Thames Water,4900,Utilities,Water,-39.32,GBP,-22284.74,Direct Debit,Reading,GB,9074,user_001,rec_3a34d62842,
8379c8b1-3133-4222-9b82-49b9ca5a1c63,2024-12-11,2024-12-11,Amazon UK,5942,Shopping,Online Retail,-80.07,GBP,-22364.81,E-Com,London,GB,4488,user_001,,
e9c5b8d9-0f3a-45e9-a988-1ff76ed26391,2024-12-11,2024-12-13,Tesco,5411,Groceries,Supermarket,-49.6,GBP,-22414.41,POS,London,GB,9074,user_001,,
4715a0d2-dab6-4ee3-b612-f6fbaae068ea,2024-12-12,2024-12-13,Sainsbury's,5411,Groceries,Supermarket,-52.51,GBP,-22466.92,POS,London,GB,1045,user_001,,
7c6c82f7-7ed0-4df8-aa84-88bacaaa2d83,2024-12-12,2024-12-16,Transport for London,4111,Transport,Transit,-10.03,GBP,-22476.95,POS,London,GB,1045,user_001,,
7f63b023-822e-434e-996f-41335fb9243d,2024-12-12,2024-12-12,Sainsbury's,5411,Groceries,Supermarket,-36.94,GBP,-22513.89,POS,London,GB,1045,user_001,,
c56a6e98-592d-40d1-b986-7253cd3c5a41,2024-12-13,2024-12-16,City Council Tax,9399,Utilities,Council Tax,-176.15,GBP,-22690.04,Direct Debit,London,GB,4488,user_001,rec_f531495db5,
5651eacd-cb91-494c-aa5e-b3909773f7f3,2024-12-14,2024-12-16,Tesco,5411,Groceries,Supermarket,-33.71,GBP,-22723.75,POS,London,GB,4488,user_001,,
80923811-cf8d-4168-a689-fb16054c3b90,2024-12-14,2024-12-16,Uber UK,4121,Transport,Ride Hailing,-18.28,GBP,-22742.03,E-Com,London,GB,9074,user_001,,
a3481ffd-6048-4b27-8948-70ee0af418c7,2024-12-14,2024-12-16,Sainsbury's,5411,Groceries,Supermarket,-16.16,GBP,-22758.19,POS,London,GB,2219,user_001,,
d86982a7-3fbd-4c93-89dc-936e12a3d677,2024-12-14,2024-12-16,Tesco,5411,Groceries,Supermarket,-34.61,GBP,-22792.8,POS,London,GB,1045,user_001,,
e761325c-c71b-4d3f-a36a-b1f98bde58f3,2024-12-14,2024-12-16,Sainsbury's,5411,Groceries,Supermarket,-56.61,GBP,-22849.41,POS,London,GB,9074,user_001,,
15136962-7f61-40a8-883f-3ca77649a480,2024-12-15,2024-12-16,Apple.com/bill,5734,Shopping,Electronics,-207.6,GBP,-23057.01,E-Com,Cupertino,US,2219,user_002,,
47ac2786-3f17-45de-9c0b-009d789773ad,2024-12-15,2024-12-16,Deliveroo,5812,Food & Drink,Delivery,-26.29,GBP,-23083.3,E-Com,London,GB,2219,user_001,,
5aca30d8-2c05-4138-9d2e-4e9998701d12,2024-12-15,2024-12-17,Waitrose,5411,Groceries,Supermarket,-54.05,GBP,-23137.35,POS,London,GB,4488,user_001,,
80f72a4c-a449-4c1c-9cc2-59e79b2829dd,2024-12-15,2024-12-16,Amazon UK,5942,Shopping,Online Retail,-60.14,GBP,-23197.49,E-Com,London,GB,9074,user_002,,
aef4de5c-4ff6-4cee-97ce-d0819c63a643,2024-12-15,2024-12-16,Local Market,5499,Groceries,Specialty,-6.18,GBP,-23203.67,POS,London,GB,4488,user_001,,
bb958f02-1634-4846-8dfd-9139c0563855,2024-12-15,2024-12-17,Shell,5541,Transport,Fuel,-58.33,GBP,-23262.0,POS,London,GB,2219,user_001,,
edd005c2-d4f2-4685-acea-4c817ebb49cc,2024-12-15,2024-12-16,Pret A Manger,5814,Food & Drink,Eating Out,-5.52,GBP,-23267.52,POS,London,GB,1045,user_001,,
a103d6cf-8971-479b-b132-5734e6180886,2024-12-16,2024-12-18,O2 UK,4814,Bills,Mobile,-35.19,GBP,-23302.71,Direct Debit,Slough,GB,4488,user_001,rec_95042d8101,
47ea1fba-bd08-457c-80c0-fceb23152698,2024-12-17,2024-12-19,Deliveroo,5812,Food & Drink,Delivery,-29.19,GBP,-23331.9,E-Com,London,GB,9074,user_001,,
9dea24cd-9c77-40ae-9e4f-0da695e71d44,2024-12-17,2024-12-18,Transport for London,4111,Transport,Transit,-7.47,GBP,-23339.37,POS,London,GB,9074,user_001,,
a3aa4215-68f7-437f-b8c4-6671b16c6c8b,2024-12-17,2024-12-19,Amazon UK,5942,Shopping,Online Retail,-87.71,GBP,-23427.08,E-Com,London,GB,2219,user_001,,
ab7699db-2917-4041-9011-6d3e0b1e18dd,2024-12-17,2024-12-18,GymBox,7997,Wellness,Gym,-59.41,GBP,-23486.49,Direct Debit,London,GB,9074,user_001,rec_3906953fd2,
b3f01e13-cd4f-4c70-aa2e-279003e468ab,2024-12-18,2024-12-18,Apple.com/bill,5734,Shopping,Electronics,-73.9,USD,-23560.39,E-Com,Cupertino,US,2219,user_001,,FX purchase 93.1 USD @ rate 1.26
d3c8c592-e59b-4b8e-8fc1-bfdf390d9a08,2024-12-18,2024-12-19,Pret A Manger,5814,Food & Drink,Eating Out,-7.31,GBP,-23567.7,POS,London,GB,1045,user_001,,
108b0935-4229-4acf-8f4c-d03b7129b767,2024-12-19,2024-12-23,Uber UK,4121,Transport,Ride Hailing,-35.14,GBP,-23602.84,E-Com,London,GB,1045,user_002,,
7ee3df8a-4474-4f1a-9a3f-d1d9a5335580,2024-12-19,2024-12-20,Shell,5541,Transport,Fuel,-66.54,GBP,-23669.38,POS,London,GB,4488,user_001,,
bfe7e7d1-c149-4ae4-b558-597ce307c089,2024-12-19,2024-12-19,Spotify,5735,Entertainment,Subscriptions,-8.68,GBP,-23678.06,E-Com,Stockholm,SE,1045,user_002,rec_34b6e9e33f,
d4d7472b-984d-446f-b874-7dab85c1e1e9,2024-12-19,2024-12-23,Shell,5541,Transport,Fuel,-41.82,GBP,-23719.88,POS,London,GB,9074,user_001,,
df1e6cfe-6f38-42ec-bde4-1b6f7feeb880,2024-12-19,2024-12-23,Tesco,5411,Groceries,Supermarket,-20.35,GBP,-23740.23,POS,London,GB,2219,user_002,,
60ba5464-2d86-44e5-aa23-abba5b8e5987,2024-12-20,2024-12-23,Uber UK,4121,Transport,Ride Hailing,-23.65,GBP,-23763.88,E-Com,London,GB,1045,user_001,,
4d57826e-2212-4681-b361-3d4e2fcc2b70,2024-12-21,2024-12-23,Amazon UK,5942,Shopping,Online Retail,-92.47,GBP,-23856.35,E-Com,London,GB,1045,user_001,,
6dc00fb3-e3ec-46d9-b720-bf6360c69443,2024-12-21,2024-12-23,Amazon UK,5942,Shopping,Online Retail,-67.71,GBP,-23924.06,E-Com,London,GB,9074,user_002,,
eb4767e9-3d44-4884-b2de-7c0276317226,2024-12-21,2024-12-23,Tesco,5411,Groceries,Supermarket,-57.66,GBP,-23981.72,POS,London,GB,9074,user_001,,
ee16a944-9ece-42b7-be5d-76a7fcfaa718,2024-12-21,2024-12-23,Pret A Manger,5814,Food & Drink,Eating Out,-7.36,GBP,-23989.08,POS,London,GB,4488,user_001,,
1aa7c59e-76ac-4f1e-9a2e-7bdc4cdd05c2,2024-12-22,2024-12-23,Deliveroo,5812,Food & Drink,Delivery,-21.36,GBP,-24010.44,E-Com,London,GB,4488,user_001,,
b1f8b5ae-cfb8-40a2-b544-bfdaea68c285,2024-12-22,2024-12-23,Uber UK,4121,Transport,Ride Hailing,-27.19,GBP,-24037.63,E-Com,London,GB,9074,user_002,,
c69c0845-3520-460c-b213-7c27b7dfcbc1,2024-12-22,2024-12-24,Shell,5541,Transport,Fuel,-40.44,GBP,-24078.07,POS,London,GB,9074,user_002,,
ccebd8ef-7de7-4a88-b44e-33915283f551,2024-12-22,2024-12-23,Amazon UK,5942,Shopping,Online Retail,-91.22,GBP,-24169.29,E-Com,London,GB,2219,user_001,,
e6c0c9f0-a6b0-4223-b1ee-c5ad8c11da61,2024-12-22,2024-12-23,Amazon UK,5942,Shopping,Online Retail,-110.36,GBP,-24279.65,E-Com,London,GB,1045,user_001,,
fac0b9c3-e3ce-49f2-863b-c14ee50d9ff0,2024-12-22,2024-12-23,Apple.com/bill,5734,Shopping,Electronics,-8.6,USD,-24288.25,E-Com,Cupertino,US,4488,user_001,,FX purchase 10.78 USD @ rate 1.25
1530b235-52e1-4ec3-a49a-6854cc7f7276,2024-12-23,2024-12-23,Deliveroo,5812,Food & Drink,Delivery,-33.24,GBP,-24321.49,E-Com,London,GB,9074,user_001,,
3e77eb61-cc72-4930-9432-b3eb2dacdcb1,2024-12-23,2024-12-23,Netflix,7841,Entertainment,Subscriptions,-13.68,GBP,-24335.17,E-Com,Los Gatos,US,4488,user_001,rec_1bfe33738d,
80e96c10-ba0b-4249-8479-cdb682fc1e0e,2024-12-23,2024-12-25,Sainsbury's,5411,Groceries,Supermarket,-54.32,GBP,-24389.49,POS,London,GB,1045,user_002,,
d39ffa2d-acac-4ce2-89c5-49b29a642d70,2024-12-23,2024-12-25,Pret A Manger,5814,Food & Drink,Eating Out,-11.07,GBP,-24400.56,POS,London,GB,4488,user_001,,
20307360-28fb-4be1-985a-fadb489a192f,2024-12-24,2024-12-26,Uber UK,4121,Transport,Ride Hailing,-34.82,GBP,-24435.38,E-Com,London,GB,2219,user_001,,
85b7420e-0d39-4e5e-9c87-ef84687095c8,2024-12-24,2024-12-25,Tesco,5411,Groceries,Supermarket,-37.19,GBP,-24472.57,POS,London,GB,2219,user_001,,
f133edc3-15df-47f8-96b1-e28b2934c667,2024-12-24,2024-12-26,Amazon UK,5942,Shopping,Online Retail,-10.01,GBP,-24482.58,E-Com,London,GB,9074,user_001,,
0c6a303a-2ebd-4bd6-96d8-8aac5ffe126d,2024-12-25,2024-12-27,Deliveroo,5812,Food & Drink,Delivery,-16.44,GBP,-24499.02,E-Com,London,GB,9074,user_001,,
4a799cf3-b668-4d17-9e90-854fe09227a9,2024-12-25,2024-12-26,Deliveroo,5812,Food & Drink,Delivery,-31.72,GBP,-24530.74,E-Com,London,GB,2219,user_002,,
58d566da-322a-49d5-ad85-bf24d79c81b6,2024-12-25,2024-12-25,T212 Capital,6011,Income,Salary,2982.53,GBP,-21548.21,Credit,London,GB,2219,user_001,rec_2ff8f778d0,
d58dbba9-d11a-4261-93e8-e1301a3fa027,2024-12-25,2024-12-25,Transport for London,4111,Transport,Transit,-5.77,GBP,-21553.98,POS,London,GB,4488,user_001,,
ed257ded-3644-4fca-816b-f7a93c8b40fe,2024-12-25,2024-12-25,Tesco,5411,Groceries,Supermarket,-53.21,GBP,-21607.19,POS,London,GB,9074,user_001,,
35e2984b-427d-4d39-8c17-04c8a8535b5c,2024-12-26,2024-12-26,Waitrose,5411,Groceries,Supermarket,-61.14,GBP,-21668.33,POS,London,GB,2219,user_001,,
9913f7be-b4b8-4219-ab66-e365b38c250e,2024-12-26,2024-12-27,Local Market,5499,Groceries,Specialty,-18.51,GBP,-21686.84,POS,London,GB,1045,user_001,,
4bd58c2d-f985-47d6-93c4-3bee99ca23dc,2024-12-27,2024-12-30,Waitrose,5411,Groceries,Supermarket,-29.1,GBP,-21715.94,POS,London,GB,1045,user_001,,
16b616b7-f615-47e2-9bde-356eb3410d91,2024-12-28,2024-12-30,Local Market,5499,Groceries,Specialty,-7.66,GBP,-21723.6,POS,London,GB,2219,user_001,,
1e6a011a-5197-4cf1-8d3c-12ce7450bbd9,2024-12-28,2024-12-30,Amazon UK,5942,Shopping,Online Retail,-16.36,GBP,-21739.96,E-Com,London,GB,1045,user_001,,
2072d8e9-f55c-451d-9700-ecc539a91d98,2024-12-28,2024-12-30,Shell,5541,Transport,Fuel,-47.62,GBP,-21787.58,POS,London,GB,9074,user_001,,
2d1416ac-fecb-4d8b-bcf0-8ddba829d8e8,2024-12-28,2024-12-30,Amazon UK,5942,Shopping,Online Retail,-21.12,GBP,-21808.7,E-Com,London,GB,2219,user_001,,
54bfc7e1-7130-4851-8f1b-71c282780917,2024-12-28,2024-12-30,Amazon UK,5942,Shopping,Online Retail,-55.67,GBP,-21864.37,E-Com,London,GB,9074,user_002,,
8a8d3db4-2892-4941-98b0-2f22087f9a71,2024-12-28,2024-12-30,Shell,5541,Transport,Fuel,-30.67,GBP,-21895.04,POS,London,GB,2219,user_001,,
460add6f-f9db-41c3-bdbb-8ae266e8e954,2024-12-29,2024-12-31,Sainsbury's,5411,Groceries,Supermarket,-59.35,GBP,-21954.39,POS,London,GB,1045,user_001,,
4bd2c0e2-19d6-46b8-86f8-b360ef3f9972,2024-12-29,2024-12-30,Uber UK,4121,Transport,Ride Hailing,-34.12,GBP,-21988.51,E-Com,London,GB,4488,user_001,,
d278032c-2426-453e-9456-de1d54a08dd1,2024-12-29,2024-12-31,Local Market,5499,Groceries,Specialty,-14.29,GBP,-22002.8,POS,London,GB,4488,user_001,,
d82eb7a3-6e05-42a9-a9a9-7d6fef07ff31,2024-12-29,2024-12-31,Tesco,5411,Groceries,Supermarket,-71.67,GBP,-22074.47,POS,London,GB,1045,user_001,,
e6059ee2-0e29-48d1-8404-64512fe708d2,2024-12-29,2024-12-31,Sainsbury's,5411,Groceries,Supermarket,-27.91,GBP,-22102.38,POS,London,GB,4488,user_001,,
5eb162e3-10c6-4aed-8485-6c8ffb80ff93,2024-12-30,2024-12-30,Transport for London,4111,Transport,Transit,-8.25,GBP,-22110.63,POS,London,GB,1045,user_002,,
61465262-b779-4e9e-9d53-19f82c2e9349,2024-12-30,2025-01-01,Amazon UK,5942,Shopping,Online Retail,-73.41,GBP,-22184.04,E-Com,London,GB,2219,user_001,,
f5dea1d2-6905-4c83-ba28-4fd5f5542952,2024-12-30,2024-12-30,Uber UK,4121,Transport,Ride Hailing,-28.92,GBP,-22212.96,E-Com,London,GB,4488,user_001,,
25ff7c9a-69d8-4bfa-b088-88fd6e5f8463,2024-12-31,2025-01-01,Deliveroo,5812,Food & Drink,Delivery,-16.52,GBP,-22229.48,E-Com,London,GB,2219,user_001,,
42c94f09-66a6-4ea6-806a-85e98dd611bf,2024-12-31,2025-01-02,Uber UK,4121,Transport,Ride Hailing,-28.43,GBP,-22257.91,E-Com,London,GB,2219,user_001,,
737a9556-53a4-432a-a8c0-ba582c440a5a,2024-12-31,2025-01-01,Waitrose,5411,Groceries,Supermarket,-73.74,GBP,-22331.65,POS,London,GB,9074,user_001,,
82fa07e1-f3f8-4c71-8864-c5f8d7b11db7,2024-12-31,2025-01-01,Local Market,5499,Groceries,Specialty,-9.32,GBP,-22340.97,POS,London,GB,9074,user_001,,
15696f7a-11b2-478c-a3bf-7437e331931a,2025-01-01,2025-01-02,Waitrose,5411,Groceries,Supermarket,-26.8,GBP,-22367.77,POS,London,GB,4488,user_001,,
ded8aec7-d0cb-4103-be2c-aff4707db7c6,2025-01-01,2025-01-01,Crown Estates Lettings,6513,Housing,Rent,-1537.27,GBP,-23905.04,POS,London,GB,4488,user_001,rec_19f70fbcce,
ea814c99-0425-4efb-9548-66ff68909fbc,2025-01-01,2025-01-01,Sainsbury's,5411,Groceries,Supermarket,-42.62,GBP,-23947.66,POS,London,GB,1045,user_002,,
0d374d7c-41cb-4f51-a328-07c64486705e,2025-01-02,2025-01-02,Pret A Manger,5814,Food & Drink,Eating Out,-6.61,GBP,-23954.27,POS,London,GB,2219,user_001,,
ef29772a-d8c7-4d03-a6c3-7838202869b1,2025-01-02,2025-01-02,Shell,5541,Transport,Fuel,-51.35,GBP,-24005.62,POS,London,GB,1045,user_001,,
6fe2617c-2da6-4910-a676-6ea1bb9faac4,2025-01-03,2025-01-06,Shell,5541,Transport,Fuel,-40.92,GBP,-24046.54,POS,London,GB,2219,user_001,,
976b9989-2de5-4b0d-b8b5-78954ebf4f69,2025-01-03,2025-01-06,Tesco,5411,Groceries,Supermarket,-19.1,GBP,-24065.64,POS,London,GB,9074,user_002,,
213d5721-d059-4763-939b-1db61809a09d,2025-01-04,2025-01-06,Waitrose,5411,Groceries,Supermarket,-78.8,GBP,-24144.44,POS,London,GB,9074,user_001,,
56d2c0ee-2902-4e66-9473-08320143fb5a,2025-01-04,2025-01-06,Transport for London,4111,Transport,Transit,-11.4,GBP,-24155.84,POS,London,GB,9074,user_001,,
d8f0ce1f-3865-4c20-a0b7-1abe2e453ee8,2025-01-04,2025-01-06,Transport for London,4111,Transport,Transit,-4.34,GBP,-24160.18,POS,London,GB,2219,user_002,,
f905941a-8d75-44c5-9edd-32d8ec8adad3,2025-01-04,2025-01-06,Apple.com/bill,5734,Shopping,Electronics,-110.31,USD,-24270.49,E-Com,Cupertino,US,2219,user_001,,FX purchase 142.8 USD @ rate 1.29
563a66ea-fa47-4891-99b6-9acde41f34d8,2025-01-05,2025-01-06,Waitrose,5411,Groceries,Supermarket,-25.7,GBP,-24296.19,POS,London,GB,4488,user_001,,
7e509cd3-c1d9-49ad-9a05-68ed9322af78,2025-01-05,2025-01-07,Apple.com/bill,5734,Shopping,Electronics,-9.54,GBP,-24305.73,E-Com,Cupertino,US,4488,user_001,,
a4fd6bbf-3c7f-43aa-9ec5-d7a75984ffba,2025-01-05,2025-01-07,Apple.com/bill,5734,Shopping,Electronics,-183.86,USD,-24489.59,E-Com,Cupertino,US,1045,user_001,,FX purchase 231.39 USD @ rate 1.26
cb676d4e-20fe-403c-b4d2-50a094fbaddb,2025-01-05,2025-01-06,Deliveroo,5812,Food & Drink,Delivery,-13.34,GBP,-24502.93,E-Com,London,GB,4488,user_001,,
d122edaa-60ef-4176-9e38-8d1527cdd8fe,2025-01-05,2025-01-06,Amazon UK,5942,Shopping,Online Retail,-30.04,GBP,-24532.97,E-Com,London,GB,2219,user_001,,
d593f3cf-f718-43a5-9bf7-3ba3cb22fbb2,2025-01-05,2025-01-06,Waitrose,5411,Groceries,Supermarket,-34.6,GBP,-24567.57,POS,London,GB,2219,user_001,,
efc1f0c2-bbee-4a0d-88fb-3df086b43b42,2025-01-05,2025-01-06,Local Market,5499,Groceries,Specialty,-21.14,GBP,-24588.71,POS,London,GB,2219,user_001,,
95153ced-240a-4dd8-87db-9e67a97dffc1,2025-01-06,2025-01-06,Shell,5541,Transport,Fuel,-38.08,GBP,-24626.79,POS,London,GB,4488,user_001,,
5a6ea0a4-de0f-4d62-823b-0c89208d6adc,2025-01-07,2025-01-08,Octopus Energy,4900,Utilities,Electricity,-115.18,GBP,-24741.97,Direct Debit,London,GB,1045,user_001,rec_141a4a0666,
8ef97437-2d3e-40af-98e8-a25b854e5caa,2025-01-07,2025-01-07,Uber UK,4121,Transport,Ride Hailing,-24.26,GBP,-24766.23,E-Com,London,GB,4488,user_002,,
094a0195-6927-43a0-9d99-04ab0521958f,2025-01-08,2025-01-08,Pret A Manger,5814,Food & Drink,Eating Out,-10.75,GBP,-24776.98,POS,London,GB,4488,user_001,,
ef908df9-02f6-45d7-a79d-eebbd00497d0,2025-01-08,2025-01-09,Amazon UK,5942,Shopping,Online Retail,-46.36,GBP,-24823.34,E-Com,London,GB,4488,user_001,,
5bbbc519-5bfc-451b-bbb7-111ec0a201c2,2025-01-09,2025-01-09,Airline Refund,4511,Travel,Refund,20.85,GBP,-24802.49,Credit,London,GB,2219,user_001,,Refund for Deliveroo
97e865de-94a7-4398-99b9-a237aa9ae5f9,2025-01-11,2025-01-13,Sainsbury's,5411,Groceries,Supermarket,-32.46,GBP,-24834.95,POS,London,GB,9074,user_001,,
e422a617-7dd1-443b-a7f9-a0871851d8dd,2025-01-11,2025-01-13,Local Market,5499,Groceries,Specialty,-16.9,GBP,-24851.85,POS,London,GB,1045,user_001,,
1cc07130-d35f-4c64-848e-6c3239adb46d,2025-01-12,2025-01-14,Local Market,5499,Groceries,Specialty,-16.89,GBP,-24868.74,POS,London,GB,4488,user_001,,
f3c7a607-97df-41ec-b360-474ee1e8cc5a,2025-01-12,2025-01-13,Deliveroo,5812,Food & Drink,Delivery,-32.54,GBP,-24901.28,E-Com,London,GB,2219,user_001,,
f9a75104-4511-4ecd-bc6d-22d11a80f5f4,2025-01-12,2025-01-13,Shell,5541,Transport,Fuel,-33.14,GBP,-24934.42,POS,London,GB,4488,user_001,,
032e0dd9-d259-4570-83d3-85801d71a189,2025-01-13,2025-01-14,City Council Tax,9399,Utilities,Council Tax,-180.1,GBP,-25114.52,Direct Debit,London,GB,2219,user_001,rec_f531495db5,
2bc3e0fb-bbcf-4095-9b85-2e8abc7bfab3,2025-01-13,2025-01-13,Shell,5541,Transport,Fuel,-76.76,GBP,-25191.28,POS,London,GB,4488,user_001,,
4757bf9a-2000-472e-9b85-69f263127ffa,2025-01-13,2025-01-15,Deliveroo,5812,Food & Drink,Delivery,-23.25,GBP,-25214.53,E-Com,London,GB,2219,user_001,,
6f7fb549-38a7-429a-a2d0-c45a2219636a,2025-01-13,2025-01-15,Thames Water,4900,Utilities,Water,-34.14,GBP,-25248.67,Direct Debit,Reading,GB,2219,user_001,rec_3a34d62842,
a2359374-d111-43ed-9cb3-adfb82215dc3,2025-01-13,2025-01-13,Waitrose,5411,Groceries,Supermarket,-48.78,GBP,-25297.45,POS,London,GB,9074,user_001,,
bea5bf3a-ea8c-4f17-9546-1cf173f82f8b,2025-01-13,2025-01-14,Apple.com/bill,5734,Shopping,Electronics,-106.41,USD,-25403.86,E-Com,Cupertino,US,1045,user_001,,FX purchase 129.83 USD @ rate 1.22
3162f1d8-ea97-432b-b494-a974bef39f63,2025-01-14,2025-01-15,Uber UK,4121,Transport,Ride Hailing,-28.98,GBP,-25432.84,E-Com,London,GB,9074,user_001,,
4edc6682-6acc-413b-89d3-4852335a1f36,2025-01-14,2025-01-16,Sainsbury's,5411,Groceries,Supermarket,-19.6,GBP,-25452.44,POS,London,GB,1045,user_001,,
2ad1b5fb-86e5-45bc-9791-df1cc27242b2,2025-01-15,2025-01-15,Airline Refund,4511,Travel,Refund,5.75,GBP,-25446.69,Credit,London,GB,1045,user_001,,Refund for Local Market
3a81015a-87b7-4b4e-bd70-5ecb029f7672,2025-01-15,2025-01-16,Amazon UK,5942,Shopping,Online Retail,-110.94,GBP,-25557.63,E-Com,London,GB,1045,user_001,,
8c6d2ad8-f401-4ec0-82f6-829c64e7381d,2025-01-15,2025-01-17,Waitrose,5411,Groceries,Supermarket,-60.38,GBP,-25618.01,POS,London,GB,2219,user_001,,
b116cfd7-7bea-4f5d-984e-a33b6c6fd409,2025-01-15,2025-01-17,O2 UK,4814,Bills,Mobile,-53.49,GBP,-25671.5,Direct Debit,Slough,GB,9074,user_001,rec_95042d8101,
cb41d9e6-e412-4a72-a24b-8ea858b75395,2025-01-15,2025-01-16,Uber UK,4121,Transport,Ride Hailing,-15.37,GBP,-25686.87,E-Com,London,GB,1045,user_001,,
70212b94-5cc0-4b9e-8cf8-05fb7f4a620e,2025-01-16,2025-01-20,Tesco,5411,Groceries,Supermarket,-60.26,GBP,-25747.13,POS,London,GB,9074,user_001,,
7a364740-6c3b-43e4-b54c-4d19b807b970,2025-01-17,2025-01-20,GymBox,7997,Wellness,Gym,-57.7,GBP,-25804.83,Direct Debit,London,GB,1045,user_001,rec_3906953fd2,
c0d02e90-e33f-47a5-9207-737118843d36,2025-01-17,2025-01-20,Deliveroo,5812,Food & Drink,Delivery,-29.27,GBP,-25834.1,E-Com,London,GB,4488,user_002,,
c30fa4d1-5a99-4d63-879d-84540a918956,2025-01-17,2025-01-20,Uber UK,4121,Transport,Ride Hailing,-32.84,GBP,-25866.94,E-Com,London,GB,4488,user_002,,
2879b432-e4e6-4f9c-8210-fead2f8cf7f4,2025-01-18,2025-01-20,ATM Withdrawal,6011,Cash,ATM,-83.72,GBP,-25950.66,ATM,London,GB,2219,user_002,,
7937f019-4a9b-44f7-8e8d-dc71aa1c45b2,2025-01-18,2025-01-20,Apple.com/bill,5734,Shopping,Electronics,-85.75,GBP,-26036.41,E-Com,Cupertino,US,2219,user_001,,
85024459-8b0a-4627-9848-4ae2582f9b18,2025-01-18,2025-01-20,Uber UK,4121,Transport,Ride Hailing,-35.77,GBP,-26072.18,E-Com,London,GB,9074,user_001,,
866b8147-360b-4f12-8534-d4bdf1583e10,2025-01-18,2025-01-20,Shell,5541,Transport,Fuel,-42.1,GBP,-26114.28,POS,London,GB,9074,user_001,,
86b52ab6-706b-41cd-b726-e1a0ea75441e,2025-01-19,2025-01-20,Waitrose,5411,Groceries,Supermarket,-26.79,GBP,-26141.07,POS,London,GB,1045,user_001,,
27e2e165-3ee1-4160-a056-a00b0c58c25f,2025-01-20,2025-01-21,Spotify,5735,Entertainment,Subscriptions,-8.38,GBP,-26149.45,E-Com,Stockholm,SE,1045,user_001,rec_4c746d2c3b,
3c2f7389-2deb-408e-88cb-0d8660f64541,2025-01-20,2025-01-20,Pret A Manger,5814,Food & Drink,Eating Out,-9.7,GBP,-26159.15,POS,London,GB,1045,user_001,,
666c6d50-3f78-4053-af1c-8428f16c6e38,2025-01-20,2025-01-22,Tesco,5411,Groceries,Supermarket,-62.12,GBP,-26221.27,POS,London,GB,9074,user_001,,
5af806f3-f01a-49ec-bfb7-cc899a01fe14,2025-01-21,2025-01-22,Sainsbury's,5411,Groceries,Supermarket,-27.44,GBP,-26248.71,POS,London,GB,9074,user_001,,
8d4876a3-224c-4e78-9940-40272c642cfb,2025-01-21,2025-01-22,Netflix,7841,Entertainment,Subscriptions,-10.1,GBP,-26258.81,E-Com,Los Gatos,US,9074,user_001,rec_1bfe33738d,
04a3618f-0762-4561-b348-f43d585e4a03,2025-01-22,2025-01-23,Waitrose,5411,Groceries,Supermarket,-30.57,GBP,-26289.38,POS,London,GB,2219,user_001,,
4dbc4c72-9d03-4662-99d0-c3b405830d4a,2025-01-23,2025-01-24,Shell,5541,Transport,Fuel,-87.69,GBP,-26377.07,POS,London,GB,1045,user_001,,
c3c90b48-2a69-4672-9e00-f42fa18b26cf,2025-01-23,2025-01-23,Local Market,5499,Groceries,Specialty,-19.41,GBP,-26396.48,POS,London,GB,9074,user_001,,
c9cef8d2-72fd-490c-9222-3f7ce601bf66,2025-01-23,2025-01-24,Pret A Manger,5814,Food & Drink,Eating Out,-9.79,GBP,-26406.27,POS,London,GB,1045,user_001,,
e103d97a-8eba-4af2-9f0d-578811d76fc1,2025-01-23,2025-01-23,Transport for London,4111,Transport,Transit,-5.24,GBP,-26411.51,POS,London,GB,1045,user_001,,
38fcf828-60d3-4a4f-91f4-3de322bf8ac8,2025-01-24,2025-01-24,T212 Capital,6011,Income,Salary,3031.27,GBP,-23380.24,Credit,London,GB,1045,user_001,rec_2ff8f778d0,
b8df81ab-d65a-43a8-bd1c-ee8bc979b0ed,2025-01-24,2025-01-27,Tesco,5411,Groceries,Supermarket,-40.74,GBP,-23420.98,POS,London,GB,4488,user_001,,
04332814-a85b-4540-ba14-189a2a2123c1,2025-01-25,2025-01-27,Deliveroo,5812,Food & Drink,Delivery,-23.17,GBP,-23444.15,E-Com,London,GB,9074,user_002,,
d644b40d-7976-4adf-ab18-6aa4241f239f,2025-01-25,2025-01-27,Local Market,5499,Groceries,Specialty,-15.46,GBP,-23459.61,POS,London,GB,1045,user_001,,
ef171ab2-0639-4cef-95a6-796210f9be21,2025-01-25,2025-01-27,Amazon UK,5942,Shopping,Online Retail,-83.34,GBP,-23542.95,E-Com,London,GB,9074,user_001,,
8055200d-8be7-4db8-93c5-90fa79ae385c,2025-01-26,2025-01-27,Amazon UK,5942,Shopping,Online Retail,-12.55,GBP,-23555.5,E-Com,London,GB,9074,user_001,,
85577f05-948f-424e-a306-2f209cbf919a,2025-01-26,2025-01-28,Shell,5541,Transport,Fuel,-88.2,GBP,-23643.7,POS,London,GB,4488,user_001,,
87804dbb-393e-4d77-a7a8-316bfc23d474,2025-01-26,2025-01-27,Local Market,5499,Groceries,Specialty,-14.57,GBP,-23658.27,POS,London,GB,1045,user_002,,
a1f73c47-2185-4a43-a962-c825643cf1b2,2025-01-28,2025-01-30,Waitrose,5411,Groceries,Supermarket,-69.27,GBP,-23727.54,POS,London,GB,4488,user_001,,
e0682bc5-6838-4a14-9a6f-071053ff302b,2025-01-28,2025-01-30,Apple.com/bill,5734,Shopping,Electronics,-56.71,GBP,-23784.25,E-Com,Cupertino,US,9074,user_002,,
380b5203-9df7-466d-a9e6-1dc54b85ae3c,2025-01-29,2025-01-29,Uber UK,4121,Transport,Ride Hailing,-13.63,GBP,-23797.88,E-Com,London,GB,1045,user_001,,
708aa1d7-4b33-4d49-be5a-636a4a4cf810,2025-01-29,2025-01-29,Uber UK,4121,Transport,Ride Hailing,-28.62,GBP,-23826.5,E-Com,London,GB,1045,user_001,,
81d5baf6-2a34-47bc-bc97-a10669ff19fd,2025-01-29,2025-01-29,Tesco,5411,Groceries,Supermarket,-56.31,GBP,-23882.81,POS,London,GB,2219,user_001,,
c0626ada-5a12-471c-a11c-6b3208c73c0e,2025-01-29,2025-01-29,Transport for London,4111,Transport,Transit,-11.14,GBP,-23893.95,POS,London,GB,4488,user_001,,
29f222e0-3f09-47f2-8f0f-81abeb8a80bf,2025-01-30,2025-01-30,Pret A Manger,5814,Food & Drink,Eating Out,-6.9,GBP,-23900.85,POS,London,GB,4488,user_002,,
3fda3aa7-a0ed-457a-a213-39765066688e,2025-01-30,2025-01-30,Pret A Manger,5814,Food & Drink,Eating Out,-8.06,GBP,-23908.91,POS,London,GB,1045,user_002,,
97b4c2b0-7717-4f23-85c7-1170c7cbd664,2025-01-30,2025-02-03,Local Market,5499,Groceries,Specialty,-13.33,GBP,-23922.24,POS,London,GB,4488,user_002,,
ea7165cb-ef59-4482-87f5-0dc71b9fd8b7,2025-01-30,2025-01-31,Tesco,5411,Groceries,Supermarket,-57.9,GBP,-23980.14,POS,London,GB,4488,user_001,,
023e9b26-a518-43e3-b81f-c231298d0717,2025-01-31,2025-02-03,Shell,5541,Transport,Fuel,-57.95,GBP,-24038.09,POS,London,GB,9074,user_001,,
f8db660c-032c-41e4-8e12-409ced269f0e,2025-01-31,2025-02-03,Amazon UK,5942,Shopping,Online Retail,-58.86,GBP,-24096.95,E-Com,London,GB,1045,user_001,,
9704e72b-cf8d-48e9-8aae-bddb0039002d,2025-02-01,2025-02-03,Apple.com/bill,5734,Shopping,Electronics,-120.81,USD,-24217.76,E-Com,Cupertino,US,1045,user_001,,FX purchase 147.92 USD @ rate 1.22
d4e2947d-9c10-458d-a1af-010ab34890eb,2025-02-01,2025-02-03,Tesco,5411,Groceries,Supermarket,-54.1,GBP,-24271.86,POS,London,GB,4488,user_001,,
162606ea-9b25-42d5-8331-d50518528f82,2025-02-02,2025-02-04,Shell,5541,Transport,Fuel,-58.5,GBP,-24330.36,POS,London,GB,9074,user_001,,
19b3f178-f75a-4517-9691-cd462b27e1cb,2025-02-02,2025-02-03,Uber UK,4121,Transport,Ride Hailing,-33.3,GBP,-24363.66,E-Com,London,GB,2219,user_002,,
3bbe3d3b-bd89-4df1-9573-0e574d6e1c78,2025-02-03,2025-02-03,Crown Estates Lettings,6513,Housing,Rent,-1491.55,GBP,-25855.21,POS,London,GB,9074,user_002,rec_fc2ae06846,
b2bdd518-e100-48fb-b75d-443d5d5d1790,2025-02-03,2025-02-05,Local Market,5499,Groceries,Specialty,-18.01,GBP,-25873.22,POS,London,GB,9074,user_001,,
b7000f2e-8d14-4daa-bc7f-03e97101d93e,2025-02-03,2025-02-04,Uber UK,4121,Transport,Ride Hailing,-35.06,GBP,-25908.28,E-Com,London,GB,2219,user_001,,
4aea7f75-b567-4b8e-a314-bba7058dcd75,2025-02-04,2025-02-04,Airline Refund,4511,Travel,Refund,29.84,GBP,-25878.44,Credit,London,GB,9074,user_001,,Refund for Waitrose
df011e61-8fa3-4b53-a655-96ccbfa1a7a0,2025-02-04,2025-02-04,Tesco,5411,Groceries,Supermarket,-83.61,GBP,-25962.05,POS,London,GB,9074,user_001,,
5eb0d34c-a7d6-4358-81a6-fc279fd6f362,2025-02-05,2025-02-05,Uber UK,4121,Transport,Ride Hailing,-31.97,GBP,-25994.02,E-Com,London,GB,2219,user_002,,
56aaef16-a7c1-4456-a720-7b120b081793,2025-02-06,2025-02-06,Uber UK,4121,Transport,Ride Hailing,-27.86,GBP,-26021.88,E-Com,London,GB,1045,user_001,,
cb65693a-307f-43e6-8b6a-c78175dc30bd,2025-02-06,2025-02-07,Amazon UK,5942,Shopping,Online Retail,-78.69,GBP,-26100.57,E-Com,London,GB,2219,user_002,,
1ab50905-dd18-46db-8ea1-0323167a7401,2025-02-07,2025-02-07,Octopus Energy,4900,Utilities,Electricity,-134.78,GBP,-26235.35,Direct Debit,London,GB,9074,user_001,rec_141a4a0666,
98453753-75a0-40db-8099-c5f1271240ed,2025-02-07,2025-02-07,Pret A Manger,5814,Food & Drink,Eating Out,-11.84,GBP,-26247.19,POS,London,GB,9074,user_001,,
d8b5b41e-52a8-4728-b33c-cccd2ccf91ab,2025-02-07,2025-02-07,Uber UK,4121,Transport,Ride Hailing,-29.44,GBP,-26276.63,E-Com,London,GB,1045,user_001,,
222fa4a1-05b2-4bbc-8f37-43a4cb256a87,2025-02-08,2025-02-10,Pret A Manger,5814,Food & Drink,Eating Out,-6.19,GBP,-26282.82,POS,London,GB,9074,user_001,,
a749c83c-1fee-4b72-a08f-12e1343715ca,2025-02-08,2025-02-10,Uber UK,4121,Transport,Ride Hailing,-35.94,GBP,-26318.76,E-Com,London,GB,9074,user_001,,
fc31ad46-4939-4b50-b718-4c12efd1e3a7,2025-02-08,2025-02-10,Local Market,5499,Groceries,Specialty,-18.2,GBP,-26336.96,POS,London,GB,2219,user_001,,
af8c58f2-5762-4dc5-a747-b9482f15b5c4,2025-02-09,2025-02-10,Sainsbury's,5411,Groceries,Supermarket,-17.71,GBP,-26354.67,POS,London,GB,4488,user_001,,
ebda43af-2a78-4a6a-9245-c32105251b72,2025-02-09,2025-02-10,Sainsbury's,5411,Groceries,Supermarket,-31.0,GBP,-26385.67,POS,London,GB,9074,user_001,,
124c6faf-7ba6-4377-9cb7-b66be8680edb,2025-02-11,2025-02-13,Apple.com/bill,5734,Shopping,Electronics,-106.55,USD,-26492.22,E-Com,Cupertino,US,4488,user_001,,FX purchase 132.31 USD @ rate 1.24
17f9ce98-69ac-4701-8918-067148701e49,2025-02-11,2025-02-11,Thames Water,4900,Utilities,Water,-36.34,GBP,-26528.56,Direct Debit,Reading,GB,9074,user_001,rec_3a34d62842,
79230485-f18a-44ae-b3ee-8d028c7da942,2025-02-11,2025-02-12,Transport for London,4111,Transport,Transit,-6.76,GBP,-26535.32,POS,London,GB,2219,user_001,,
a8d61705-2625-4e87-8f32-87ecf1d755c8,2025-02-11,2025-02-11,Waitrose,5411,Groceries,Supermarket,-49.47,GBP,-26584.79,POS,London,GB,4488,user_001,,
e7b540de-ddf2-47bf-a5c2-960b9382db80,2025-02-11,2025-02-12,Amazon UK,5942,Shopping,Online Retail,-88.08,GBP,-26672.87,E-Com,London,GB,1045,user_001,,
fa7209ec-265d-45b1-a80e-b6ba825fbd66,2025-02-11,2025-02-13,Uber UK,4121,Transport,Ride Hailing,-14.79,GBP,-26687.66,E-Com,London,GB,1045,user_001,,
0ed3e6c1-1fe3-49be-a963-aa16567e1f6a,2025-02-13,2025-02-13,Uber UK,4121,Transport,Ride Hailing,-27.06,GBP,-26714.72,E-Com,London,GB,4488,user_001,,
8f4a978f-a5a8-4541-9d70-737a03cddab7,2025-02-13,2025-02-13,Amazon UK,5942,Shopping,Online Retail,-22.53,GBP,-26737.25,E-Com,London,GB,1045,user_001,,
d07a81ba-b1c9-40e0-b69d-9de4c0a83b77,2025-02-13,2025-02-17,City Council Tax,9399,Utilities,Council Tax,-180.95,GBP,-26918.2,Direct Debit,London,GB,9074,user_001,rec_f531495db5,
2cb1dc4d-bcea-40f8-b102-732f044c7612,2025-02-14,2025-02-14,Airline Refund,4511,Travel,Refund,9.19,GBP,-26909.01,Credit,London,GB,9074,user_001,,Refund for Local Market
acb98835-778a-4e54-82f3-a1f40b739a6d,2025-02-14,2025-02-14,Pret A Manger,5814,Food & Drink,Eating Out,-7.9,GBP,-26916.91,POS,London,GB,1045,user_001,,
dd2ab749-c938-4847-ba1d-ea9a9168ec69,2025-02-14,2025-02-14,Amazon UK,5942,Shopping,Online Retail,-82.43,GBP,-26999.34,E-Com,London,GB,4488,user_001,,
65d13d74-725e-4ec6-a7de-fbdd2d15c821,2025-02-15,2025-02-17,Waitrose,5411,Groceries,Supermarket,-31.1,GBP,-27030.44,POS,London,GB,4488,user_001,,
8eaf90fa-a0b4-4eb8-aa23-74c912ae5e1c,2025-02-15,2025-02-17,Deliveroo,5812,Food & Drink,Delivery,-14.55,GBP,-27044.99,E-Com,London,GB,9074,user_001,,
b995b045-5dd5-466c-9062-358a61c25eb6,2025-02-15,2025-02-17,Apple.com/bill,5734,Shopping,Electronics,-68.39,USD,-27113.38,E-Com,Cupertino,US,9074,user_001,,FX purchase 86.61 USD @ rate 1.27
1b9c7849-d2b5-411a-85ef-2383e2c676b5,2025-02-16,2025-02-17,Deliveroo,5812,Food & Drink,Delivery,-12.68,GBP,-27126.06,E-Com,London,GB,9074,user_001,,
97db3129-8b82-4771-8bed-70ac0c851b0c,2025-02-16,2025-02-18,Transport for London,4111,Transport,Transit,-7.89,GBP,-27133.95,POS,London,GB,1045,user_001,,
9ae8f0a6-a855-4a4c-bca7-bf2e3bc94f44,2025-02-16,2025-02-17,Pret A Manger,5814,Food & Drink,Eating Out,-9.36,GBP,-27143.31,POS,London,GB,9074,user_001,,
e63c1dc8-10d7-4ae8-9fc5-36d44047e0af,2025-02-16,2025-02-17,Apple.com/bill,5734,Shopping,Electronics,-148.42,GBP,-27291.73,E-Com,Cupertino,US,1045,user_002,,
39f61542-8a03-4935-9b9f-e440be95e095,2025-02-17,2025-02-17,Apple.com/bill,5734,Shopping,Electronics,-184.27,GBP,-27476.0,E-Com,Cupertino,US,1045,user_002,,
890e6462-4011-445c-842f-136e4b043997,2025-02-17,2025-02-18,Amazon UK,5942,Shopping,Online Retail,-13.11,GBP,-27489.11,E-Com,London,GB,1045,user_001,,
95dd6efd-b728-4e4f-92e9-64b157c603d3,2025-02-17,2025-02-17,GymBox,7997,Wellness,Gym,-55.49,GBP,-27544.6,Direct Debit,London,GB,9074,user_001,rec_3906953fd2,
aa8e478a-4a71-47d6-b07e-601569aa8785,2025-02-17,2025-02-18,Shell,5541,Transport,Fuel,-75.54,GBP,-27620.14,POS,London,GB,4488,user_001,,
e79f05f0-c29a-40d7-8ddc-27b9d6f1edfa,2025-02-17,2025-02-18,Shell,5541,Transport,Fuel,-73.77,GBP,-27693.91,POS,London,GB,2219,user_002,,
fe663848-4b89-4bad-9a83-fae3758ff27c,2025-02-17,2025-02-19,O2 UK,4814,Bills,Mobile,-41.42,GBP,-27735.33,Direct Debit,Slough,GB,1045,user_001,rec_95042d8101,
8a002fca-edd5-4309-a6d3-8800be4d6b7d,2025-02-18,2025-02-20,Waitrose,5411,Groceries,Supermarket,-24.24,GBP,-27759.57,POS,London,GB,9074,user_002,,
81c752cc-8860-48b4-ab3d-64600636b72c,2025-02-19,2025-02-21,Spotify,5735,Entertainment,Subscriptions,-9.5,GBP,-27769.07,E-Com,Stockholm,SE,2219,user_001,rec_4c746d2c3b,
0ba4db3e-5fdf-4685-b3dc-2ef022fd9be9,2025-02-20,2025-02-20,Pret A Manger,5814,Food & Drink,Eating Out,-6.02,GBP,-27775.09,POS,London,GB,4488,user_002,,
899fd4f5-5c0b-4087-9226-7054eac0a074,2025-02-21,2025-02-24,Uber UK,4121,Transport,Ride Hailing,-11.05,GBP,-27786.14,E-Com,London,GB,2219,user_001,,
aeb99fa7-7337-4997-bec3-e7a191d8b9f9,2025-02-21,2025-02-21,Netflix,7841,Entertainment,Subscriptions,-13.01,GBP,-27799.15,E-Com,Los Gatos,US,1045,user_001,rec_1bfe33738d,
42dcb7b4-4186-4b48-b93b-18c05a42b9f8,2025-02-22,2025-02-24,Local Market,5499,Groceries,Specialty,-9.02,GBP,-27808.17,POS,London,GB,9074,user_001,,
b050cf22-3c2b-456b-ad3e-73827d37fac2,2025-02-22,2025-02-24,Tesco,5411,Groceries,Supermarket,-69.13,GBP,-27877.3,POS,London,GB,1045,user_001,,
4c570371-0041-42a3-b82b-2d14e4f4e4e4,2025-02-23,2025-02-24,Shell,5541,Transport,Fuel,-75.24,GBP,-27952.54,POS,London,GB,1045,user_001,,
5fb47f02-5179-41e8-a942-71450561e4fc,2025-02-23,2025-02-24,Uber UK,4121,Transport,Ride Hailing,-18.69,GBP,-27971.23,E-Com,London,GB,2219,user_001,,
b66080a7-30d3-4471-aca8-4d33651e9842,2025-02-23,2025-02-25,Transport for London,4111,Transport,Transit,-10.13,GBP,-27981.36,POS,London,GB,4488,user_001,,
daec0acb-f2bc-4869-99c0-b4f55d687ae7,2025-02-23,2025-02-24,Waitrose,5411,Groceries,Supermarket,-82.8,GBP,-28064.16,POS,London,GB,1045,user_001,,
2475d229-0828-4f9d-8d8a-ee82116c805b,2025-02-24,2025-02-26,Amazon UK,5942,Shopping,Online Retail,-89.68,GBP,-28153.84,E-Com,London,GB,9074,user_001,,
3310e453-05bc-46f6-91b0-cc24ec99fa17,2025-02-25,2025-02-26,Local Market,5499,Groceries,Specialty,-6.24,GBP,-28160.08,POS,London,GB,1045,user_001,,
4f4251bc-7df5-4cce-b247-6dfe9ceae760,2025-02-25,2025-02-25,T212 Capital,6011,Income,Salary,3180.6,GBP,-24979.48,Credit,London,GB,1045,user_001,rec_2ff8f778d0,
a54d3348-bc08-426e-b98c-13580632d78d,2025-02-25,2025-02-25,Local Market,5499,Groceries,Specialty,-6.49,GBP,-24985.97,POS,London,GB,1045,user_001,,
1b537ad1-7262-4a74-846a-9ee64a7bf35b,2025-02-26,2025-02-26,Local Market,5499,Groceries,Specialty,-18.89,GBP,-25004.86,POS,London,GB,1045,user_002,,
87c5021d-e4c8-4a98-a8bd-2df849965308,2025-02-26,2025-02-26,Tesco,5411,Groceries,Supermarket,-22.73,GBP,-25027.59,POS,London,GB,4488,user_001,,
667e40ad-9d13-4a2e-87ff-fc0fad3c4879,2025-02-27,2025-03-03,Local Market,5499,Groceries,Specialty,-14.01,GBP,-25041.6,POS,London,GB,1045,user_001,,
d10ff2d2-b79c-4983-8412-4c766cc3c4b3,2025-02-27,2025-02-27,Apple.com/bill,5734,Shopping,Electronics,-81.97,GBP,-25123.57,E-Com,Cupertino,US,9074,user_001,,
924c6233-bc02-461d-943d-b320b62aa28c,2025-02-28,2025-03-03,Deliveroo,5812,Food & Drink,Delivery,-33.12,GBP,-25156.69,E-Com,London,GB,1045,user_001,,
dc61b9a1-a1dd-4c17-91e2-bc18d0dc6d7c,2025-02-28,2025-03-03,Apple.com/bill,5734,Shopping,Electronics,-107.66,GBP,-25264.35,E-Com,Cupertino,US,9074,user_002,,
0ddd4977-c221-4e09-8cd6-cd1084cfac6f,2025-03-01,2025-03-03,Deliveroo,5812,Food & Drink,Delivery,-16.59,GBP,-25280.94,E-Com,London,GB,4488,user_001,,
7ad3b077-87ef-46b1-abaa-88681e387627,2025-03-01,2025-03-03,Local Market,5499,Groceries,Specialty,-15.56,GBP,-25296.5,POS,London,GB,4488,user_001,,
863158cc-9861-4b78-960d-771e9e215b78,2025-03-01,2025-03-03,Tesco,5411,Groceries,Supermarket,-66.23,GBP,-25362.73,POS,London,GB,2219,user_002,,
a278d852-509e-49fc-8312-5a01dcb5980a,2025-03-01,2025-03-03,Waitrose,5411,Groceries,Supermarket,-22.18,GBP,-25384.91,POS,London,GB,4488,user_001,,
b4cabe34-8a12-4cae-82dd-c124a8799c24,2025-03-01,2025-03-03,Amazon UK,5942,Shopping,Online Retail,-117.95,GBP,-25502.86,E-Com,London,GB,9074,user_001,,
dba5bead-e877-4b6f-a659-4aa16d3bcc61,2025-03-01,2025-03-03,Pret A Manger,5814,Food & Drink,Eating Out,-7.52,GBP,-25510.38,POS,London,GB,9074,user_001,,
dfa2f690-b5f6-4ae9-bab4-ef6485706cc2,2025-03-01,2025-03-03,Pret A Manger,5814,Food & Drink,Eating Out,-5.79,GBP,-25516.17,POS,London,GB,1045,user_002,,
fda990b6-895d-4a56-90e2-51023ea1295a,2025-03-01,2025-03-03,Shell,5541,Transport,Fuel,-50.39,GBP,-25566.56,POS,London,GB,2219,user_002,,
6c6f5117-573e-4f69-b408-59750ddcbba7,2025-03-02,2025-03-03,Waitrose,5411,Groceries,Supermarket,-55.33,GBP,-25621.89,POS,London,GB,4488,user_001,,
a18db2b3-fb14-46d1-af00-56868b667c2a,2025-03-02,2025-03-03,Local Market,5499,Groceries,Specialty,-19.41,GBP,-25641.3,POS,London,GB,4488,user_001,,
a8d39f19-77d6-4ff6-a0a2-d60b091f3ad9,2025-03-02,2025-03-04,Local Market,5499,Groceries,Specialty,-9.5,GBP,-25650.8,POS,London,GB,2219,user_001,,
ab12e8e5-e6a7-4306-9ae1-1f00388dddf3,2025-03-02,2025-03-04,Amazon UK,5942,Shopping,Online Retail,-83.25,GBP,-25734.05,E-Com,London,GB,2219,user_001,,
ef09792e-594e-451a-b3f9-f9cd87e76249,2025-03-02,2025-03-03,Sainsbury's,5411,Groceries,Supermarket,-60.07,GBP,-25794.12,POS,London,GB,2219,user_001,,
4c8d7f30-7da9-46cb-b583-78699efe1851,2025-03-03,2025-03-04,Apple.com/bill,5734,Shopping,Electronics,-129.12,GBP,-25923.24,E-Com,Cupertino,US,2219,user_001,,
868798e1-02d5-482e-b84e-7910817dd694,2025-03-03,2025-03-04,Crown Estates Lettings,6513,Housing,Rent,-1612.04,GBP,-27535.28,POS,London,GB,1045,user_001,rec_19f70fbcce,
0d520bca-fe05-4cfb-94c0-3457d05af165,2025-03-04,2025-03-06,Pret A Manger,5814,Food & Drink,Eating Out,-11.42,GBP,-27546.7,POS,London,GB,2219,user_001,,
7b7e6e21-3e1d-42d5-8950-35b82cb39a1c,2025-03-05,2025-03-06,Local Market,5499,Groceries,Specialty,-18.59,GBP,-27565.29,POS,London,GB,9074,user_001,,
4f227659-0f65-40f9-89b5-c32527dfec36,2025-03-07,2025-03-07,Octopus Energy,4900,Utilities,Electricity,-142.83,GBP,-27708.12,Direct Debit,London,GB,9074,user_001,rec_141a4a0666,
9fd44134-341f-4227-b5cc-e1fad2f370e6,2025-03-07,2025-03-10,Deliveroo,5812,Food & Drink,Delivery,-23.92,GBP,-27732.04,E-Com,London,GB,9074,user_001,,
4244ff72-f77a-4213-9f7f-b7f9adc0ca8a,2025-03-08,2025-03-10,Local Market,5499,Groceries,Specialty,-11.0,GBP,-27743.04,POS,London,GB,2219,user_001,,
560a9a19-2b90-499e-bfc5-7ddbd0cec4f4,2025-03-08,2025-03-10,Deliveroo,5812,Food & Drink,Delivery,-23.32,GBP,-27766.36,E-Com,London,GB,2219,user_001,,
8a95e164-0f2c-4e9c-b49d-8223c53d89be,2025-03-09,2025-03-11,Waitrose,5411,Groceries,Supermarket,-39.38,GBP,-27805.74,POS,London,GB,4488,user_002,,
301a8d1c-0d8e-4531-8632-510589aa3595,2025-03-10,2025-03-10,Sainsbury's,5411,Groceries,Supermarket,-31.05,GBP,-27836.79,POS,London,GB,2219,user_001,,
a091e9b4-b1f5-40a6-8f06-ae47fa57f05c,2025-03-10,2025-03-12,Sainsbury's,5411,Groceries,Supermarket,-27.91,GBP,-27864.7,POS,London,GB,1045,user_001,,
ff6c3356-7670-4dec-aa67-e7754b8312e6,2025-03-10,2025-03-10,Local Market,5499,Groceries,Specialty,-13.9,GBP,-27878.6,POS,London,GB,2219,user_001,,
6d8c2e89-fa56-4c04-a9c4-d069601a7592,2025-03-11,2025-03-11,Apple.com/bill,5734,Shopping,Electronics,-160.71,GBP,-28039.31,E-Com,Cupertino,US,1045,user_002,,
7d5aacf9-7a52-45fa-bf7a-7b9fa46fee79,2025-03-11,2025-03-11,Thames Water,4900,Utilities,Water,-37.52,GBP,-28076.83,Direct Debit,Reading,GB,9074,user_001,rec_3a34d62842,
ceda7cc9-d679-45b2-9a47-575269f66b7e,2025-03-11,2025-03-11,Apple.com/bill,5734,Shopping,Electronics,-181.3,USD,-28258.13,E-Com,Cupertino,US,1045,user_001,,FX purchase 227.25 USD @ rate 1.25
ff6d5357-82ba-4422-9a2a-711980f1c4e9,2025-03-11,2025-03-12,Apple.com/bill,5734,Shopping,Electronics,-117.83,GBP,-28375.96,E-Com,Cupertino,US,9074,user_002,,
513f88c7-2699-42fa-8a5d-895e0d9b5809,2025-03-12,2025-03-14,Local Market,5499,Groceries,Specialty,-16.57,GBP,-28392.53,POS,London,GB,4488,user_001,,
9c5c892e-9236-4c12-a630-c8f93f3deedf,2025-03-12,2025-03-12,Transport for London,4111,Transport,Transit,-7.05,GBP,-28399.58,POS,London,GB,1045,user_001,,
88a44162-9bbe-415c-bf07-f25fc3db7a79,2025-03-13,2025-03-17,City Council Tax,9399,Utilities,Council Tax,-185.62,GBP,-28585.2,Direct Debit,London,GB,1045,user_002,rec_6feaa5d43f,
9688f304-2d0a-405d-a186-858f9c717d28,2025-03-13,2025-03-14,Deliveroo,5812,Food & Drink,Delivery,-27.65,GBP,-28612.85,E-Com,London,GB,2219,user_002,,
afd1ab9f-2d05-4301-ba5b-2b092fae8a4f,2025-03-13,2025-03-17,Local Market,5499,Groceries,Specialty,-14.43,GBP,-28627.28,POS,London,GB,4488,user_001,,
8063d6d9-3847-4104-a4f4-805cbeae897e,2025-03-14,2025-03-14,Uber UK,4121,Transport,Ride Hailing,-26.23,GBP,-28653.51,E-Com,London,GB,2219,user_001,,
0bbbf494-a3d2-427e-a0e3-83bd6d6edfa7,2025-03-15,2025-03-17,Pret A Manger,5814,Food & Drink,Eating Out,-8.45,GBP,-28661.96,POS,London,GB,1045,user_002,,
1497987a-5b2b-432b-997b-a5d2c2ad852b,2025-03-15,2025-03-17,Pret A Manger,5814,Food & Drink,Eating Out,-7.72,GBP,-28669.68,POS,London,GB,1045,user_001,,
439cd826-2c54-410b-9bf3-fa04cdc034db,2025-03-15,2025-03-17,Deliveroo,5812,Food & Drink,Delivery,-16.29,GBP,-28685.97,E-Com,London,GB,1045,user_002,,
50be5b63-17f9-4ba8-a64f-1c28a1c51c53,2025-03-15,2025-03-17,Amazon UK,5942,Shopping,Online Retail,-85.08,GBP,-28771.05,E-Com,London,GB,1045,user_001,,
9886d42a-8744-47b6-b128-3da5d0256f9b,2025-03-15,2025-03-17,Sainsbury's,5411,Groceries,Supermarket,-62.44,GBP,-28833.49,POS,London,GB,2219,user_002,,
2916e339-4fa2-4dcb-955d-0f38d254d18f,2025-03-16,2025-03-17,Pret A Manger,5814,Food & Drink,Eating Out,-7.8,GBP,-28841.29,POS,London,GB,9074,user_001,,
93b7ffad-59ec-4e7a-9dc2-3d24209f524b,2025-03-16,2025-03-17,Apple.com/bill,5734,Shopping,Electronics,-199.35,GBP,-29040.64,E-Com,Cupertino,US,1045,user_001,,
f2f26214-b3b0-4822-a0c2-3724cc885834,2025-03-16,2025-03-17,Shell,5541,Transport,Fuel,-77.2,GBP,-29117.84,POS,London,GB,4488,user_001,,
18e8c405-493a-488f-ab44-32f393524637,2025-03-17,2025-03-18,Tesco,5411,Groceries,Supermarket,-60.04,GBP,-29177.88,POS,London,GB,4488,user_001,,
61a8803d-ca46-482d-8669-e234b0159cc7,2025-03-17,2025-03-18,Sainsbury's,5411,Groceries,Supermarket,-66.91,GBP,-29244.79,POS,London,GB,4488,user_001,,
6d21a191-acf1-481f-9a4a-841a71821bd5,2025-03-17,2025-03-17,O2 UK,4814,Bills,Mobile,-42.68,GBP,-29287.47,Direct Debit,Slough,GB,4488,user_001,rec_95042d8101,
9f8c1122-cd24-440b-b6a8-08a46e145243,2025-03-17,2025-03-19,Pret A Manger,5814,Food & Drink,Eating Out,-7.41,GBP,-29294.88,POS,London,GB,1045,user_001,,
f0d35c19-5993-4206-9acf-4498a15b55c1,2025-03-17,2025-03-17,GymBox,7997,Wellness,Gym,-47.62,GBP,-29342.5,Direct Debit,London,GB,2219,user_001,rec_3906953fd2,
035b12d1-9894-4560-848a-4b1daaea9079,2025-03-19,2025-03-20,Spotify,5735,Entertainment,Subscriptions,-9.04,GBP,-29351.54,E-Com,Stockholm,SE,2219,user_002,rec_34b6e9e33f,
274583ce-c378-4ce6-9029-c634fef5e3ca,2025-03-19,2025-03-19,Shell,5541,Transport,Fuel,-88.76,GBP,-29440.3,POS,London,GB,4488,user_001,,
78674a7c-f960-4141-ab85-120e7f09564e,2025-03-20,2025-03-20,Shell,5541,Transport,Fuel,-66.43,GBP,-29506.73,POS,London,GB,1045,user_001,,
bc4dfa5e-a900-4129-be00-eb66ddfcdf25,2025-03-20,2025-03-21,Transport for London,4111,Transport,Transit,-4.57,GBP,-29511.3,POS,London,GB,2219,user_001,,
238c4c64-f1cd-47f4-b772-d886ca5f9735,2025-03-21,2025-03-24,Transport for London,4111,Transport,Transit,-9.51,GBP,-29520.81,POS,London,GB,9074,user_001,,
6985cc0e-ecff-443e-b06e-fba3ba17a4fd,2025-03-21,2025-03-24,Waitrose,5411,Groceries,Supermarket,-37.44,GBP,-29558.25,POS,London,GB,2219,user_002,,
97fcf9d0-2a40-489f-9858-6885d5a04e16,2025-03-21,2025-03-21,Tesco,5411,Groceries,Supermarket,-71.35,GBP,-29629.6,POS,London,GB,9074,user_001,,
c484f376-67f3-4093-adad-81d539db65b0,2025-03-21,2025-03-24,Local Market,5499,Groceries,Specialty,-20.67,GBP,-29650.27,POS,London,GB,4488,user_001,,
c8ac452c-ff36-4f1e-a045-948f257b1ced,2025-03-21,2025-03-24,Local Market,5499,Groceries,Specialty,-16.23,GBP,-29666.5,POS,London,GB,4488,user_002,,
d9ceeff3-af4e-4ff1-8c08-1453eb45e8d2,2025-03-21,2025-03-24,Netflix,7841,Entertainment,Subscriptions,-15.56,USD,-29682.06,E-Com,Los Gatos,US,1045,user_001,rec_1bfe33738d,FX purchase 19.24 USD @ rate 1.24
f87bc3c0-0373-48d3-9fde-9961e04e8916,2025-03-21,2025-03-21,Uber UK,4121,Transport,Ride Hailing,-10.27,GBP,-29692.33,E-Com,London,GB,1045,user_001,,
06ac0010-4823-4ea7-ac21-aef4415ff86a,2025-03-22,2025-03-24,Deliveroo,5812,Food & Drink,Delivery,-28.43,GBP,-29720.76,E-Com,London,GB,2219,user_001,,
208614a1-395b-4dc3-ad9a-3c68c789faf7,2025-03-22,2025-03-24,Transport for London,4111,Transport,Transit,-6.62,GBP,-29727.38,POS,London,GB,4488,user_001,,
23ad3fd9-895a-4c09-a2c1-70b624ae68cc,2025-03-22,2025-03-24,HM Revenue & Customs,9311,Income,Tax Refund,29.19,GBP,-29698.19,Credit,London,GB,2219,user_001,,Refund for Sainsbury's
71c884ec-17bb-47b0-8390-a8efb5df606c,2025-03-22,2025-03-24,Waitrose,5411,Groceries,Supermarket,-23.88,GBP,-29722.07,POS,London,GB,1045,user_002,,
da1771cf-e25c-4cb0-9c39-84364eb986e2,2025-03-22,2025-03-24,Waitrose,5411,Groceries,Supermarket,-63.29,GBP,-29785.36,POS,London,GB,1045,user_001,,
dadc0700-615b-4107-aa06-28f06d116e81,2025-03-22,2025-03-24,Apple.com/bill,5734,Shopping,Electronics,-28.57,GBP,-29813.93,E-Com,Cupertino,US,2219,user_002,,
e49c7839-8d96-49ac-9466-6302b9d884ff,2025-03-22,2025-03-24,Transport for London,4111,Transport,Transit,-6.82,GBP,-29820.75,POS,London,GB,4488,user_001,,
1fb4ce19-afce-47bb-96ca-1980fb9b4514,2025-03-23,2025-03-24,Airbnb,7011,Travel,Accommodation,-370.11,USD,-30190.86,E-Com,Dublin,IE,4488,user_002,,Business travel
26f3b17b-646b-4495-be36-4d3140dc0798,2025-03-23,2025-03-24,Transport for London,4111,Transport,Transit,-6.98,GBP,-30197.84,POS,London,GB,4488,user_001,,
47f5d265-2179-4904-af29-ea6e3f6e5452,2025-03-23,2025-03-24,Pret A Manger,5814,Food & Drink,Eating Out,-8.81,GBP,-30206.65,POS,London,GB,1045,user_002,,
56e2f6e8-36fe-47c6-a825-bfe075d7947f,2025-03-23,2025-03-25,Deliveroo,5812,Food & Drink,Delivery,-23.2,GBP,-30229.85,E-Com,London,GB,2219,user_001,,
8ecc1ed4-15f5-44b4-92d9-7ba145b63849,2025-03-23,2025-03-24,Pret A Manger,5814,Food & Drink,Eating Out,-11.9,GBP,-30241.75,POS,London,GB,2219,user_001,,
a701fed8-6b5e-45a3-9161-02e8728be71e,2025-03-23,2025-03-25,Transport for London,4111,Transport,Transit,-4.12,GBP,-30245.87,POS,London,GB,1045,user_001,,
f4bcea0c-7812-4654-80a6-069ba7ea33ac,2025-03-23,2025-03-24,Waitrose,5411,Groceries,Supermarket,-62.57,GBP,-30308.44,POS,London,GB,2219,user_002,,
1f4f71b3-70d1-486a-8e75-f4c933225502,2025-03-24,2025-03-25,Transport for London,4111,Transport,Transit,-4.61,GBP,-30313.05,POS,London,GB,9074,user_002,,
072d657c-f00c-4b66-a45e-b175305a597b,2025-03-25,2025-03-25,T212 Capital,6011,Income,Salary,3373.71,GBP,-26939.34,Credit,London,GB,1045,user_001,rec_2ff8f778d0,
28e04a5c-11e8-48f9-9c25-3a2a0d4c5aee,2025-03-25,2025-03-27,Deliveroo,5812,Food & Drink,Delivery,-33.45,GBP,-26972.79,E-Com,London,GB,2219,user_001,,
b7c91b9c-c6c9-40ec-9747-e92b0ecb73fc,2025-03-25,2025-03-26,Amazon UK,5942,Shopping,Online Retail,-108.31,GBP,-27081.1,E-Com,London,GB,1045,user_001,,
467549d9-cc07-4d1d-9adf-47d1c12b2d61,2025-03-26,2025-03-28,Waitrose,5411,Groceries,Supermarket,-58.32,GBP,-27139.42,POS,London,GB,2219,user_001,,
02d9f16b-16e8-4540-a9f4-64bbc099ab4f,2025-03-27,2025-03-31,Deliveroo,5812,Food & Drink,Delivery,-27.36,GBP,-27166.78,E-Com,London,GB,4488,user_001,,
ac88b69c-15fe-40aa-8f77-c97e5d1b2da9,2025-03-27,2025-03-31,Tesco,5411,Groceries,Supermarket,-23.9,GBP,-27190.68,POS,London,GB,1045,user_001,,
be04559a-42c4-417f-9eba-f61b950d4886,2025-03-27,2025-03-27,Transport for London,4111,Transport,Transit,-11.2,GBP,-27201.88,POS,London,GB,9074,user_002,,
9f2256ef-3ac9-4f6f-abc6-ddc1d7088fb8,2025-03-28,2025-03-31,ATM Withdrawal,6011,Cash,ATM,-77.07,GBP,-27278.95,ATM,London,GB,1045,user_001,,
22b36c74-356b-4dc3-970b-bbacef3821a6,2025-03-29,2025-03-31,Apple.com/bill,5734,Shopping,Electronics,-34.07,GBP,-27313.02,E-Com,Cupertino,US,1045,user_001,,
240d1e0c-33dc-4472-9070-2c794f0a86cb,2025-03-29,2025-03-31,Apple.com/bill,5734,Shopping,Electronics,-20.86,GBP,-27333.88,E-Com,Cupertino,US,1045,user_001,,
a1b55130-590b-441c-93e5-8f8946616bc5,2025-03-29,2025-03-31,Transport for London,4111,Transport,Transit,-5.25,GBP,-27339.13,POS,London,GB,4488,user_001,,
266985fa-fd15-42c4-8fdf-d0590adcbc3e,2025-03-30,2025-04-01,Amazon UK,5942,Shopping,Online Retail,-50.12,GBP,-27389.25,E-Com,London,GB,9074,user_001,,
58a09404-76c8-434a-a5b2-48ee4f8773c4,2025-03-30,2025-03-31,ATM Withdrawal,6011,Cash,ATM,-71.67,GBP,-27460.92,ATM,London,GB,1045,user_001,,
6c748fa0-9364-4fc8-a210-af9d5ec5cec9,2025-03-30,2025-03-31,Apple.com/bill,5734,Shopping,Electronics,-88.88,GBP,-27549.8,E-Com,Cupertino,US,4488,user_001,,
ce9642e2-c8e0-4b84-af06-d71272a7c5c7,2025-03-30,2025-04-01,Shell,5541,Transport,Fuel,-89.97,GBP,-27639.77,POS,London,GB,1045,user_002,,
31d5ffe1-d2e5-40eb-b34e-af624f00118b,2025-03-31,2025-04-02,Shell,5541,Transport,Fuel,-31.69,GBP,-27671.46,POS,London,GB,1045,user_001,,
398efe74-9a18-4156-bb20-dcf2e43ff6db,2025-03-31,2025-03-31,Tesco,5411,Groceries,Supermarket,-33.33,GBP,-27704.79,POS,London,GB,2219,user_002,,
4721862b-e775-40fc-be2a-7cffcc0ecd79,2025-04-01,2025-04-02,Shell,5541,Transport,Fuel,-30.93,GBP,-27735.72,POS,London,GB,1045,user_001,,
5c29a092-f329-41b1-bbff-5d565333434b,2025-04-01,2025-04-01,Tesco,5411,Groceries,Supermarket,-25.56,GBP,-27761.28,POS,London,GB,1045,user_001,,
bcb59021-62af-41e0-9cf1-269bbf861e4d,2025-04-01,2025-04-03,Crown Estates Lettings,6513,Housing,Rent,-1646.88,GBP,-29408.16,POS,London,GB,2219,user_001,rec_19f70fbcce,
03110f9d-6aa7-4def-8fac-0d858fe8b9f7,2025-04-02,2025-04-02,Waitrose,5411,Groceries,Supermarket,-35.35,GBP,-29443.51,POS,London,GB,4488,user_001,,
a95b901a-7b63-4711-b87b-ab9d6610e30c,2025-04-02,2025-04-04,Tesco,5411,Groceries,Supermarket,-55.65,GBP,-29499.16,POS,London,GB,4488,user_001,,
2b9542e4-2940-47f4-8c33-155916d49cd7,2025-04-03,2025-04-03,Amazon UK,5942,Shopping,Online Retail,-54.86,GBP,-29554.02,E-Com,London,GB,2219,user_001,,
36379446-b8b1-4991-bb79-4ffffeb72483,2025-04-03,2025-04-04,Tesco,5411,Groceries,Supermarket,-72.02,GBP,-29626.04,POS,London,GB,9074,user_001,,
7605198b-804c-42db-a07a-a52fe9a4ac89,2025-04-04,2025-04-07,Transport for London,4111,Transport,Transit,-9.89,GBP,-29635.93,POS,London,GB,1045,user_001,,
c5d77970-3072-476d-9f18-3e5de33604d3,2025-04-04,2025-04-07,Sainsbury's,5411,Groceries,Supermarket,-34.54,GBP,-29670.47,POS,London,GB,2219,user_001,,
2d182bef-acf5-4757-a972-4bd259ecf502,2025-04-05,2025-04-07,Transport for London,4111,Transport,Transit,-3.7,GBP,-29674.17,POS,London,GB,2219,user_002,,
7050f026-8a01-4994-81ae-357f067e34ae,2025-04-05,2025-04-07,Deliveroo,5812,Food & Drink,Delivery,-24.91,GBP,-29699.08,E-Com,London,GB,2219,user_001,,
92935fac-9b98-46ca-8723-0d168ec09e24,2025-04-05,2025-04-07,Pret A Manger,5814,Food & Drink,Eating Out,-6.55,GBP,-29705.63,POS,London,GB,9074,user_001,,
9e2c3ae4-89d9-4850-ac1f-02c7c0abe1fc,2025-04-05,2025-04-07,Shell,5541,Transport,Fuel,-50.49,GBP,-29756.12,POS,London,GB,2219,user_001,,
c0f8b236-2761-4126-b07c-ea12bd7ff522,2025-04-05,2025-04-07,Pret A Manger,5814,Food & Drink,Eating Out,-8.07,GBP,-29764.19,POS,London,GB,2219,user_001,,
f8617801-7487-45db-8925-1c118fb41b3d,2025-04-05,2025-04-07,Shell,5541,Transport,Fuel,-35.35,GBP,-29799.54,POS,London,GB,1045,user_001,,
f896e8a2-419e-49b4-a355-ecec107ac44f,2025-04-05,2025-04-07,Shell,5541,Transport,Fuel,-90.56,GBP,-29890.1,POS,London,GB,4488,user_001,,
370ff655-9e9b-4722-8d3b-ba7b90784091,2025-04-06,2025-04-07,Shell,5541,Transport,Fuel,-43.25,GBP,-29933.35,POS,London,GB,9074,user_002,,
5aec2a70-9220-4985-9e56-7d2e8f64475f,2025-04-06,2025-04-07,Shell,5541,Transport,Fuel,-46.66,GBP,-29980.01,POS,London,GB,2219,user_001,,
5fbf6ae0-eca3-4bac-ab5c-9f534034a372,2025-04-06,2025-04-08,Amazon UK,5942,Shopping,Online Retail,-79.99,GBP,-30060.0,E-Com,London,GB,1045,user_001,,
6cbbac17-bf97-4051-854c-8691b83ed4ac,2025-04-06,2025-04-08,Uber UK,4121,Transport,Ride Hailing,-34.51,GBP,-30094.51,E-Com,London,GB,1045,user_001,,
f82b2fe6-4325-4ca4-a709-c8f66ad9ea46,2025-04-07,2025-04-09,Octopus Energy,4900,Utilities,Electricity,-112.48,GBP,-30206.99,Direct Debit,London,GB,4488,user_001,rec_141a4a0666,
1bd397a6-f6bf-448d-838d-53b3faa9e1de,2025-04-09,2025-04-11,Pret A Manger,5814,Food & Drink,Eating Out,-11.16,GBP,-30218.15,POS,London,GB,1045,user_001,,
c037fb5b-cec0-4cf0-9a90-fc5958f474bf,2025-04-09,2025-04-11,Apple.com/bill,5734,Shopping,Electronics,-204.67,GBP,-30422.82,E-Com,Cupertino,US,1045,user_001,,
c517cd77-8d45-41d1-8c93-f44f99ecb4d6,2025-04-09,2025-04-09,Uber UK,4121,Transport,Ride Hailing,-22.25,GBP,-30445.07,E-Com,London,GB,9074,user_001,,
8ff8d1f6-90f2-410f-9e21-1fbcdf1929da,2025-04-11,2025-04-14,Thames Water,4900,Utilities,Water,-39.58,GBP,-30484.65,Direct Debit,Reading,GB,4488,user_001,rec_3a34d62842,
ed6fcf6b-1372-4057-91ac-749cfd4e4443,2025-04-11,2025-04-14,ATM Withdrawal,6011,Cash,ATM,-71.41,GBP,-30556.06,ATM,London,GB,9074,user_001,,
0e66e931-11cb-4d32-a5f2-432bcec9b910,2025-04-12,2025-04-14,Pret A Manger,5814,Food & Drink,Eating Out,-11.54,GBP,-30567.6,POS,London,GB,9074,user_001,,
3731d374-cec3-4bdb-ae35-d2ee314ed3f7,2025-04-12,2025-04-14,Waitrose,5411,Groceries,Supermarket,-35.12,GBP,-30602.72,POS,London,GB,1045,user_002,,
4e111416-dc6e-4420-967d-3c21698d3188,2025-04-12,2025-04-14,Local Market,5499,Groceries,Specialty,-9.36,GBP,-30612.08,POS,London,GB,1045,user_002,,
ea9454b0-4a86-4622-b40f-d5808eb65dff,2025-04-12,2025-04-14,Uber UK,4121,Transport,Ride Hailing,-35.42,GBP,-30647.5,E-Com,London,GB,2219,user_001,,
db422203-1b8e-4d8f-9ee6-1294662218d1,2025-04-13,2025-04-14,Transport for London,4111,Transport,Transit,-6.41,GBP,-30653.91,POS,London,GB,2219,user_001,,
db71de6a-842a-4f05-b285-1fb994ee2732,2025-04-13,2025-04-15,Sainsbury's,5411,Groceries,Supermarket,-24.35,GBP,-30678.26,POS,London,GB,1045,user_002,,
e945ea4d-6245-4da3-9c7a-19b05f5a2c2b,2025-04-13,2025-04-14,Deliveroo,5812,Food & Drink,Delivery,-31.38,GBP,-30709.64,E-Com,London,GB,2219,user_001,,
65e9d657-7873-4c66-9cab-9c1c715128ae,2025-04-14,2025-04-16,City Council Tax,9399,Utilities,Council Tax,-177.78,GBP,-30887.42,Direct Debit,London,GB,9074,user_002,rec_6feaa5d43f,
204cec05-ed01-42c0-acbe-00e402c9df52,2025-04-15,2025-04-16,Apple.com/bill,5734,Shopping,Electronics,-159.08,USD,-31046.5,E-Com,Cupertino,US,4488,user_001,,FX purchase 202.73 USD @ rate 1.27
cf6ded7d-50b0-4200-a8c3-480a7c71982b,2025-04-15,2025-04-17,O2 UK,4814,Bills,Mobile,-35.63,GBP,-31082.13,Direct Debit,Slough,GB,2219,user_001,rec_95042d8101,
63db2c4a-34b0-41b5-822a-6755ec28bfc9,2025-04-16,2025-04-18,Transport for London,4111,Transport,Transit,-3.71,GBP,-31085.84,POS,London,GB,4488,user_002,,
b4a86026-d191-456c-8b9e-cc21ef9b7ba8,2025-04-16,2025-04-18,Sainsbury's,5411,Groceries,Supermarket,-57.51,GBP,-31143.35,POS,London,GB,9074,user_001,,
0ef8fa00-9207-4529-931e-baf197e24ea6,2025-04-17,2025-04-18,Waitrose,5411,Groceries,Supermarket,-67.93,GBP,-31211.28,POS,London,GB,9074,user_001,,
9bb47295-29fd-4a0f-a54a-ac047d5c0827,2025-04-17,2025-04-21,GymBox,7997,Wellness,Gym,-62.41,GBP,-31273.69,Direct Debit,London,GB,2219,user_001,rec_3906953fd2,
1d607f05-b5a3-4ef1-9fe5-e985d7a7774e,2025-04-18,2025-04-21,Deliveroo,5812,Food & Drink,Delivery,-29.61,GBP,-31303.3,E-Com,London,GB,2219,user_001,,
8535c944-22de-49c2-9ee7-f0cab922cb8f,2025-04-18,2025-04-21,Waitrose,5411,Groceries,Supermarket,-46.09,GBP,-31349.39,POS,London,GB,2219,user_001,,
859857ad-a83c-4554-b6e1-765c9858e5b0,2025-04-18,2025-04-21,Transport for London,4111,Transport,Transit,-7.52,GBP,-31356.91,POS,London,GB,4488,user_002,,
a8f52f59-1ea4-49fc-a170-0527a1ce0177,2025-04-19,2025-04-21,Transport for London,4111,Transport,Transit,-7.55,GBP,-31364.46,POS,London,GB,1045,user_002,,
aea93487-0073-47ba-953f-2d853216cea8,2025-04-19,2025-04-21,Transport for London,4111,Transport,Transit,-8.36,GBP,-31372.82,POS,London,GB,2219,user_001,,
be854be3-f8e9-4a91-9cfe-f57faad58c61,2025-04-19,2025-04-21,Tesco,5411,Groceries,Supermarket,-54.7,GBP,-31427.52,POS,London,GB,4488,user_001,,
73b9274a-bd07-4b84-bd1e-0cca904faf3d,2025-04-20,2025-04-22,Deliveroo,5812,Food & Drink,Delivery,-24.29,GBP,-31451.81,E-Com,London,GB,1045,user_001,,
a116fb0a-8ac6-4963-8d8e-ab874602d71a,2025-04-20,2025-04-21,Tesco,5411,Groceries,Supermarket,-57.43,GBP,-31509.24,POS,London,GB,1045,user_001,,
f2b49fed-5abd-4918-866d-9fead8d0fe4f,2025-04-20,2025-04-21,Pret A Manger,5814,Food & Drink,Eating Out,-9.84,GBP,-31519.08,POS,London,GB,9074,user_001,,
67401665-7031-4a07-b543-a3128d634093,2025-04-21,2025-04-23,Shell,5541,Transport,Fuel,-53.33,GBP,-31572.41,POS,London,GB,9074,user_002,,
7c5bea5a-2112-495f-bdd3-20df493e3ad6,2025-04-21,2025-04-21,Netflix,7841,Entertainment,Subscriptions,-12.77,USD,-31585.18,E-Com,Los Gatos,US,2219,user_001,rec_1bfe33738d,FX purchase 16.59 USD @ rate 1.30
bbacb36c-f73d-4c2c-8258-e450879b84fe,2025-04-21,2025-04-21,Spotify,5735,Entertainment,Subscriptions,-8.23,GBP,-31593.41,E-Com,Stockholm,SE,9074,user_001,rec_4c746d2c3b,
fb209223-6e5f-4318-8182-bab15ba1477d,2025-04-21,2025-04-21,Tesco,5411,Groceries,Supermarket,-37.74,GBP,-31631.15,POS,London,GB,4488,user_001,,
29165df2-28e3-40b6-834f-f1d107b6fee8,2025-04-22,2025-04-23,Deliveroo,5812,Food & Drink,Delivery,-12.74,GBP,-31643.89,E-Com,London,GB,4488,user_001,,
0f0ff131-aa08-4318-9900-a896a0c64e9a,2025-04-23,2025-04-24,Waitrose,5411,Groceries,Supermarket,-39.6,GBP,-31683.49,POS,London,GB,9074,user_002,,
2db9c545-3cd3-4583-83d0-c36c75f323af,2025-04-23,2025-04-23,Shell,5541,Transport,Fuel,-33.41,GBP,-31716.9,POS,London,GB,4488,user_001,,
088cc8d6-6533-4ce2-811f-b38854f0fc3b,2025-04-24,2025-04-28,Shell,5541,Transport,Fuel,-79.54,GBP,-31796.44,POS,London,GB,4488,user_001,,
0b62256d-715a-4d10-9e4b-3d318a91552c,2025-04-24,2025-04-25,Waitrose,5411,Groceries,Supermarket,-83.16,GBP,-31879.6,POS,London,GB,1045,user_002,,
1d419c49-a03f-49f3-97a0-4d9402b252ce,2025-04-24,2025-04-25,Tesco,5411,Groceries,Supermarket,-39.18,GBP,-31918.78,POS,London,GB,2219,user_001,,
27af4da9-84c7-4dc4-bcf1-923a0519be31,2025-04-24,2025-04-24,Waitrose,5411,Groceries,Supermarket,-81.66,GBP,-32000.44,POS,London,GB,2219,user_001,,
77d63b16-7b5e-41ee-95e6-a9317bfbf0d2,2025-04-24,2025-04-28,Amazon UK,5942,Shopping,Online Retail,-20.16,GBP,-32020.6,E-Com,London,GB,2219,user_001,,
a7db3cf5-169c-40d6-983a-f68e183efb61,2025-04-24,2025-04-25,Uber UK,4121,Transport,Ride Hailing,-22.9,GBP,-32043.5,E-Com,London,GB,4488,user_001,,
b2069cf9-f681-4df8-b75d-dd364d8a4e2c,2025-04-24,2025-04-24,Tesco,5411,Groceries,Supermarket,-65.6,GBP,-32109.1,POS,London,GB,9074,user_001,,
d7e8fe75-d02e-404e-95cc-ff565c51ab06,2025-04-24,2025-04-25,Pret A Manger,5814,Food & Drink,Eating Out,-10.24,GBP,-32119.34,POS,London,GB,4488,user_001,,
5abb1229-d46b-4d9c-b768-77e845a4df4c,2025-04-25,2025-04-25,T212 Capital,6011,Income,Salary,3369.24,GBP,-28750.1,Credit,London,GB,4488,user_001,rec_2ff8f778d0,
5b920146-ac42-4bef-8172-c14b7f0a59c1,2025-04-26,2025-04-28,Transport for London,4111,Transport,Transit,-5.5,GBP,-28755.6,POS,London,GB,2219,user_001,,
7a64fdf0-5dda-400a-96d7-c98d74e582db,2025-04-26,2025-04-28,Shell,5541,Transport,Fuel,-67.66,GBP,-28823.26,POS,London,GB,1045,user_001,,
9d5f6449-c69b-402a-9e18-6b71ae9d8647,2025-04-26,2025-04-28,Tesco,5411,Groceries,Supermarket,-40.82,GBP,-28864.08,POS,London,GB,1045,user_001,,
be7dbfd4-0afa-487d-a2fb-ee4209ce2276,2025-04-26,2025-04-28,Local Market,5499,Groceries,Specialty,-6.31,GBP,-28870.39,POS,London,GB,1045,user_001,,
f3cb18d8-eb85-4287-937d-2ebad1099cf6,2025-04-26,2025-04-28,Tesco,5411,Groceries,Supermarket,-73.27,GBP,-28943.66,POS,London,GB,2219,user_001,,
007f2976-3194-4956-81ca-9d409321d19f,2025-04-27,2025-04-28,Tesco,5411,Groceries,Supermarket,-65.7,GBP,-29009.36,POS,London,GB,2219,user_001,,
cce33d9d-47aa-4daa-b409-39f6aa2b4ecf,2025-04-27,2025-04-28,Transport for London,4111,Transport,Transit,-5.75,GBP,-29015.11,POS,London,GB,1045,user_002,,
ff621e7f-4fb8-4fab-a471-f27cfb6744e4,2025-04-27,2025-04-28,Shell,5541,Transport,Fuel,-58.2,GBP,-29073.31,POS,London,GB,9074,user_001,,
5b3d5886-6214-4c78-9af7-ca5a1554702a,2025-04-28,2025-04-29,Pret A Manger,5814,Food & Drink,Eating Out,-9.97,GBP,-29083.28,POS,London,GB,1045,user_001,,
3b9925e6-aac5-4ee6-b3bc-2a679a9ae271,2025-04-29,2025-04-30,Tesco,5411,Groceries,Supermarket,-81.67,GBP,-29164.95,POS,London,GB,2219,user_001,,
b58a271c-1085-44b8-8908-9eae8a6c2534,2025-04-30,2025-05-02,Shell,5541,Transport,Fuel,-41.43,GBP,-29206.38,POS,London,GB,2219,user_001,,
13a2e5b6-f102-49b0-8ea1-66ffbc9a5b12,2025-05-01,2025-05-01,Uber UK,4121,Transport,Ride Hailing,-9.68,GBP,-29216.06,E-Com,London,GB,4488,user_002,,
c54349de-0620-4415-93cf-e0508b38854a,2025-05-01,2025-05-05,Crown Estates Lettings,6513,Housing,Rent,-1473.94,GBP,-30690.0,POS,London,GB,1045,user_001,rec_19f70fbcce,
f4530cc3-1af4-4f26-a3ff-d0ca371843dd,2025-05-01,2025-05-01,Transport for London,4111,Transport,Transit,-3.61,GBP,-30693.61,POS,London,GB,1045,user_002,,
87b3c476-a148-4b26-8032-5479ca9037bf,2025-05-02,2025-05-02,Airline Refund,4511,Travel,Refund,9.27,GBP,-30684.34,Credit,London,GB,9074,user_001,,Refund for Netflix
8f7de6ee-b5e7-423a-9746-c15d7f5bf673,2025-05-02,2025-05-05,Transport for London,4111,Transport,Transit,-7.42,GBP,-30691.76,POS,London,GB,1045,user_001,,
ae2493b0-1777-4dd0-a388-6209b2053cee,2025-05-02,2025-05-05,Local Market,5499,Groceries,Specialty,-16.56,GBP,-30708.32,POS,London,GB,2219,user_002,,
02c7d61b-6114-4e60-b14e-de7cd6b3a719,2025-05-03,2025-05-05,Apple.com/bill,5734,Shopping,Electronics,-61.27,GBP,-30769.59,E-Com,Cupertino,US,4488,user_001,,
08ba012c-7db3-4ccd-9e89-3406ba492ab2,2025-05-03,2025-05-05,Pret A Manger,5814,Food & Drink,Eating Out,-9.27,GBP,-30778.86,POS,London,GB,4488,user_001,,
75ab01f0-1cde-41ba-9a33-10e39165fe59,2025-05-03,2025-05-05,Amazon UK,5942,Shopping,Online Retail,-44.69,GBP,-30823.55,E-Com,London,GB,4488,user_001,,
7902bc9f-c1b5-45d3-82cc-2f1cf70dc794,2025-05-03,2025-05-05,Uber UK,4121,Transport,Ride Hailing,-15.85,GBP,-30839.4,E-Com,London,GB,2219,user_001,,
807dca2e-4421-4b01-90cb-63c2e83a101f,2025-05-03,2025-05-05,Shell,5541,Transport,Fuel,-91.42,GBP,-30930.82,POS,London,GB,1045,user_002,,
ad9b32eb-23fd-4576-a3d3-f37fb97a467d,2025-05-03,2025-05-05,Apple.com/bill,5734,Shopping,Electronics,-40.16,GBP,-30970.98,E-Com,Cupertino,US,1045,user_001,,
de5433e9-a6d5-4d7f-a976-d81607fb13ac,2025-05-03,2025-05-05,Shell,5541,Transport,Fuel,-73.31,GBP,-31044.29,POS,London,GB,4488,user_001,,
e3d13e80-93a8-4e93-8cf2-222347760a8b,2025-05-03,2025-05-05,Local Market,5499,Groceries,Specialty,-7.47,GBP,-31051.76,POS,London,GB,2219,user_002,,
13bcabdf-5224-43fb-afb9-1b278ba26a86,2025-05-04,2025-05-06,Local Market,5499,Groceries,Specialty,-17.98,GBP,-31069.74,POS,London,GB,9074,user_002,,
3f885271-0d09-410f-8890-e67e9a7c28b4,2025-05-04,2025-05-05,Deliveroo,5812,Food & Drink,Delivery,-14.6,GBP,-31084.34,E-Com,London,GB,9074,user_001,,
4428586d-7e6d-4658-9feb-05e54584feab,2025-05-04,2025-05-06,Shell,5541,Transport,Fuel,-77.13,GBP,-31161.47,POS,London,GB,1045,user_001,,
47b516b1-c8e7-48cc-b77e-d3b3b279318c,2025-05-04,2025-05-05,Pret A Manger,5814,Food & Drink,Eating Out,-9.98,GBP,-31171.45,POS,London,GB,9074,user_001,,
5b6b2a55-4630-4be8-8f8a-a89107d1f3cb,2025-05-04,2025-05-06,Deliveroo,5812,Food & Drink,Delivery,-32.2,GBP,-31203.65,E-Com,London,GB,1045,user_001,,
866fd0ad-db9c-43e8-bfbc-0bc4de3995eb,2025-05-04,2025-05-05,Sainsbury's,5411,Groceries,Supermarket,-21.71,GBP,-31225.36,POS,London,GB,9074,user_001,,
d643555e-73b2-4169-8f00-b1ae61c7d8c7,2025-05-04,2025-05-06,ATM Withdrawal,6011,Cash,ATM,-65.49,GBP,-31290.85,ATM,London,GB,4488,user_002,,
292e4489-bd1a-49ed-b171-91bdc088d512,2025-05-05,2025-05-06,Sainsbury's,5411,Groceries,Supermarket,-19.01,GBP,-31309.86,POS,London,GB,1045,user_002,,
a9e4ab7a-3537-4710-aa42-645633a99860,2025-05-05,2025-05-06,Tesco,5411,Groceries,Supermarket,-44.47,GBP,-31354.33,POS,London,GB,4488,user_001,,
db328dbd-3f77-43db-9a75-123e50bc377a,2025-05-06,2025-05-06,Sainsbury's,5411,Groceries,Supermarket,-47.22,GBP,-31401.55,POS,London,GB,2219,user_001,,
355710d4-3567-4292-b63f-747c523d7f91,2025-05-07,2025-05-09,Waitrose,5411,Groceries,Supermarket,-25.9,GBP,-31427.45,POS,London,GB,9074,user_001,,
7cce29dd-4147-4dbb-b538-1c64af4388ab,2025-05-07,2025-05-08,Deliveroo,5812,Food & Drink,Delivery,-20.83,GBP,-31448.28,E-Com,London,GB,2219,user_002,,
e5725518-f184-41b0-9579-2ddd9d935fcf,2025-05-07,2025-05-08,Octopus Energy,4900,Utilities,Electricity,-119.33,GBP,-31567.61,Direct Debit,London,GB,1045,user_002,rec_09c3f12b18,
979bba22-6f5e-4244-b108-f3d780167ecf,2025-05-08,2025-05-09,Sainsbury's,5411,Groceries,Supermarket,-28.72,GBP,-31596.33,POS,London,GB,9074,user_001,,
d20907e0-590c-4418-8204-02b5cbab5f30,2025-05-08,2025-05-08,Amazon UK,5942,Shopping,Online Retail,-103.31,GBP,-31699.64,E-Com,London,GB,9074,user_001,,
df86330f-3363-467f-80f8-087a7a34092f,2025-05-08,2025-05-09,Shell,5541,Transport,Fuel,-36.9,GBP,-31736.54,POS,London,GB,9074,user_001,,
5e97427e-c3d6-4306-af48-9b5fc3614483,2025-05-09,2025-05-12,Deliveroo,5812,Food & Drink,Delivery,-23.43,GBP,-31759.97,E-Com,London,GB,1045,user_001,,
e8078b67-445e-4291-998a-7bb8b453d8c0,2025-05-09,2025-05-09,Shell,5541,Transport,Fuel,-80.08,GBP,-31840.05,POS,London,GB,4488,user_001,,
f8173d8b-dcb4-4b79-8e49-e4d524396054,2025-05-09,2025-05-12,Local Market,5499,Groceries,Specialty,-17.36,GBP,-31857.41,POS,London,GB,9074,user_001,,
1be7a9c7-13e5-4bba-a1ed-8d2a5e29a565,2025-05-10,2025-05-12,Amazon UK,5942,Shopping,Online Retail,-24.75,GBP,-31882.16,E-Com,London,GB,9074,user_001,,
7413c475-3b6c-4267-a192-c527884f6a0f,2025-05-10,2025-05-12,Local Market,5499,Groceries,Specialty,-20.04,GBP,-31902.2,POS,London,GB,9074,user_001,,
d40b7e85-4630-42c5-ad88-4feafb9af14a,2025-05-10,2025-05-12,Transport for London,4111,Transport,Transit,-10.08,GBP,-31912.28,POS,London,GB,9074,user_001,,
0c146aa8-041b-4c29-a511-2f4e20c538f7,2025-05-11,2025-05-12,Uber UK,4121,Transport,Ride Hailing,-16.61,GBP,-31928.89,E-Com,London,GB,1045,user_002,,
6f62eb08-f143-4299-a3cd-ffa23a2d1821,2025-05-11,2025-05-12,Tesco,5411,Groceries,Supermarket,-63.27,GBP,-31992.16,POS,London,GB,1045,user_001,,
8d81eb04-f00e-40e3-937a-22df18265c28,2025-05-11,2025-05-12,ATM Withdrawal,6011,Cash,ATM,-103.81,GBP,-32095.97,ATM,London,GB,1045,user_001,,
92020bc3-73f5-4984-9a9d-3940da1b0aab,2025-05-11,2025-05-12,Apple.com/bill,5734,Shopping,Electronics,-113.98,GBP,-32209.95,E-Com,Cupertino,US,1045,user_001,,
eceafd4d-4350-4a8e-8357-93f9c2b2ff38,2025-05-11,2025-05-13,Local Market,5499,Groceries,Specialty,-19.78,GBP,-32229.73,POS,London,GB,9074,user_001,,
0a6ab4d7-0449-4114-aba5-fbd1376ed994,2025-05-12,2025-05-12,Airline Refund,4511,Travel,Refund,14.06,GBP,-32215.67,Credit,London,GB,9074,user_001,,Refund for Uber UK
209ab8a3-c0d3-4301-aa2e-1c52b111b292,2025-05-12,2025-05-13,Thames Water,4900,Utilities,Water,-34.13,GBP,-32249.8,Direct Debit,Reading,GB,4488,user_001,rec_3a34d62842,
3b740c54-81c5-4c04-9f6e-c5fcf928cb8c,2025-05-12,2025-05-12,Waitrose,5411,Groceries,Supermarket,-66.27,GBP,-32316.07,POS,London,GB,2219,user_001,,
7e9d00ad-db18-4df1-92b1-28e406f06b37,2025-05-12,2025-05-13,Transport for London,4111,Transport,Transit,-3.54,GBP,-32319.61,POS,London,GB,4488,user_002,,
d356f6ae-d7a5-42d6-9e9e-76601645fd60,2025-05-12,2025-05-12,Deliveroo,5812,Food & Drink,Delivery,-18.62,GBP,-32338.23,E-Com,London,GB,1045,user_001,,
39996293-b5a5-464e-bc8a-38f214f6cccc,2025-05-13,2025-05-13,City Council Tax,9399,Utilities,Council Tax,-155.92,GBP,-32494.15,Direct Debit,London,GB,4488,user_002,rec_6feaa5d43f,
789bd309-15db-4f40-99c9-3c999ef7ce29,2025-05-13,2025-05-15,Apple.com/bill,5734,Shopping,Electronics,-49.69,USD,-32543.84,E-Com,Cupertino,US,2219,user_001,,FX purchase 62.88 USD @ rate 1.27
7983e994-ec68-43b5-a414-87da8a00db4b,2025-05-13,2025-05-14,Shell,5541,Transport,Fuel,-62.36,GBP,-32606.2,POS,London,GB,4488,user_001,,
ab14c2a6-c38f-4208-a364-b9578ae0a891,2025-05-13,2025-05-15,Apple.com/bill,5734,Shopping,Electronics,-178.86,GBP,-32785.06,E-Com,Cupertino,US,4488,user_001,,
6cee4f5c-db8b-4df2-ab2d-779110813e81,2025-05-14,2025-05-16,Amazon UK,5942,Shopping,Online Retail,-111.51,GBP,-32896.57,E-Com,London,GB,2219,user_001,,
b668d061-6d78-4fb3-a4cf-1be37e716aa6,2025-05-14,2025-05-14,Local Market,5499,Groceries,Specialty,-20.87,GBP,-32917.44,POS,London,GB,4488,user_001,,
2d540103-e022-455e-85e1-c744d351fa34,2025-05-15,2025-05-19,Waitrose,5411,Groceries,Supermarket,-32.96,GBP,-32950.4,POS,London,GB,2219,user_001,,
40927d43-bdc5-4f61-8bb3-c05faddcf12f,2025-05-15,2025-05-15,Sainsbury's,5411,Groceries,Supermarket,-49.74,GBP,-33000.14,POS,London,GB,4488,user_002,,
8bc20d17-6ec4-441d-b929-4166eba4e588,2025-05-15,2025-05-15,Pret A Manger,5814,Food & Drink,Eating Out,-8.71,GBP,-33008.85,POS,London,GB,4488,user_002,,
8f3b8fcf-b1ff-44e6-b93b-2467f4f0bc37,2025-05-15,2025-05-19,Pret A Manger,5814,Food & Drink,Eating Out,-10.53,GBP,-33019.38,POS,London,GB,9074,user_001,,
aa133795-40d9-4047-ab0f-3416f18a5bcd,2025-05-15,2025-05-15,O2 UK,4814,Bills,Mobile,-46.44,GBP,-33065.82,Direct Debit,Slough,GB,4488,user_002,rec_d2dce4c42f,
64bdf99d-fddb-4196-bd63-8016ffa943cf,2025-05-16,2025-05-16,Shell,5541,Transport,Fuel,-57.01,GBP,-33122.83,POS,London,GB,2219,user_002,,
f1e00cd5-5697-47d1-995f-76c10663c82b,2025-05-16,2025-05-19,Waitrose,5411,Groceries,Supermarket,-26.31,GBP,-33149.14,POS,London,GB,4488,user_001,,
4586dc90-7ab8-463a-8ed1-c1975e5577ce,2025-05-17,2025-05-19,Waitrose,5411,Groceries,Supermarket,-44.91,GBP,-33194.05,POS,London,GB,1045,user_001,,
4662742a-9930-4d3c-8099-5839074e9cc4,2025-05-17,2025-05-19,Waitrose,5411,Groceries,Supermarket,-85.94,GBP,-33279.99,POS,London,GB,4488,user_001,,
5fb9f9eb-f6f2-4c9e-b109-cf3a28b4b8af,2025-05-17,2025-05-19,Local Market,5499,Groceries,Specialty,-17.69,GBP,-33297.68,POS,London,GB,4488,user_001,,
22d06aaa-70ea-4d01-9545-b1d83953eea6,2025-05-18,2025-05-19,Uber UK,4121,Transport,Ride Hailing,-25.14,GBP,-33322.82,E-Com,London,GB,4488,user_002,,
2ad2bb65-ba9b-42e1-82fd-e53eb97cdaf6,2025-05-18,2025-05-20,Local Market,5499,Groceries,Specialty,-14.59,GBP,-33337.41,POS,London,GB,2219,user_002,,
488d1ae4-13d7-45b8-abca-c92028078177,2025-05-18,2025-05-19,Deliveroo,5812,Food & Drink,Delivery,-33.63,GBP,-33371.04,E-Com,London,GB,4488,user_001,,
4b5e1f20-251a-4495-accb-afc749e63c35,2025-05-18,2025-05-20,Uber UK,4121,Transport,Ride Hailing,-34.08,GBP,-33405.12,E-Com,London,GB,1045,user_001,,
350b82ff-ea04-46e7-b78b-2a9c979c00c3,2025-05-19,2025-05-20,GymBox,7997,Wellness,Gym,-50.87,GBP,-33455.99,Direct Debit,London,GB,9074,user_001,rec_3906953fd2,
3c10b004-969d-4ce0-bee8-c637eb1fd7e8,2025-05-19,2025-05-20,Spotify,5735,Entertainment,Subscriptions,-8.7,GBP,-33464.69,E-Com,Stockholm,SE,2219,user_001,rec_4c746d2c3b,
6e84a991-a20b-4658-83d6-8d43028f09f0,2025-05-19,2025-05-20,Sainsbury's,5411,Groceries,Supermarket,-16.9,GBP,-33481.59,POS,London,GB,1045,user_002,,
dafb42a9-537e-472f-8bc7-8bcb9b509ca3,2025-05-19,2025-05-20,Sainsbury's,5411,Groceries,Supermarket,-51.04,GBP,-33532.63,POS,London,GB,1045,user_001,,
fce6295a-5232-4e2e-98e5-aa78802d5371,2025-05-19,2025-05-20,Sainsbury's,5411,Groceries,Supermarket,-44.29,GBP,-33576.92,POS,London,GB,1045,user_002,,
b1c6129e-b3a0-43ee-b922-25e729c6acdc,2025-05-20,2025-05-20,Waitrose,5411,Groceries,Supermarket,-79.31,GBP,-33656.23,POS,London,GB,1045,user_001,,
20fccdc4-07dc-4a74-ab2f-81c09c11142b,2025-05-21,2025-05-22,Netflix,7841,Entertainment,Subscriptions,-11.92,GBP,-33668.15,E-Com,Los Gatos,US,9074,user_001,rec_1bfe33738d,
cf1459ce-bed1-4833-be08-360c4f0fc33b,2025-05-21,2025-05-22,Uber UK,4121,Transport,Ride Hailing,-9.18,GBP,-33677.33,E-Com,London,GB,2219,user_001,,
3a84f048-9e07-4245-a038-703e42b53459,2025-05-22,2025-05-26,Amazon UK,5942,Shopping,Online Retail,-49.95,GBP,-33727.28,E-Com,London,GB,2219,user_001,,
96c3423c-f02a-433e-aaa7-ea5094f6cbd5,2025-05-22,2025-05-22,Pret A Manger,5814,Food & Drink,Eating Out,-8.7,GBP,-33735.98,POS,London,GB,2219,user_001,,
a7b628b6-2d84-45d4-b42d-303e8edbcb48,2025-05-22,2025-05-23,Tesco,5411,Groceries,Supermarket,-58.43,GBP,-33794.41,POS,London,GB,1045,user_001,,
ba5dbda5-24ec-4064-83d1-b3fa5f803a7f,2025-05-22,2025-05-22,Tesco,5411,Groceries,Supermarket,-51.31,GBP,-33845.72,POS,London,GB,4488,user_001,,
83b2cf99-8d89-4b4b-8802-3c2c7f9e2b75,2025-05-23,2025-05-26,Apple.com/bill,5734,Shopping,Electronics,-18.31,GBP,-33864.03,E-Com,Cupertino,US,9074,user_001,,
b6b03d6a-8005-49eb-a753-9a0d84a29331,2025-05-23,2025-05-23,T212 Capital,6011,Income,Salary,2892.75,GBP,-30971.28,Credit,London,GB,9074,user_001,rec_2ff8f778d0,
e163a381-576a-4494-b5ae-2f7750e9d20b,2025-05-23,2025-05-26,Tesco,5411,Groceries,Supermarket,-48.43,GBP,-31019.71,POS,London,GB,1045,user_002,,
58cf5673-6e59-4af5-a369-0b3997cbc0aa,2025-05-24,2025-05-26,Uber UK,4121,Transport,Ride Hailing,-13.36,GBP,-31033.07,E-Com,London,GB,2219,user_002,,
8b7e05fb-60e4-4d30-9cde-78ec04aaa999,2025-05-24,2025-05-26,Sainsbury's,5411,Groceries,Supermarket,-47.9,GBP,-31080.97,POS,London,GB,2219,user_001,,
9eeaffca-1d82-43d8-9e3f-ee9836d06cf4,2025-05-24,2025-05-26,Shell,5541,Transport,Fuel,-89.43,GBP,-31170.4,POS,London,GB,9074,user_001,,
a8cc361e-2f46-4a1a-9a77-15996f2b75d7,2025-05-24,2025-05-26,Apple.com/bill,5734,Shopping,Electronics,-19.59,GBP,-31189.99,E-Com,Cupertino,US,2219,user_001,,
b4eab587-3354-405a-84f4-fde3f184060f,2025-05-24,2025-05-26,Local Market,5499,Groceries,Specialty,-17.98,GBP,-31207.97,POS,London,GB,9074,user_001,,
1e7c230e-3e23-48fe-b800-8beadfd5d3de,2025-05-25,2025-05-26,Waitrose,5411,Groceries,Supermarket,-41.73,GBP,-31249.7,POS,London,GB,1045,user_001,,
3b4fb826-7e4b-4001-b206-4b609da94f58,2025-05-25,2025-05-26,Apple.com/bill,5734,Shopping,Electronics,-159.53,GBP,-31409.23,E-Com,Cupertino,US,2219,user_001,,
ea872f3c-6452-45bc-aa16-0d4c3a48503d,2025-05-25,2025-05-27,Apple.com/bill,5734,Shopping,Electronics,-129.7,USD,-31538.93,E-Com,Cupertino,US,4488,user_001,,FX purchase 161.03 USD @ rate 1.24
1db7072b-f5de-4af8-9863-2e1627a7fccc,2025-05-26,2025-05-26,Apple.com/bill,5734,Shopping,Electronics,-113.03,GBP,-31651.96,E-Com,Cupertino,US,1045,user_001,,
331d8f0e-de3a-46e1-a957-fc44ee5ba847,2025-05-27,2025-05-28,Apple.com/bill,5734,Shopping,Electronics,-3.59,GBP,-31655.55,E-Com,Cupertino,US,2219,user_001,,
113686d5-f301-4fe8-acf1-b3ba74d421be,2025-05-29,2025-05-30,Shell,5541,Transport,Fuel,-41.6,GBP,-31697.15,POS,London,GB,1045,user_001,,
23555505-a396-4ab4-9c42-899272ad8e0a,2025-05-30,2025-06-02,Local Market,5499,Groceries,Specialty,-10.63,GBP,-31707.78,POS,London,GB,9074,user_001,,
3cf853a0-a9a1-4404-98d5-49c162208559,2025-05-30,2025-06-02,Deliveroo,5812,Food & Drink,Delivery,-32.34,GBP,-31740.12,E-Com,London,GB,2219,user_001,,
9d41ddfa-4991-46af-817d-b651d55193bb,2025-05-30,2025-06-02,Pret A Manger,5814,Food & Drink,Eating Out,-9.26,GBP,-31749.38,POS,London,GB,2219,user_001,,
3fb65afa-0c4d-497c-97b8-3f769b903dd1,2025-05-31,2025-06-02,Deliveroo,5812,Food & Drink,Delivery,-17.13,GBP,-31766.51,E-Com,London,GB,4488,user_001,,
e309b019-bb7c-4346-974d-552394923ff4,2025-05-31,2025-06-02,Pret A Manger,5814,Food & Drink,Eating Out,-8.79,GBP,-31775.3,POS,London,GB,1045,user_001,,
24dea6ae-99df-46ac-9239-cc2a08f1245e,2025-06-01,2025-06-02,Deliveroo,5812,Food & Drink,Delivery,-22.38,GBP,-31797.68,E-Com,London,GB,2219,user_001,,
57414bc1-ad70-4e34-8198-89c39eb8777c,2025-06-01,2025-06-03,Waitrose,5411,Groceries,Supermarket,-66.28,GBP,-31863.96,POS,London,GB,2219,user_002,,
bd5519d9-ccd6-4a81-8b43-92265f06abba,2025-06-01,2025-06-02,Transport for London,4111,Transport,Transit,-11.16,GBP,-31875.12,POS,London,GB,2219,user_001,,
d78ab970-1f31-4861-8a7d-c2e238ce22ab,2025-06-02,2025-06-04,Crown Estates Lettings,6513,Housing,Rent,-1568.73,GBP,-33443.85,POS,London,GB,1045,user_002,rec_fc2ae06846,
f0fcf33a-8b32-41ec-9625-312c656be7af,2025-06-02,2025-06-03,Shell,5541,Transport,Fuel,-94.6,GBP,-33538.45,POS,London,GB,4488,user_001,,
c89d83ca-f9de-4071-8321-98856a868ed1,2025-06-03,2025-06-04,Pret A Manger,5814,Food & Drink,Eating Out,-6.82,GBP,-33545.27,POS,London,GB,1045,user_001,,
4f1c10b3-1931-4928-b62e-82ea91cbfbf1,2025-06-04,2025-06-04,Tesco,5411,Groceries,Supermarket,-68.57,GBP,-33613.84,POS,London,GB,4488,user_001,,
7cbd262a-8899-4d9b-878d-62bd3b4637df,2025-06-04,2025-06-06,Waitrose,5411,Groceries,Supermarket,-57.74,GBP,-33671.58,POS,London,GB,4488,user_001,,
d1775fc7-1c70-4d00-a674-fd37ed84ea28,2025-06-04,2025-06-06,Tesco,5411,Groceries,Supermarket,-61.58,GBP,-33733.16,POS,London,GB,4488,user_001,,
3d23e823-adda-4469-a381-4af8fdff6b8a,2025-06-05,2025-06-05,Local Market,5499,Groceries,Specialty,-12.94,GBP,-33746.1,POS,London,GB,1045,user_001,,
19bf3b3b-39ca-40f7-9af6-be9623a128de,2025-06-06,2025-06-09,Tesco,5411,Groceries,Supermarket,-28.67,GBP,-33774.77,POS,London,GB,2219,user_001,,
20013abc-10ab-40f0-be53-123e57974057,2025-06-06,2025-06-09,Transport for London,4111,Transport,Transit,-5.11,GBP,-33779.88,POS,London,GB,2219,user_001,,
c7f2b264-e2d5-4163-8c5c-a92d7ba6ee37,2025-06-06,2025-06-06,Shell,5541,Transport,Fuel,-70.08,GBP,-33849.96,POS,London,GB,4488,user_002,,
08404388-3c0a-4fbc-8f85-896fa304ea2a,2025-06-07,2025-06-09,Waitrose,5411,Groceries,Supermarket,-36.81,GBP,-33886.77,POS,London,GB,1045,user_001,,
3d73cec2-c29e-4b03-b851-e8504c47be39,2025-06-07,2025-06-09,Amazon UK,5942,Shopping,Online Retail,-72.75,GBP,-33959.52,E-Com,London,GB,4488,user_001,,
9fc7b039-e141-4d39-a91a-b1778ed2e448,2025-06-07,2025-06-09,Local Market,5499,Groceries,Specialty,-16.52,GBP,-33976.04,POS,London,GB,1045,user_001,,
69566c63-858b-4ec0-8bc2-20ec45f68a2b,2025-06-08,2025-06-09,Tesco,5411,Groceries,Supermarket,-55.67,GBP,-34031.71,POS,London,GB,4488,user_001,,
7befda19-9f0e-4ade-a24a-b3175cdbfe6c,2025-06-08,2025-06-09,Sainsbury's,5411,Groceries,Supermarket,-39.3,GBP,-34071.01,POS,London,GB,2219,user_002,,
bada021e-fd97-447d-9c26-08635fdaa4e5,2025-06-08,2025-06-09,Apple.com/bill,5734,Shopping,Electronics,-93.48,GBP,-34164.49,E-Com,Cupertino,US,4488,user_001,,
901e1a38-c10e-403e-b19a-431c6993045a,2025-06-09,2025-06-11,Transport for London,4111,Transport,Transit,-11.73,GBP,-34176.22,POS,London,GB,9074,user_001,,
9b5a90e0-7b40-4ade-a30d-3d15f4d96f03,2025-06-09,2025-06-10,Octopus Energy,4900,Utilities,Electricity,-142.04,GBP,-34318.26,Direct Debit,London,GB,1045,user_001,rec_141a4a0666,
9094e548-ff55-44dd-8edb-b1a653132deb,2025-06-10,2025-06-11,Sainsbury's,5411,Groceries,Supermarket,-14.02,GBP,-34332.28,POS,London,GB,2219,user_001,,
db760284-db00-4e2e-80e9-59b5d4383949,2025-06-10,2025-06-12,Shell,5541,Transport,Fuel,-86.46,GBP,-34418.74,POS,London,GB,4488,user_001,,
ef4ce0ca-d9c5-4cb1-8a0a-26f656cccfad,2025-06-10,2025-06-12,Transport for London,4111,Transport,Transit,-8.24,GBP,-34426.98,POS,London,GB,9074,user_002,,
f2f76143-5215-45d9-9c07-2932903c3e5d,2025-06-10,2025-06-12,Apple.com/bill,5734,Shopping,Electronics,-163.16,USD,-34590.14,E-Com,Cupertino,US,9074,user_001,,FX purchase 208.6 USD @ rate 1.28
26f0280f-fecf-4162-8a4f-ac8df46d803f,2025-06-11,2025-06-13,Shell,5541,Transport,Fuel,-80.58,GBP,-34670.72,POS,London,GB,4488,user_002,,
874a4853-e5ec-411a-a284-2be85ffcc6c7,2025-06-11,2025-06-13,Thames Water,4900,Utilities,Water,-33.11,GBP,-34703.83,Direct Debit,Reading,GB,9074,user_001,rec_3a34d62842,
91932ec5-ca48-4754-a795-761920a0640e,2025-06-11,2025-06-11,Airline Refund,4511,Travel,Refund,32.08,GBP,-34671.75,Credit,London,GB,2219,user_001,,Refund for Waitrose
1e0731e2-a6cc-4540-b8a1-7e5ae9b4a4b7,2025-06-12,2025-06-13,Waitrose,5411,Groceries,Supermarket,-27.5,GBP,-34699.25,POS,London,GB,9074,user_001,,
c69b88a1-d5a5-4c88-b995-5c7182885b32,2025-06-12,2025-06-12,Sainsbury's,5411,Groceries,Supermarket,-46.47,GBP,-34745.72,POS,London,GB,4488,user_001,,
39a2ccd4-2c57-4ea8-a644-dd275a8a1e1c,2025-06-13,2025-06-13,Deliveroo,5812,Food & Drink,Delivery,-24.5,GBP,-34770.22,E-Com,London,GB,4488,user_001,,
549ae6f9-8281-4ced-ac25-c93d9fdd3492,2025-06-13,2025-06-13,Uber UK,4121,Transport,Ride Hailing,-24.95,GBP,-34795.17,E-Com,London,GB,1045,user_001,,
6b4ee95c-78a2-4693-8722-5c827e18edd8,2025-06-13,2025-06-13,City Council Tax,9399,Utilities,Council Tax,-152.81,GBP,-34947.98,Direct Debit,London,GB,4488,user_002,rec_6feaa5d43f,
1e4bb00e-1612-4265-99c4-6ebf9ef5f7a8,2025-06-14,2025-06-16,Shell,5541,Transport,Fuel,-34.0,GBP,-34981.98,POS,London,GB,4488,user_002,,
1ea17281-3eec-4ee9-afd7-4d8b650c3c94,2025-06-14,2025-06-16,Deliveroo,5812,Food & Drink,Delivery,-18.35,GBP,-35000.33,E-Com,London,GB,2219,user_001,,
3e446979-8a1a-4e93-b4ad-60b8f95639db,2025-06-14,2025-06-16,Uber UK,4121,Transport,Ride Hailing,-25.71,GBP,-35026.04,E-Com,London,GB,2219,user_001,,
4e511409-25c4-4f8e-8128-47d08128db7c,2025-06-14,2025-06-16,Deliveroo,5812,Food & Drink,Delivery,-18.66,GBP,-35044.7,E-Com,London,GB,4488,user_001,,
51a284e4-f97b-48a7-9555-6d695590f83e,2025-06-14,2025-06-16,Waitrose,5411,Groceries,Supermarket,-82.46,GBP,-35127.16,POS,London,GB,4488,user_001,,
d377feb8-216d-48e5-9a61-c8ede5867d97,2025-06-14,2025-06-16,Tesco,5411,Groceries,Supermarket,-84.64,GBP,-35211.8,POS,London,GB,9074,user_001,,
0189c8ec-ab19-4016-9440-b3149839466e,2025-06-15,2025-06-16,Amazon UK,5942,Shopping,Online Retail,-42.04,GBP,-35253.84,E-Com,London,GB,9074,user_001,,
3137d238-72fe-42be-a9ba-15908322d468,2025-06-15,2025-06-16,Sainsbury's,5411,Groceries,Supermarket,-66.3,GBP,-35320.14,POS,London,GB,9074,user_001,,
5967a45d-675f-4ec7-bfb1-5d7fad6ba99a,2025-06-15,2025-06-16,Local Market,5499,Groceries,Specialty,-16.14,GBP,-35336.28,POS,London,GB,1045,user_001,,
5c689b6b-a7ae-409a-94de-26dbd6cfde57,2025-06-15,2025-06-16,Shell,5541,Transport,Fuel,-71.41,GBP,-35407.69,POS,London,GB,2219,user_001,,
bb0ab55c-611b-4c26-8106-571581fdb5c8,2025-06-15,2025-06-17,Shell,5541,Transport,Fuel,-58.64,GBP,-35466.33,POS,London,GB,1045,user_002,,
d380c96d-eea4-4114-ba4e-a77134ddcfbb,2025-06-15,2025-06-16,Amazon UK,5942,Shopping,Online Retail,-65.73,GBP,-35532.06,E-Com,London,GB,9074,user_001,,
b10de5d8-8ad8-4e8d-af00-178636a386e9,2025-06-16,2025-06-18,Uber UK,4121,Transport,Ride Hailing,-9.67,GBP,-35541.73,E-Com,London,GB,2219,user_001,,
bbad54d8-c4fa-40b7-81ab-4f97c9af80d8,2025-06-16,2025-06-18,O2 UK,4814,Bills,Mobile,-36.89,GBP,-35578.62,Direct Debit,Slough,GB,9074,user_001,rec_95042d8101,
498d70bb-ac60-4fc4-9249-c71c3135a7a0,2025-06-17,2025-06-17,GymBox,7997,Wellness,Gym,-62.74,GBP,-35641.36,Direct Debit,London,GB,4488,user_001,rec_3906953fd2,
28573d68-f594-4680-af62-438b7282432a,2025-06-19,2025-06-20,Spotify,5735,Entertainment,Subscriptions,-8.75,GBP,-35650.11,E-Com,Stockholm,SE,4488,user_001,rec_4c746d2c3b,
ce6a3851-dbe7-43e1-a0f2-3496fb8798dd,2025-06-19,2025-06-19,Tesco,5411,Groceries,Supermarket,-31.75,GBP,-35681.86,POS,London,GB,1045,user_001,,
dad01b3f-361e-49df-8bd3-e96eb415ee2c,2025-06-20,2025-06-23,Shell,5541,Transport,Fuel,-85.2,GBP,-35767.06,POS,London,GB,9074,user_001,,
249f1aac-424d-4b96-ab43-9806a438c8a4,2025-06-21,2025-06-23,Sainsbury's,5411,Groceries,Supermarket,-28.43,GBP,-35795.49,POS,London,GB,9074,user_001,,
6953cbe4-800b-4dba-8db7-88686653968e,2025-06-21,2025-06-23,Amazon UK,5942,Shopping,Online Retail,-113.81,GBP,-35909.3,E-Com,London,GB,4488,user_001,,
d4317719-5d09-4a17-899f-cbc2c19e7f40,2025-06-21,2025-06-23,Uber UK,4121,Transport,Ride Hailing,-11.18,GBP,-35920.48,E-Com,London,GB,2219,user_001,,
f061dadb-243a-4667-adc4-1fa567339b69,2025-06-21,2025-06-23,Apple.com/bill,5734,Shopping,Electronics,-189.8,GBP,-36110.28,E-Com,Cupertino,US,2219,user_002,,
1f0ce421-baf6-472f-b81f-7f605166ba22,2025-06-22,2025-06-23,Sainsbury's,5411,Groceries,Supermarket,-18.48,GBP,-36128.76,POS,London,GB,4488,user_001,,
87575134-e23e-4519-aa28-e3d752db210c,2025-06-22,2025-06-23,Pret A Manger,5814,Food & Drink,Eating Out,-9.24,GBP,-36138.0,POS,London,GB,4488,user_001,,
e9c4ffe8-b38a-4764-a5cb-cf07f3e32c96,2025-06-22,2025-06-23,Tesco,5411,Groceries,Supermarket,-79.08,GBP,-36217.08,POS,London,GB,1045,user_002,,
05ef4e4e-8e77-42f3-92d5-a1c8a94229e4,2025-06-23,2025-06-25,Deliveroo,5812,Food & Drink,Delivery,-30.79,GBP,-36247.87,E-Com,London,GB,2219,user_001,,
0c9281b1-2537-413f-800c-1b5977e24c20,2025-06-23,2025-06-23,Local Market,5499,Groceries,Specialty,-16.27,GBP,-36264.14,POS,London,GB,9074,user_001,,
8626fc46-9cb1-4540-8642-a38c46b1fb24,2025-06-23,2025-06-23,Netflix,7841,Entertainment,Subscriptions,-13.15,GBP,-36277.29,E-Com,Los Gatos,US,1045,user_001,rec_1bfe33738d,
86b910d8-77ee-48a1-a5f8-c08a5f6762a9,2025-06-23,2025-06-23,HM Revenue & Customs,9311,Income,Tax Refund,17.37,GBP,-36259.92,Credit,London,GB,2219,user_001,,Refund for O2 UK
fc941c9c-4b64-4307-a3f1-2a48cae23fb6,2025-06-23,2025-06-24,Pret A Manger,5814,Food & Drink,Eating Out,-7.97,GBP,-36267.89,POS,London,GB,9074,user_001,,
5c8d4d8f-bbcf-47d6-a89a-ad6c550f77d4,2025-06-24,2025-06-25,Sainsbury's,5411,Groceries,Supermarket,-34.15,GBP,-36302.04,POS,London,GB,2219,user_001,,
a01692fc-f18e-427a-b2bf-d2b09159cabb,2025-06-24,2025-06-24,Local Market,5499,Groceries,Specialty,-6.21,GBP,-36308.25,POS,London,GB,9074,user_002,,
a293bc7a-efe1-4481-b894-4c2e7c9cbff1,2025-06-24,2025-06-25,Transport for London,4111,Transport,Transit,-11.72,GBP,-36319.97,POS,London,GB,2219,user_001,,
a0c857e7-aa88-40bb-88d1-0956ee485f23,2025-06-25,2025-06-26,Pret A Manger,5814,Food & Drink,Eating Out,-10.27,GBP,-36330.24,POS,London,GB,1045,user_001,,
bb1a576a-5520-4b2e-8e59-f9685677f09b,2025-06-25,2025-06-25,T212 Capital,6011,Income,Salary,2980.36,GBP,-33349.88,Credit,London,GB,1045,user_001,rec_2ff8f778d0,
4c0fcfea-9012-4b9f-b8de-c69fe2a488de,2025-06-26,2025-06-26,Local Market,5499,Groceries,Specialty,-16.87,GBP,-33366.75,POS,London,GB,4488,user_001,,
dd5fb8b1-f410-4f10-a0d5-8acc5fbc1e66,2025-06-26,2025-06-26,HM Revenue & Customs,9311,Income,Tax Refund,30.44,GBP,-33336.31,Credit,London,GB,4488,user_001,,Refund for Sainsbury's
55eede99-03a7-49de-aadb-a85ed89a75e1,2025-06-27,2025-06-30,Amazon UK,5942,Shopping,Online Retail,-52.03,GBP,-33388.34,E-Com,London,GB,4488,user_001,,
67eb51b2-4123-462e-be53-48333f3207ad,2025-06-27,2025-06-30,Waitrose,5411,Groceries,Supermarket,-27.96,GBP,-33416.3,POS,London,GB,9074,user_001,,
e473fb76-6d95-447f-8fd7-9dc1badaa6ed,2025-06-27,2025-06-30,Uber UK,4121,Transport,Ride Hailing,-11.12,GBP,-33427.42,E-Com,London,GB,2219,user_001,,
ff4bb9e2-6898-48b0-9d62-40aec584259a,2025-06-27,2025-06-30,Tesco,5411,Groceries,Supermarket,-81.69,GBP,-33509.11,POS,London,GB,2219,user_001,,
35091edc-7f88-4211-9c10-2eca92ecec24,2025-06-28,2025-06-30,Tesco,5411,Groceries,Supermarket,-48.32,GBP,-33557.43,POS,London,GB,4488,user_001,,
627eb01c-5e37-48b5-ad4d-db8881152886,2025-06-28,2025-06-30,Amazon UK,5942,Shopping,Online Retail,-98.15,GBP,-33655.58,E-Com,London,GB,9074,user_002,,
6f36cad8-599c-414f-b244-ffb037df9ffb,2025-06-28,2025-06-30,Apple.com/bill,5734,Shopping,Electronics,-32.58,GBP,-33688.16,E-Com,Cupertino,US,1045,user_002,,
70bd5b4b-2a84-4df2-b04a-7ad1b9627c15,2025-06-28,2025-06-30,Tesco,5411,Groceries,Supermarket,-55.52,GBP,-33743.68,POS,London,GB,1045,user_001,,
08c86eee-f776-4e07-8b98-b61d044321c3,2025-06-29,2025-06-30,Shell,5541,Transport,Fuel,-54.73,GBP,-33798.41,POS,London,GB,9074,user_002,,
32ea8a65-8714-4c12-be24-27c826256ef7,2025-06-29,2025-06-30,Uber UK,4121,Transport,Ride Hailing,-31.25,GBP,-33829.66,E-Com,London,GB,4488,user_001,,
8d7988a4-6bc1-4a57-b84b-e87fa3e5851f,2025-06-29,2025-06-30,Apple.com/bill,5734,Shopping,Electronics,-128.03,GBP,-33957.69,E-Com,Cupertino,US,2219,user_001,,
9f01052b-6daa-4314-91cd-502528220935,2025-06-29,2025-06-30,Sainsbury's,5411,Groceries,Supermarket,-61.47,GBP,-34019.16,POS,London,GB,9074,user_002,,
c9243c72-ff0e-4e03-836c-d0dfe7fd03ec,2025-06-29,2025-06-30,Transport for London,4111,Transport,Transit,-7.42,GBP,-34026.58,POS,London,GB,1045,user_001,,
fde013a0-3c23-4ad9-ae72-7fe563c03203,2025-06-29,2025-06-30,Deliveroo,5812,Food & Drink,Delivery,-21.87,GBP,-34048.45,E-Com,London,GB,4488,user_001,,
0266ec10-0de2-41a9-99f0-0ef5512a53ee,2025-06-30,2025-07-02,Deliveroo,5812,Food & Drink,Delivery,-26.44,GBP,-34074.89,E-Com,London,GB,1045,user_002,,
df4e2ab0-82ce-4319-a15c-f8b024ca2cae,2025-07-01,2025-07-02,Waitrose,5411,Groceries,Supermarket,-75.82,GBP,-34150.71,POS,London,GB,4488,user_001,,
f891af32-b18a-4794-b12b-d744f72b9b1b,2025-07-01,2025-07-01,Waitrose,5411,Groceries,Supermarket,-75.79,GBP,-34226.5,POS,London,GB,2219,user_001,,
f8bfc979-d270-4b85-b328-d27dde3993d1,2025-07-01,2025-07-03,Crown Estates Lettings,6513,Housing,Rent,-1645.23,GBP,-35871.73,POS,London,GB,1045,user_002,rec_fc2ae06846,
2c18e970-b659-4ec8-927c-38b9f5fd012b,2025-07-02,2025-07-04,Local Market,5499,Groceries,Specialty,-12.66,GBP,-35884.39,POS,London,GB,1045,user_001,,
a8323c89-cfc9-49c1-90ca-776c1937ab09,2025-07-02,2025-07-03,Apple.com/bill,5734,Shopping,Electronics,-23.56,USD,-35907.95,E-Com,Cupertino,US,4488,user_001,,FX purchase 29.04 USD @ rate 1.23
189e18c0-1ee7-4cc0-96e8-921cd99e2a3f,2025-07-03,2025-07-07,Amazon UK,5942,Shopping,Online Retail,-19.23,GBP,-35927.18,E-Com,London,GB,9074,user_001,,
cb0eab17-7c18-426e-9a4e-c266e469ee2c,2025-07-03,2025-07-07,Uber UK,4121,Transport,Ride Hailing,-8.4,GBP,-35935.58,E-Com,London,GB,4488,user_001,,
07043a5c-219f-461c-871e-6956204f73a1,2025-07-04,2025-07-07,Apple.com/bill,5734,Shopping,Electronics,-39.02,GBP,-35974.6,E-Com,Cupertino,US,1045,user_001,,
20b2a036-e9dc-4135-9426-c43bfb732271,2025-07-04,2025-07-07,Pret A Manger,5814,Food & Drink,Eating Out,-6.71,GBP,-35981.31,POS,London,GB,9074,user_001,,
236b6ddf-4447-416a-8510-86ec9eb8f85c,2025-07-05,2025-07-07,Shell,5541,Transport,Fuel,-44.37,GBP,-36025.68,POS,London,GB,4488,user_001,,
6047d3ff-17ca-4329-b5b6-ffc71f2de65a,2025-07-05,2025-07-07,Amazon UK,5942,Shopping,Online Retail,-11.94,GBP,-36037.62,E-Com,London,GB,9074,user_001,,
14aaafd0-043b-4b4d-b89d-e5f3b87d292c,2025-07-06,2025-07-07,Airline Refund,4511,Travel,Refund,8.72,GBP,-36028.9,Credit,London,GB,1045,user_001,,Refund for Uber UK
80bc5c84-8128-4005-9f6e-ae6a1e3cc677,2025-07-06,2025-07-07,Uber UK,4121,Transport,Ride Hailing,-30.53,GBP,-36059.43,E-Com,London,GB,2219,user_002,,
8fb8e85b-9449-4206-b460-7804dcabe20e,2025-07-06,2025-07-07,Amazon UK,5942,Shopping,Online Retail,-36.61,GBP,-36096.04,E-Com,London,GB,4488,user_002,,
b4cc8f31-f017-4a54-9137-53b5340794fc,2025-07-06,2025-07-08,Waitrose,5411,Groceries,Supermarket,-67.18,GBP,-36163.22,POS,London,GB,4488,user_002,,
ba353272-2fab-47a6-9bb7-6edf6d1d8c15,2025-07-06,2025-07-07,Uber UK,4121,Transport,Ride Hailing,-10.01,GBP,-36173.23,E-Com,London,GB,4488,user_002,,
bf96dfe9-7910-4a15-9a8c-fc2c24b073b5,2025-07-06,2025-07-07,Local Market,5499,Groceries,Specialty,-16.07,GBP,-36189.3,POS,London,GB,2219,user_001,,
808844f6-ee7d-49fb-bff1-14ce5d786ae1,2025-07-07,2025-07-09,Pret A Manger,5814,Food & Drink,Eating Out,-7.22,GBP,-36196.52,POS,London,GB,9074,user_001,,
b1eaedac-4fd8-464b-b4d2-adbcf773926b,2025-07-07,2025-07-09,Octopus Energy,4900,Utilities,Electricity,-119.54,GBP,-36316.06,Direct Debit,London,GB,9074,user_001,rec_141a4a0666,
e63329e2-cf4c-412d-86d3-13922e45bf57,2025-07-07,2025-07-07,Deliveroo,5812,Food & Drink,Delivery,-29.07,GBP,-36345.13,E-Com,London,GB,2219,user_001,,
eb044ebc-a691-40e1-ae8d-fdaab026c10a,2025-07-07,2025-07-08,Deliveroo,5812,Food & Drink,Delivery,-27.48,GBP,-36372.61,E-Com,London,GB,4488,user_001,,
5bcf8641-4140-46e1-ae73-d6144dbb1146,2025-07-08,2025-07-08,Transport for London,4111,Transport,Transit,-5.5,GBP,-36378.11,POS,London,GB,4488,user_001,,
f9fdc456-d95b-4580-adf4-face615ae1bd,2025-07-08,2025-07-09,Apple.com/bill,5734,Shopping,Electronics,-119.15,GBP,-36497.26,E-Com,Cupertino,US,1045,user_001,,
79562c98-75d1-4465-9a1f-6216e0f4a471,2025-07-09,2025-07-11,Shell,5541,Transport,Fuel,-53.63,GBP,-36550.89,POS,London,GB,2219,user_001,,
ad82b178-1e3d-4512-acf4-004dc3a3d2db,2025-07-09,2025-07-11,Shell,5541,Transport,Fuel,-84.68,GBP,-36635.57,POS,London,GB,9074,user_002,,
e24772e8-953a-4462-bbac-bf951ac59481,2025-07-09,2025-07-11,Local Market,5499,Groceries,Specialty,-17.23,GBP,-36652.8,POS,London,GB,9074,user_001,,
fd9d6228-8e59-4dd6-8b7e-2f65addb4fcb,2025-07-11,2025-07-11,Thames Water,4900,Utilities,Water,-33.78,GBP,-36686.58,Direct Debit,Reading,GB,4488,user_001,rec_3a34d62842,
411b17bf-41a1-40ad-a41c-3edb6b0a4792,2025-07-12,2025-07-14,Waitrose,5411,Groceries,Supermarket,-32.95,GBP,-36719.53,POS,London,GB,9074,user_001,,
a0938626-9860-4236-b5c3-35cc1ec945c7,2025-07-12,2025-07-14,Pret A Manger,5814,Food & Drink,Eating Out,-9.43,GBP,-36728.96,POS,London,GB,4488,user_001,,
d531526d-36a7-4454-a3b1-efac2650bfbd,2025-07-12,2025-07-14,Local Market,5499,Groceries,Specialty,-11.27,GBP,-36740.23,POS,London,GB,1045,user_001,,
f94e5b23-1431-4b31-adfc-b59cb751c03f,2025-07-12,2025-07-14,Local Market,5499,Groceries,Specialty,-11.12,GBP,-36751.35,POS,London,GB,1045,user_002,,
109c754b-2071-44bc-952c-00b4e68f2eeb,2025-07-13,2025-07-15,Deliveroo,5812,Food & Drink,Delivery,-13.04,GBP,-36764.39,E-Com,London,GB,9074,user_001,,
63346988-5af8-4205-b047-e75fa349fcf3,2025-07-13,2025-07-14,Pret A Manger,5814,Food & Drink,Eating Out,-9.38,GBP,-36773.77,POS,London,GB,4488,user_001,,
6e096104-4f7a-4b4c-bb1c-68218b9422c1,2025-07-13,2025-07-14,Deliveroo,5812,Food & Drink,Delivery,-17.67,GBP,-36791.44,E-Com,London,GB,2219,user_001,,
b725c3fa-9c0d-4961-a70e-feb96cc622c0,2025-07-13,2025-07-15,Sainsbury's,5411,Groceries,Supermarket,-35.24,GBP,-36826.68,POS,London,GB,1045,user_001,,
f479e200-80d8-4709-991b-5282afedbfd3,2025-07-13,2025-07-15,Deliveroo,5812,Food & Drink,Delivery,-27.42,GBP,-36854.1,E-Com,London,GB,1045,user_001,,
0217cf77-6826-47b6-9e33-4d1ae4c80cd9,2025-07-14,2025-07-14,Apple.com/bill,5734,Shopping,Electronics,-130.43,USD,-36984.53,E-Com,Cupertino,US,9074,user_001,,FX purchase 156.71 USD @ rate 1.20
3cf1ef22-8be5-4034-9187-6b650906b05d,2025-07-14,2025-07-14,City Council Tax,9399,Utilities,Council Tax,-171.7,GBP,-37156.23,Direct Debit,London,GB,9074,user_001,rec_f531495db5,
7d713042-4855-4a58-895a-e65f67e7ee66,2025-07-14,2025-07-14,Pret A Manger,5814,Food & Drink,Eating Out,-6.83,GBP,-37163.06,POS,London,GB,1045,user_001,,
5c262f10-f964-474b-94f3-6b58338c87bf,2025-07-15,2025-07-17,O2 UK,4814,Bills,Mobile,-53.51,GBP,-37216.57,Direct Debit,Slough,GB,1045,user_001,rec_95042d8101,
3b283422-0748-4acf-abeb-b11ece5780ba,2025-07-16,2025-07-18,Pret A Manger,5814,Food & Drink,Eating Out,-8.7,GBP,-37225.27,POS,London,GB,9074,user_001,,
40e893b9-f01d-4204-bc03-963f275544f2,2025-07-17,2025-07-18,GymBox,7997,Wellness,Gym,-52.76,GBP,-37278.03,Direct Debit,London,GB,2219,user_001,rec_3906953fd2,
4b1faf30-7c0c-4980-84e2-2c56003779bc,2025-07-17,2025-07-21,Amazon UK,5942,Shopping,Online Retail,-17.89,GBP,-37295.92,E-Com,London,GB,2219,user_001,,
7476c222-3a95-4a29-8e02-e80949ff5136,2025-07-17,2025-07-18,Sainsbury's,5411,Groceries,Supermarket,-59.88,GBP,-37355.8,POS,London,GB,2219,user_001,,
8e8e7f76-31dc-4e55-acda-fe4cd7af49e7,2025-07-17,2025-07-18,Deliveroo,5812,Food & Drink,Delivery,-25.86,GBP,-37381.66,E-Com,London,GB,9074,user_002,,
bf33739d-ca45-4805-a99c-11ff1c0d7667,2025-07-17,2025-07-18,Shell,5541,Transport,Fuel,-92.05,GBP,-37473.71,POS,London,GB,2219,user_001,,
40d134c5-fbc5-4cab-9575-f7c0b42a8956,2025-07-18,2025-07-21,Amazon UK,5942,Shopping,Online Retail,-26.33,GBP,-37500.04,E-Com,London,GB,2219,user_001,,
47c1de77-beae-4e1d-9851-60165431ab10,2025-07-18,2025-07-21,Deliveroo,5812,Food & Drink,Delivery,-21.53,GBP,-37521.57,E-Com,London,GB,2219,user_002,,
cd0746fc-f36d-4182-8de0-9ed2851157ca,2025-07-18,2025-07-21,Sainsbury's,5411,Groceries,Supermarket,-44.29,GBP,-37565.86,POS,London,GB,1045,user_002,,
168091bf-7ce1-4d8f-8ad2-2fa0d1461810,2025-07-19,2025-07-21,Apple.com/bill,5734,Shopping,Electronics,-199.14,GBP,-37765.0,E-Com,Cupertino,US,4488,user_001,,
68ca8769-2ac6-4b01-a22a-7a034f641aa9,2025-07-19,2025-07-21,Sainsbury's,5411,Groceries,Supermarket,-68.76,GBP,-37833.76,POS,London,GB,1045,user_001,,
a116682c-370a-4463-a4b4-5325091d8bf1,2025-07-19,2025-07-21,Tesco,5411,Groceries,Supermarket,-84.76,GBP,-37918.52,POS,London,GB,9074,user_001,,
c9246d21-daa1-453a-b575-0315f60e3288,2025-07-19,2025-07-21,Local Market,5499,Groceries,Specialty,-7.38,GBP,-37925.9,POS,London,GB,2219,user_001,,
20cb9930-27cb-45b7-8a4e-f0572aa6b211,2025-07-20,2025-07-22,Local Market,5499,Groceries,Specialty,-17.75,GBP,-37943.65,POS,London,GB,4488,user_001,,
2e74c388-6a01-4102-9019-1c016cc107d6,2025-07-20,2025-07-21,Tesco,5411,Groceries,Supermarket,-57.38,GBP,-38001.03,POS,London,GB,1045,user_002,,
9487e802-61da-4d44-9ae8-feeed686b757,2025-07-20,2025-07-21,Sainsbury's,5411,Groceries,Supermarket,-14.69,GBP,-38015.72,POS,London,GB,1045,user_001,,
8873b664-093f-4ea6-a50f-b1310372520c,2025-07-21,2025-07-21,Spotify,5735,Entertainment,Subscriptions,-9.68,EUR,-38025.4,E-Com,Stockholm,SE,2219,user_001,rec_4c746d2c3b,FX purchase 11.46 EUR @ rate 1.18
8bed2a31-d1e4-462c-b7d3-c271af72f4ac,2025-07-21,2025-07-23,Local Market,5499,Groceries,Specialty,-15.07,GBP,-38040.47,POS,London,GB,9074,user_001,,
b0def872-0562-447f-8122-83b394cd5afa,2025-07-21,2025-07-21,ATM Withdrawal,6011,Cash,ATM,-119.23,GBP,-38159.7,ATM,London,GB,4488,user_002,,
b8cef1a8-3ee0-49fd-9d83-e1fad0ead560,2025-07-21,2025-07-21,Sainsbury's,5411,Groceries,Supermarket,-50.63,GBP,-38210.33,POS,London,GB,9074,user_001,,
bde9be41-a003-4cab-ac6f-fae06a615f30,2025-07-21,2025-07-22,Waitrose,5411,Groceries,Supermarket,-62.16,GBP,-38272.49,POS,London,GB,1045,user_001,,
e9dba77d-d7f5-4c8d-aa62-b65ee4d2ddaa,2025-07-21,2025-07-22,Netflix,7841,Entertainment,Subscriptions,-13.74,GBP,-38286.23,E-Com,Los Gatos,US,9074,user_001,rec_1bfe33738d,
3fb4e64b-9602-4976-ad0d-cfa9dac5370a,2025-07-22,2025-07-23,Sainsbury's,5411,Groceries,Supermarket,-58.16,GBP,-38344.39,POS,London,GB,4488,user_001,,
97fc2b53-fad3-43e4-8711-d38e6f64a5d4,2025-07-22,2025-07-23,Shell,5541,Transport,Fuel,-75.08,GBP,-38419.47,POS,London,GB,2219,user_001,,
0d2dc90f-4402-4782-abdd-20d694559076,2025-07-23,2025-07-25,Tesco,5411,Groceries,Supermarket,-52.84,GBP,-38472.31,POS,London,GB,4488,user_002,,
3506f7af-833f-432d-a24a-5e9003664588,2025-07-23,2025-07-25,Tesco,5411,Groceries,Supermarket,-23.58,GBP,-38495.89,POS,London,GB,9074,user_002,,
4bb4ab1e-0674-45df-9a30-842101a76b37,2025-07-23,2025-07-23,Sainsbury's,5411,Groceries,Supermarket,-16.26,GBP,-38512.15,POS,London,GB,2219,user_001,,
f5b47d43-6978-46ba-bede-3b6006589014,2025-07-23,2025-07-24,Shell,5541,Transport,Fuel,-48.34,GBP,-38560.49,POS,London,GB,9074,user_002,,
1f3bdf58-c43d-431f-95c5-5f0c1210fa9f,2025-07-24,2025-07-24,Airline Refund,4511,Travel,Refund,5.37,GBP,-38555.12,Credit,London,GB,9074,user_001,,Refund for Transport for London
65f99e3f-2391-439c-95f5-82907c32bee5,2025-07-24,2025-07-28,Sainsbury's,5411,Groceries,Supermarket,-42.93,GBP,-38598.05,POS,London,GB,1045,user_001,,
880ef667-f4df-4ab7-8073-7edfb33a9dcb,2025-07-24,2025-07-25,Tesco,5411,Groceries,Supermarket,-75.1,GBP,-38673.15,POS,London,GB,1045,user_001,,
a0a78edb-6662-4c2b-9256-6c1d942e66c6,2025-07-24,2025-07-25,Waitrose,5411,Groceries,Supermarket,-71.5,GBP,-38744.65,POS,London,GB,9074,user_001,,
ab6156a4-6183-4739-b9c1-cb94691c84b1,2025-07-24,2025-07-24,Amazon UK,5942,Shopping,Online Retail,-84.58,GBP,-38829.23,E-Com,London,GB,4488,user_001,,
cd9cab59-02fb-4f4c-afac-3b6e9c6b62da,2025-07-24,2025-07-24,HM Revenue & Customs,9311,Income,Tax Refund,6.47,GBP,-38822.76,Credit,London,GB,9074,user_001,,Refund for Pret A Manger
2fe3a989-081b-41a7-9dec-b27e0a622c82,2025-07-25,2025-07-25,T212 Capital,6011,Income,Salary,3157.62,GBP,-35665.14,Credit,London,GB,1045,user_001,rec_2ff8f778d0,
b7608462-54a5-4d71-ab65-dae807c52b25,2025-07-26,2025-07-28,Deliveroo,5812,Food & Drink,Delivery,-21.93,GBP,-35687.07,E-Com,London,GB,2219,user_001,,
f98ccca6-b55c-4bf3-b12f-f798d7f99273,2025-07-26,2025-07-28,Waitrose,5411,Groceries,Supermarket,-86.32,GBP,-35773.39,POS,London,GB,4488,user_001,,
05538dc8-ad85-43d6-ae36-51e7c3a4d9b9,2025-07-27,2025-07-28,Transport for London,4111,Transport,Transit,-4.33,GBP,-35777.72,POS,London,GB,4488,user_001,,
0ea72ea8-0f45-4257-a634-39bf41394cfe,2025-07-27,2025-07-28,Apple.com/bill,5734,Shopping,Electronics,-43.51,GBP,-35821.23,E-Com,Cupertino,US,9074,user_001,,
3eee3adb-2746-48bf-bf7e-2238e17b5371,2025-07-27,2025-07-28,Transport for London,4111,Transport,Transit,-5.78,GBP,-35827.01,POS,London,GB,4488,user_001,,
9cbd26c7-dde3-4608-8f11-41341aad7a1c,2025-07-27,2025-07-28,Amazon UK,5942,Shopping,Online Retail,-94.21,GBP,-35921.22,E-Com,London,GB,9074,user_001,,
d9d7483c-0a48-4d13-bf45-e58a09a6e8a5,2025-07-27,2025-07-28,Tesco,5411,Groceries,Supermarket,-23.02,GBP,-35944.24,POS,London,GB,9074,user_001,,
39690005-4265-4c45-8847-00f773c95ae9,2025-07-28,2025-07-28,Amazon UK,5942,Shopping,Online Retail,-26.75,GBP,-35970.99,E-Com,London,GB,9074,user_001,,
3ec59637-3c40-4bdd-82dd-850a599106ec,2025-07-28,2025-07-28,Transport for London,4111,Transport,Transit,-5.93,GBP,-35976.92,POS,London,GB,1045,user_001,,
75c39ac1-69fd-40d7-bb43-397018285ab3,2025-07-28,2025-07-28,Deliveroo,5812,Food & Drink,Delivery,-29.52,GBP,-36006.44,E-Com,London,GB,1045,user_001,,
7010472f-3c5e-4cbb-886d-2007f9d9b7a8,2025-07-30,2025-08-01,Local Market,5499,Groceries,Specialty,-10.77,GBP,-36017.21,POS,London,GB,9074,user_001,,
99805eb4-3e6f-48db-8f57-f631925563c0,2025-07-30,2025-07-31,Tesco,5411,Groceries,Supermarket,-58.75,GBP,-36075.96,POS,London,GB,2219,user_001,,
f22eeee1-2e64-4492-af8a-9d337a3f244e,2025-07-30,2025-07-30,Sainsbury's,5411,Groceries,Supermarket,-57.33,GBP,-36133.29,POS,London,GB,2219,user_001,,
ff2d900e-6961-43c2-933d-07068e2b79ad,2025-07-30,2025-08-01,Tesco,5411,Groceries,Supermarket,-31.48,GBP,-36164.77,POS,London,GB,1045,user_001,,
d1efef90-7903-4cff-afa3-ed64efb9a4ff,2025-07-31,2025-07-31,Local Market,5499,Groceries,Specialty,-9.02,GBP,-36173.79,POS,London,GB,4488,user_001,,
2d69804b-30a1-4dd6-b760-c269820cdc5d,2025-08-01,2025-08-01,Sainsbury's,5411,Groceries,Supermarket,-48.74,GBP,-36222.53,POS,London,GB,9074,user_001,,
924694eb-a0c7-4d6c-ab50-e7bcf8de8c1a,2025-08-01,2025-08-04,Crown Estates Lettings,6513,Housing,Rent,-1497.49,GBP,-37720.02,POS,London,GB,4488,user_001,rec_19f70fbcce,
e6b66809-f3eb-4315-bc9e-0c396fa3211a,2025-08-01,2025-08-01,Local Market,5499,Groceries,Specialty,-15.45,GBP,-37735.47,POS,London,GB,4488,user_001,,
47aa1a4e-6bbb-49eb-8bb6-3d0e0a537335,2025-08-02,2025-08-04,Transport for London,4111,Transport,Transit,-7.74,GBP,-37743.21,POS,London,GB,9074,user_002,,
796786d2-bb1a-4514-8240-1b17921967e7,2025-08-02,2025-08-04,Waitrose,5411,Groceries,Supermarket,-27.42,GBP,-37770.63,POS,London,GB,9074,user_001,,
ca6c90de-7703-40fa-a71b-90d51bb8b764,2025-08-02,2025-08-04,Deliveroo,5812,Food & Drink,Delivery,-18.55,GBP,-37789.18,E-Com,London,GB,1045,user_002,,
0f461a9d-0383-43ba-8fb8-efae72c2bfa7,2025-08-03,2025-08-04,Transport for London,4111,Transport,Transit,-11.79,GBP,-37800.97,POS,London,GB,2219,user_001,,
7ada0372-c6d5-4490-b0b9-9fa62eb04067,2025-08-03,2025-08-05,Waitrose,5411,Groceries,Supermarket,-44.08,GBP,-37845.05,POS,London,GB,9074,user_002,,
8612f9ce-81f9-47e4-9c7a-5a9347821f88,2025-08-03,2025-08-04,Sainsbury's,5411,Groceries,Supermarket,-66.87,GBP,-37911.92,POS,London,GB,4488,user_001,,
b6ee1e32-7af7-4054-a196-7c224dc8ad24,2025-08-03,2025-08-04,Uber UK,4121,Transport,Ride Hailing,-14.12,GBP,-37926.04,E-Com,London,GB,9074,user_001,,
2c012d60-c4f9-45d6-8dad-268d22759c4b,2025-08-04,2025-08-04,HM Revenue & Customs,9311,Income,Tax Refund,12.19,GBP,-37913.85,Credit,London,GB,9074,user_001,,Refund for Netflix
b4278f8d-85a1-4ecd-826e-076e89c39588,2025-08-04,2025-08-04,Sainsbury's,5411,Groceries,Supermarket,-43.92,GBP,-37957.77,POS,London,GB,1045,user_002,,
59b0fa58-55fc-4665-84f3-9e5b6fba23e2,2025-08-05,2025-08-06,Tesco,5411,Groceries,Supermarket,-48.73,GBP,-38006.5,POS,London,GB,9074,user_002,,
37723d2c-c575-4b59-8491-19fe80312764,2025-08-06,2025-08-06,Tesco,5411,Groceries,Supermarket,-68.76,GBP,-38075.26,POS,London,GB,2219,user_001,,
89a0b08d-e158-4919-b7fb-acf45ddb0748,2025-08-06,2025-08-08,Tesco,5411,Groceries,Supermarket,-23.29,GBP,-38098.55,POS,London,GB,1045,user_001,,
c7bfd103-1c8c-413b-8062-6068e202ce41,2025-08-06,2025-08-06,HM Revenue & Customs,9311,Income,Tax Refund,8.78,GBP,-38089.77,Credit,London,GB,2219,user_001,,Refund for Local Market
0a16cb0a-64d6-437d-9762-c02754c7c3d1,2025-08-07,2025-08-11,Octopus Energy,4900,Utilities,Electricity,-127.13,GBP,-38216.9,Direct Debit,London,GB,2219,user_002,rec_09c3f12b18,
416d9913-a7f2-4650-a11c-5ee4cf23a197,2025-08-07,2025-08-11,Local Market,5499,Groceries,Specialty,-10.06,GBP,-38226.96,POS,London,GB,2219,user_001,,
651daa77-27fa-4fd8-853e-d2c04f100b5c,2025-08-07,2025-08-07,Sainsbury's,5411,Groceries,Supermarket,-38.51,GBP,-38265.47,POS,London,GB,1045,user_001,,
8517a541-2a75-42f5-8fb8-3616807ff1b1,2025-08-07,2025-08-07,Deliveroo,5812,Food & Drink,Delivery,-21.21,GBP,-38286.68,E-Com,London,GB,1045,user_001,,
230b50a5-35c6-4cd6-9d8b-8598b1eeac1f,2025-08-08,2025-08-11,Deliveroo,5812,Food & Drink,Delivery,-13.26,GBP,-38299.94,E-Com,London,GB,4488,user_002,,
455d88d4-d588-4220-99af-15afe581f809,2025-08-08,2025-08-11,Amazon UK,5942,Shopping,Online Retail,-39.65,GBP,-38339.59,E-Com,London,GB,1045,user_001,,
fc146fb1-9085-4119-b2ce-cafc0e9ff380,2025-08-08,2025-08-11,Waitrose,5411,Groceries,Supermarket,-53.07,GBP,-38392.66,POS,London,GB,2219,user_001,,
6d1bc934-0695-40be-a13a-03ac08a47074,2025-08-09,2025-08-11,Shell,5541,Transport,Fuel,-39.4,GBP,-38432.06,POS,London,GB,4488,user_001,,
bb34831d-a905-4f40-ad05-a4468b4edc40,2025-08-09,2025-08-11,Amazon UK,5942,Shopping,Online Retail,-96.22,GBP,-38528.28,E-Com,London,GB,4488,user_001,,
d421aae9-0798-4575-92e4-ffdda876590c,2025-08-09,2025-08-11,Pret A Manger,5814,Food & Drink,Eating Out,-11.14,GBP,-38539.42,POS,London,GB,9074,user_001,,
ef34e19c-50de-425f-8c07-51779d98cf61,2025-08-09,2025-08-11,Shell,5541,Transport,Fuel,-49.9,GBP,-38589.32,POS,London,GB,1045,user_001,,
53344ebb-f4f0-44c7-9916-56ed067647d9,2025-08-10,2025-08-12,Uber UK,4121,Transport,Ride Hailing,-13.48,GBP,-38602.8,E-Com,London,GB,4488,user_001,,
6eec1e13-0e63-42bc-872c-8c18113f3338,2025-08-10,2025-08-11,Local Market,5499,Groceries,Specialty,-20.59,GBP,-38623.39,POS,London,GB,1045,user_001,,
b502deb8-e476-44fc-8f4d-d5fc365b8451,2025-08-10,2025-08-11,Transport for London,4111,Transport,Transit,-4.14,GBP,-38627.53,POS,London,GB,4488,user_001,,
f711cbe8-b9f3-4cbc-8247-4e8dd16c552a,2025-08-10,2025-08-11,Waitrose,5411,Groceries,Supermarket,-25.4,GBP,-38652.93,POS,London,GB,2219,user_002,,
3b4867ef-56a8-43ad-880b-464e49c223c5,2025-08-11,2025-08-11,Transport for London,4111,Transport,Transit,-6.48,GBP,-38659.41,POS,London,GB,2219,user_002,,
9689cd99-4016-4cf4-893c-be57f2309a02,2025-08-11,2025-08-12,Thames Water,4900,Utilities,Water,-44.97,GBP,-38704.38,Direct Debit,Reading,GB,1045,user_001,rec_3a34d62842,
a0befc99-1534-4ca7-8818-8c93854535fd,2025-08-11,2025-08-11,Deliveroo,5812,Food & Drink,Delivery,-23.36,GBP,-38727.74,E-Com,London,GB,4488,user_002,,
d8fc4411-acad-4414-8b4b-245ae80de012,2025-08-12,2025-08-13,Uber UK,4121,Transport,Ride Hailing,-19.69,GBP,-38747.43,E-Com,London,GB,4488,user_001,,
1e80822c-c352-4c64-8a83-ce8203837dd9,2025-08-13,2025-08-15,City Council Tax,9399,Utilities,Council Tax,-150.67,GBP,-38898.1,Direct Debit,London,GB,2219,user_001,rec_f531495db5,
45698dd3-a6ba-4ae6-a530-2836051b49bf,2025-08-13,2025-08-15,Waitrose,5411,Groceries,Supermarket,-21.3,GBP,-38919.4,POS,London,GB,4488,user_001,,
8b95c0a4-e718-4279-ab7f-0147ed56a44d,2025-08-13,2025-08-15,Uber UK,4121,Transport,Ride Hailing,-10.46,GBP,-38929.86,E-Com,London,GB,9074,user_001,,
d3d08bc2-4e45-49ac-8aa7-e8a62666f9b8,2025-08-13,2025-08-13,Amazon UK,5942,Shopping,Online Retail,-10.66,GBP,-38940.52,E-Com,London,GB,1045,user_002,,
1c5e983e-d60e-472b-93e8-d1e569f04fef,2025-08-14,2025-08-18,Local Market,5499,Groceries,Specialty,-12.47,GBP,-38952.99,POS,London,GB,1045,user_001,,
4dec31db-1100-4be2-866c-3755ecc7bcd3,2025-08-14,2025-08-14,Sainsbury's,5411,Groceries,Supermarket,-54.22,GBP,-39007.21,POS,London,GB,9074,user_001,,
36953a42-a175-4ce7-ac32-22b294af0d78,2025-08-15,2025-08-18,Apple.com/bill,5734,Shopping,Electronics,-70.23,GBP,-39077.44,E-Com,Cupertino,US,4488,user_001,,
7fccbe00-99db-4c57-9b01-c46a5823c6ed,2025-08-15,2025-08-15,HM Revenue & Customs,9311,Income,Tax Refund,13.57,GBP,-39063.87,Credit,London,GB,4488,user_001,,Refund for Tesco
d02a288e-2803-4fc9-98eb-852a4c885e7a,2025-08-15,2025-08-15,O2 UK,4814,Bills,Mobile,-54.56,GBP,-39118.43,Direct Debit,Slough,GB,2219,user_002,rec_d2dce4c42f,
12d4cc73-df57-4bed-b2c4-32d95b84d5af,2025-08-16,2025-08-18,Shell,5541,Transport,Fuel,-40.07,GBP,-39158.5,POS,London,GB,2219,user_001,,
4e561815-0079-4aa1-a848-0a107a6b448d,2025-08-16,2025-08-18,Deliveroo,5812,Food & Drink,Delivery,-24.38,GBP,-39182.88,E-Com,London,GB,4488,user_001,,
cfc79f7b-a0aa-4c23-9d79-95aa53a38582,2025-08-16,2025-08-18,Transport for London,4111,Transport,Transit,-4.82,GBP,-39187.7,POS,London,GB,4488,user_002,,
89908fae-9571-4132-a5dd-50a973fe9aa9,2025-08-17,2025-08-18,Apple.com/bill,5734,Shopping,Electronics,-57.64,GBP,-39245.34,E-Com,Cupertino,US,1045,user_001,,
ffe09262-e705-4990-aff7-33ed98793f63,2025-08-18,2025-08-18,GymBox,7997,Wellness,Gym,-45.53,GBP,-39290.87,Direct Debit,London,GB,2219,user_001,rec_3906953fd2,
0bd4f05a-da8f-4476-84d6-17cfece9d604,2025-08-19,2025-08-21,Spotify,5735,Entertainment,Subscriptions,-9.69,GBP,-39300.56,E-Com,Stockholm,SE,1045,user_001,rec_4c746d2c3b,
0e10c27d-967e-45db-98ba-63c219a668a7,2025-08-19,2025-08-20,Pret A Manger,5814,Food & Drink,Eating Out,-10.96,GBP,-39311.52,POS,London,GB,2219,user_001,,
1ccd3a3f-cc6d-4dfd-909b-f17fd1283c21,2025-08-20,2025-08-20,Uber UK,4121,Transport,Ride Hailing,-31.08,GBP,-39342.6,E-Com,London,GB,9074,user_001,,
a1a13578-7501-40a0-ba7b-63e6306fd0ab,2025-08-20,2025-08-20,Airline Refund,4511,Travel,Refund,9.54,GBP,-39333.06,Credit,London,GB,4488,user_001,,Refund for Transport for London
02d9dfbb-cf14-46c8-8a2e-697622de9883,2025-08-21,2025-08-22,Netflix,7841,Entertainment,Subscriptions,-10.95,GBP,-39344.01,E-Com,Los Gatos,US,9074,user_001,rec_1bfe33738d,
3d624947-d34d-48a7-ab90-fcbaaad411d5,2025-08-21,2025-08-22,Apple.com/bill,5734,Shopping,Electronics,-165.35,USD,-39509.36,E-Com,Cupertino,US,2219,user_001,,FX purchase 209.77 USD @ rate 1.27
a80b67cf-c87f-4aaf-b93e-e9529e4e4407,2025-08-21,2025-08-21,Sainsbury's,5411,Groceries,Supermarket,-29.11,GBP,-39538.47,POS,London,GB,2219,user_001,,
427ff1d1-8b99-4f79-87bb-9c89938d6b9f,2025-08-22,2025-08-25,Sainsbury's,5411,Groceries,Supermarket,-14.87,GBP,-39553.34,POS,London,GB,2219,user_002,,
5bc027bb-0637-425e-adfb-08b1bddd9af1,2025-08-22,2025-08-22,Shell,5541,Transport,Fuel,-86.45,GBP,-39639.79,POS,London,GB,1045,user_001,,
16393175-a72e-40d5-bac1-344899c93cf1,2025-08-23,2025-08-25,Waitrose,5411,Groceries,Supermarket,-28.93,GBP,-39668.72,POS,London,GB,9074,user_001,,
e29fc821-d37a-4275-9f3e-23a4db9ee373,2025-08-23,2025-08-25,Uber UK,4121,Transport,Ride Hailing,-19.39,GBP,-39688.11,E-Com,London,GB,2219,user_001,,
e5e1ac26-4542-4f77-9d67-384882603fa6,2025-08-23,2025-08-25,Shell,5541,Transport,Fuel,-54.64,GBP,-39742.75,POS,London,GB,1045,user_001,,
3664652a-383e-41d5-8952-3ca163f4aeeb,2025-08-24,2025-08-26,Waitrose,5411,Groceries,Supermarket,-36.76,GBP,-39779.51,POS,London,GB,9074,user_001,,
6dfac389-2bf7-436c-9921-493a43766956,2025-08-24,2025-08-25,Pret A Manger,5814,Food & Drink,Eating Out,-8.61,GBP,-39788.12,POS,London,GB,2219,user_002,,
6e6065ee-e766-4a30-8494-f0f669afd3c7,2025-08-24,2025-08-25,Sainsbury's,5411,Groceries,Supermarket,-54.55,GBP,-39842.67,POS,London,GB,1045,user_001,,
d673d7c2-6c1c-431f-894c-94abe8d88119,2025-08-24,2025-08-26,Apple.com/bill,5734,Shopping,Electronics,-187.5,GBP,-40030.17,E-Com,Cupertino,US,1045,user_001,,
0d3588ad-3531-4719-b36b-75fdf0d09bc9,2025-08-25,2025-08-25,T212 Capital,6011,Income,Salary,3238.01,GBP,-36792.16,Credit,London,GB,9074,user_001,rec_2ff8f778d0,
df39ae62-2639-4973-8983-313083c4f684,2025-08-25,2025-08-27,Deliveroo,5812,Food & Drink,Delivery,-17.08,GBP,-36809.24,E-Com,London,GB,4488,user_001,,
74037439-55b6-4816-8677-97f748f583f3,2025-08-27,2025-08-29,Transport for London,4111,Transport,Transit,-5.44,GBP,-36814.68,POS,London,GB,2219,user_001,,
b358f0c1-9b79-4167-96e1-eecd435f3f61,2025-08-27,2025-08-28,Shell,5541,Transport,Fuel,-74.98,GBP,-36889.66,POS,London,GB,4488,user_001,,
8836033c-2b75-4936-8a36-d9439775f641,2025-08-28,2025-08-28,Tesco,5411,Groceries,Supermarket,-51.9,GBP,-36941.56,POS,London,GB,2219,user_001,,
f0e3827b-4523-48f1-b248-721c46460c45,2025-08-28,2025-08-28,Waitrose,5411,Groceries,Supermarket,-24.31,GBP,-36965.87,POS,London,GB,1045,user_001,,
39f54ca6-c5b6-4ba3-84f8-ddc09c3f2bfa,2025-08-29,2025-08-29,Transport for London,4111,Transport,Transit,-5.67,GBP,-36971.54,POS,London,GB,1045,user_001,,
4ee54092-6950-4d9d-b0c0-a17ae39c1358,2025-08-30,2025-09-01,Waitrose,5411,Groceries,Supermarket,-32.03,GBP,-37003.57,POS,London,GB,4488,user_001,,
54a7e106-e356-449c-a08b-53e922874c07,2025-08-30,2025-09-01,Transport for London,4111,Transport,Transit,-11.83,GBP,-37015.4,POS,London,GB,4488,user_001,,
df3d68bf-b557-448f-95e8-c0ec6133eab5,2025-08-30,2025-09-01,Apple.com/bill,5734,Shopping,Electronics,-187.28,GBP,-37202.68,E-Com,Cupertino,US,1045,user_002,,
eb1bfa00-1ac3-4bf4-9087-1054e4f72a76,2025-08-30,2025-09-01,Deliveroo,5812,Food & Drink,Delivery,-26.28,GBP,-37228.96,E-Com,London,GB,9074,user_001,,
7c71a923-ca18-4b68-994a-06dcae2940eb,2025-08-31,2025-09-01,Apple.com/bill,5734,Shopping,Electronics,-48.6,GBP,-37277.56,E-Com,Cupertino,US,2219,user_001,,
b5e3f894-3785-4696-851a-f0c88283b0b8,2025-08-31,2025-09-01,Uber UK,4121,Transport,Ride Hailing,-13.95,GBP,-37291.51,E-Com,London,GB,4488,user_001,,
c51b1d9f-79f4-453d-93b2-fcc24de75d7d,2025-08-31,2025-09-01,Deliveroo,5812,Food & Drink,Delivery,-23.11,GBP,-37314.62,E-Com,London,GB,2219,user_001,,
690e4697-a56d-4529-8604-fb6250486f2d,2025-09-01,2025-09-02,Waitrose,5411,Groceries,Supermarket,-42.72,GBP,-37357.34,POS,London,GB,9074,user_001,,
7cd26a7d-a608-44dc-bced-5d0584ff64d7,2025-09-01,2025-09-03,Crown Estates Lettings,6513,Housing,Rent,-1497.1,GBP,-38854.44,POS,London,GB,2219,user_001,rec_19f70fbcce,
0216d8b7-752a-4820-9023-79220ade51f1,2025-09-02,2025-09-04,Local Market,5499,Groceries,Specialty,-13.69,GBP,-38868.13,POS,London,GB,9074,user_001,,
d3ab5813-02c8-48db-a94a-01adbb0fe881,2025-09-02,2025-09-04,Apple.com/bill,5734,Shopping,Electronics,-15.87,GBP,-38884.0,E-Com,Cupertino,US,4488,user_002,,
42df4e9c-3940-429c-9119-09323d29af2f,2025-09-03,2025-09-04,Apple.com/bill,5734,Shopping,Electronics,-184.27,GBP,-39068.27,E-Com,Cupertino,US,9074,user_001,,
9989341e-1e28-4f9f-8801-36de3ace25df,2025-09-03,2025-09-04,Deliveroo,5812,Food & Drink,Delivery,-27.76,GBP,-39096.03,E-Com,London,GB,2219,user_001,,
cf12df93-b132-4531-b2d4-67efbb62fdd9,2025-09-04,2025-09-08,Shell,5541,Transport,Fuel,-77.49,GBP,-39173.52,POS,London,GB,1045,user_001,,
12e8b9fa-95fd-425e-86e5-845b9e901fa4,2025-09-05,2025-09-08,Apple.com/bill,5734,Shopping,Electronics,-120.68,USD,-39294.2,E-Com,Cupertino,US,4488,user_001,,FX purchase 151.02 USD @ rate 1.25
96e12a45-e108-4d91-9018-8916577027a7,2025-09-05,2025-09-05,Sainsbury's,5411,Groceries,Supermarket,-43.13,GBP,-39337.33,POS,London,GB,1045,user_002,,
dbcc9154-b959-4f4e-b7ee-cb61726ac365,2025-09-05,2025-09-08,Amazon UK,5942,Shopping,Online Retail,-112.64,GBP,-39449.97,E-Com,London,GB,2219,user_001,,
f7449688-4867-431f-aeee-e61aed0ec1c8,2025-09-05,2025-09-08,Sainsbury's,5411,Groceries,Supermarket,-38.43,GBP,-39488.4,POS,London,GB,9074,user_001,,
a878a888-722d-4e82-9ca3-0fd469fb5b10,2025-09-06,2025-09-08,Shell,5541,Transport,Fuel,-41.26,GBP,-39529.66,POS,London,GB,4488,user_001,,
4ec4422f-3d76-41d7-b961-2288e80c069d,2025-09-07,2025-09-08,Local Market,5499,Groceries,Specialty,-7.81,GBP,-39537.47,POS,London,GB,4488,user_002,,
80d9f4a5-781f-4824-a9dd-87090436da6d,2025-09-07,2025-09-08,Pret A Manger,5814,Food & Drink,Eating Out,-9.25,GBP,-39546.72,POS,London,GB,4488,user_001,,
a28aece0-af80-4ac8-9ffe-31a63de5d738,2025-09-07,2025-09-08,Deliveroo,5812,Food & Drink,Delivery,-32.36,GBP,-39579.08,E-Com,London,GB,9074,user_001,,
08d1d9a5-4426-4af3-a031-97593b679e90,2025-09-08,2025-09-10,Amazon UK,5942,Shopping,Online Retail,-97.79,GBP,-39676.87,E-Com,London,GB,4488,user_002,,
12700c56-e278-4168-9e1c-4bc17e7bc5d3,2025-09-08,2025-09-10,Pret A Manger,5814,Food & Drink,Eating Out,-8.85,GBP,-39685.72,POS,London,GB,9074,user_002,,
73ea5d8c-da6b-46e1-b4b9-29fc316ee8ab,2025-09-08,2025-09-08,Amazon UK,5942,Shopping,Online Retail,-78.21,GBP,-39763.93,E-Com,London,GB,1045,user_001,,
c173c0b1-1c27-4432-adf5-d20027d93405,2025-09-08,2025-09-08,Octopus Energy,4900,Utilities,Electricity,-119.75,GBP,-39883.68,Direct Debit,London,GB,2219,user_001,rec_141a4a0666,
04e41b74-12a1-4285-ac29-605c28ea1866,2025-09-09,2025-09-09,Apple.com/bill,5734,Shopping,Electronics,-135.9,GBP,-40019.58,E-Com,Cupertino,US,2219,user_001,,
23416eae-45b3-43c2-822f-6b930f799714,2025-09-09,2025-09-10,Sainsbury's,5411,Groceries,Supermarket,-24.72,GBP,-40044.3,POS,London,GB,1045,user_001,,
4913af29-51f7-4668-975d-d595cedc5bf6,2025-09-09,2025-09-09,Apple.com/bill,5734,Shopping,Electronics,-106.3,USD,-40150.6,E-Com,Cupertino,US,2219,user_001,,FX purchase 127.87 USD @ rate 1.20
e92191a1-fc03-4fe0-9368-0c1af943a403,2025-09-09,2025-09-11,Pret A Manger,5814,Food & Drink,Eating Out,-11.01,GBP,-40161.61,POS,London,GB,9074,user_001,,
09e42e70-36ab-4409-9b9e-ed2cefe91d31,2025-09-10,2025-09-10,Airline Refund,4511,Travel,Refund,173.45,GBP,-39988.16,Credit,London,GB,2219,user_001,,Refund for Apple.com/bill
3e437f1d-c589-4115-8618-0bce548518c0,2025-09-10,2025-09-11,British Airways,4511,Travel,Flights,-368.52,USD,-40356.68,E-Com,London,GB,4488,user_001,,Business travel
cade9cf1-0fc1-4766-aa6e-afe78353370d,2025-09-10,2025-09-12,Shell,5541,Transport,Fuel,-51.38,GBP,-40408.06,POS,London,GB,4488,user_002,,
0d8f0f5e-21a9-4323-8060-9142d86dd940,2025-09-11,2025-09-12,Tesco,5411,Groceries,Supermarket,-81.69,GBP,-40489.75,POS,London,GB,1045,user_001,,
c46453e5-3170-4ebc-a46b-2e95bd56e090,2025-09-11,2025-09-11,Thames Water,4900,Utilities,Water,-39.04,GBP,-40528.79,Direct Debit,Reading,GB,1045,user_001,rec_3a34d62842,
44ea84f8-8411-4a35-bf7a-66ce050979f7,2025-09-13,2025-09-15,Local Market,5499,Groceries,Specialty,-20.04,GBP,-40548.83,POS,London,GB,4488,user_001,,
c44be430-63e9-40ab-b482-d2c311bd69cc,2025-09-13,2025-09-15,Airline Refund,4511,Travel,Refund,12.83,GBP,-40536.0,Credit,London,GB,9074,user_001,,Refund for Deliveroo
fa9e77e7-1e70-4d9d-9b6f-676e0e89d91b,2025-09-13,2025-09-15,Shell,5541,Transport,Fuel,-55.66,GBP,-40591.66,POS,London,GB,4488,user_001,,
4fda86cf-b6d8-4a37-b937-5079fb340a8c,2025-09-14,2025-09-15,Uber UK,4121,Transport,Ride Hailing,-33.37,GBP,-40625.03,E-Com,London,GB,9074,user_002,,
55f800ad-dcd2-45ea-9946-8711490d3d8f,2025-09-14,2025-09-15,Deliveroo,5812,Food & Drink,Delivery,-16.12,GBP,-40641.15,E-Com,London,GB,4488,user_001,,
4c7bc7f9-e82e-4988-8ca8-650826774172,2025-09-15,2025-09-17,O2 UK,4814,Bills,Mobile,-37.35,GBP,-40678.5,Direct Debit,Slough,GB,1045,user_001,rec_95042d8101,
59530ca3-eeaa-4ca6-a0d7-030c5731bbae,2025-09-15,2025-09-16,City Council Tax,9399,Utilities,Council Tax,-170.83,GBP,-40849.33,Direct Debit,London,GB,1045,user_001,rec_f531495db5,
613beb07-edc8-4cce-9a3c-3a54438005f3,2025-09-17,2025-09-17,ATM Withdrawal,6011,Cash,ATM,-76.92,GBP,-40926.25,ATM,London,GB,9074,user_001,,
d01aba79-188f-4ab1-9417-27724a1c0f3d,2025-09-17,2025-09-19,GymBox,7997,Wellness,Gym,-51.17,GBP,-40977.42,Direct Debit,London,GB,1045,user_001,rec_3906953fd2,
ebe70f8d-bbf5-4ab2-9082-34faa9504512,2025-09-17,2025-09-18,Waitrose,5411,Groceries,Supermarket,-67.82,GBP,-41045.24,POS,London,GB,2219,user_001,,
112695b0-8b98-434b-b217-24b8ab4914d8,2025-09-18,2025-09-18,ATM Withdrawal,6011,Cash,ATM,-75.28,GBP,-41120.52,ATM,London,GB,9074,user_001,,
5ab3b901-9100-413e-888e-95cc26d9a97d,2025-09-18,2025-09-22,Tesco,5411,Groceries,Supermarket,-68.8,GBP,-41189.32,POS,London,GB,4488,user_002,,
1fc6b1bf-1da2-436f-bee2-1067fa76d11c,2025-09-19,2025-09-22,Shell,5541,Transport,Fuel,-74.07,GBP,-41263.39,POS,London,GB,4488,user_001,,
2d50fe26-69f6-4d75-ac1f-704c29a2dd2d,2025-09-19,2025-09-19,Spotify,5735,Entertainment,Subscriptions,-8.83,GBP,-41272.22,E-Com,Stockholm,SE,4488,user_001,rec_4c746d2c3b,
30abb511-38e4-4753-9eb8-5e5d5a614ba8,2025-09-19,2025-09-22,Apple.com/bill,5734,Shopping,Electronics,-97.14,GBP,-41369.36,E-Com,Cupertino,US,1045,user_001,,
4f6752ed-1dff-4679-8770-524112e662e6,2025-09-19,2025-09-22,Deliveroo,5812,Food & Drink,Delivery,-27.72,GBP,-41397.08,E-Com,London,GB,1045,user_001,,
7483aa7d-15b0-4820-9b31-a4da0e81decb,2025-09-19,2025-09-22,Pret A Manger,5814,Food & Drink,Eating Out,-11.41,GBP,-41408.49,POS,London,GB,1045,user_002,,
7bcafe89-cdf5-4f64-9f36-4c0364affb0d,2025-09-19,2025-09-22,Sainsbury's,5411,Groceries,Supermarket,-67.58,GBP,-41476.07,POS,London,GB,2219,user_001,,
7f7b5042-5ff4-4fad-b91a-1c293843aa14,2025-09-19,2025-09-22,Sainsbury's,5411,Groceries,Supermarket,-28.51,GBP,-41504.58,POS,London,GB,1045,user_001,,
a2b7858b-e599-4ea3-ba4f-20352f927bbe,2025-09-19,2025-09-22,Uber UK,4121,Transport,Ride Hailing,-33.58,GBP,-41538.16,E-Com,London,GB,2219,user_001,,
2ab2b3f5-150d-4afc-86cd-4e0c7f8b3886,2025-09-20,2025-09-22,Uber UK,4121,Transport,Ride Hailing,-21.97,GBP,-41560.13,E-Com,London,GB,4488,user_001,,
9abe9539-7059-43b6-9747-eb985f938a8a,2025-09-20,2025-09-22,Waitrose,5411,Groceries,Supermarket,-53.58,GBP,-41613.71,POS,London,GB,4488,user_001,,
1c5bb93d-bd52-4838-a36a-a38acbf1a231,2025-09-21,2025-09-22,Local Market,5499,Groceries,Specialty,-16.91,GBP,-41630.62,POS,London,GB,9074,user_001,,
6b74b728-b669-40bb-9f47-8e85679fb208,2025-09-21,2025-09-22,Uber UK,4121,Transport,Ride Hailing,-18.05,GBP,-41648.67,E-Com,London,GB,4488,user_002,,
f3963666-5c7c-4399-b9a3-3b0748c85220,2025-09-21,2025-09-22,Uber UK,4121,Transport,Ride Hailing,-13.6,GBP,-41662.27,E-Com,London,GB,1045,user_001,,
006d77cb-7b9a-4232-a131-985562075493,2025-09-22,2025-09-23,Netflix,7841,Entertainment,Subscriptions,-13.69,GBP,-41675.96,E-Com,Los Gatos,US,1045,user_001,rec_1bfe33738d,
3e6844f2-b783-45dd-a4f8-28fc93c91362,2025-09-22,2025-09-23,Amazon UK,5942,Shopping,Online Retail,-37.24,GBP,-41713.2,E-Com,London,GB,1045,user_001,,
7a9e78a6-3d80-4cf8-bcb9-1091d68156c7,2025-09-22,2025-09-24,Local Market,5499,Groceries,Specialty,-16.05,GBP,-41729.25,POS,London,GB,9074,user_001,,
b690f41d-c15b-45a6-b224-da3fed45a47f,2025-09-23,2025-09-23,Transport for London,4111,Transport,Transit,-6.66,GBP,-41735.91,POS,London,GB,1045,user_001,,
11043674-a1d3-4308-b15b-8cfd8a687c2d,2025-09-24,2025-09-26,Tesco,5411,Groceries,Supermarket,-40.19,GBP,-41776.1,POS,London,GB,2219,user_001,,
59f2ecb8-ff0d-4303-912f-2ca5e18ae410,2025-09-24,2025-09-25,Uber UK,4121,Transport,Ride Hailing,-15.95,GBP,-41792.05,E-Com,London,GB,2219,user_001,,
d34a13ad-75fd-4563-98dd-526a962c6c58,2025-09-25,2025-09-29,Uber UK,4121,Transport,Ride Hailing,-9.51,GBP,-41801.56,E-Com,London,GB,9074,user_001,,
f7b05399-dc91-44c5-8255-2dbb25f47ff6,2025-09-25,2025-09-25,T212 Capital,6011,Income,Salary,2960.57,GBP,-38840.99,Credit,London,GB,2219,user_001,rec_2ff8f778d0,
961c84d2-28aa-45ac-a1bd-0f095c098328,2025-09-26,2025-09-26,Transport for London,4111,Transport,Transit,-9.0,GBP,-38849.99,POS,London,GB,1045,user_002,,
a5010a3e-1b56-4c5d-896c-0e945713bf3f,2025-09-26,2025-09-29,Amazon UK,5942,Shopping,Online Retail,-23.83,GBP,-38873.82,E-Com,London,GB,1045,user_001,,
4a9f73cb-8306-4c59-af4f-6d313e4a303d,2025-09-27,2025-09-29,Waitrose,5411,Groceries,Supermarket,-51.67,GBP,-38925.49,POS,London,GB,4488,user_001,,
8c9e9bbe-de3c-45c2-8b0b-dc30fae26ec6,2025-09-27,2025-09-29,Amazon UK,5942,Shopping,Online Retail,-15.26,GBP,-38940.75,E-Com,London,GB,1045,user_001,,
23d1d0c5-e1ea-4baa-a458-16e97fe5d7b2,2025-09-28,2025-09-29,Tesco,5411,Groceries,Supermarket,-76.74,GBP,-39017.49,POS,London,GB,1045,user_001,,
529bf4cd-4182-43ed-9253-2e8e1ff175c1,2025-09-28,2025-09-29,Pret A Manger,5814,Food & Drink,Eating Out,-9.66,GBP,-39027.15,POS,London,GB,2219,user_001,,
80ff36b6-0998-4ee5-a572-1331a0b05ead,2025-09-28,2025-09-30,Sainsbury's,5411,Groceries,Supermarket,-26.84,GBP,-39053.99,POS,London,GB,2219,user_001,,
8edc0a07-a08c-45c6-9dc5-ab315b64b825,2025-09-29,2025-10-01,Deliveroo,5812,Food & Drink,Delivery,-21.02,GBP,-39075.01,E-Com,London,GB,4488,user_002,,
5aa902b8-535c-4369-a48b-2501a799043f,2025-10-01,2025-10-01,HM Revenue & Customs,9311,Income,Tax Refund,59.64,GBP,-39015.37,Credit,London,GB,2219,user_001,,Refund for Shell
a37ce4e8-def5-466f-9626-eeb1f52d43c6,2025-10-01,2025-10-01,Crown Estates Lettings,6513,Housing,Rent,-1610.04,GBP,-40625.41,POS,London,GB,4488,user_001,rec_19f70fbcce,
371991c0-ce0a-4a98-8ee8-c16d35be9397,2025-10-02,2025-10-06,Uber UK,4121,Transport,Ride Hailing,-29.46,GBP,-40654.87,E-Com,London,GB,1045,user_001,,
502c67e8-4f38-4f19-bd7d-abb0dd369bc3,2025-10-02,2025-10-02,Apple.com/bill,5734,Shopping,Electronics,-40.95,GBP,-40695.82,E-Com,Cupertino,US,2219,user_001,,
75bc5472-ee6b-44b2-80d9-6e65fa63ae71,2025-10-02,2025-10-03,Deliveroo,5812,Food & Drink,Delivery,-22.16,GBP,-40717.98,E-Com,London,GB,9074,user_001,,
321e60ca-7f4e-47df-839e-9cac3b02a1f6,2025-10-04,2025-10-06,Apple.com/bill,5734,Shopping,Electronics,-77.88,GBP,-40795.86,E-Com,Cupertino,US,9074,user_001,,
588d65a8-a38d-4eba-b92c-10ff4adffbba,2025-10-04,2025-10-06,Shell,5541,Transport,Fuel,-50.98,GBP,-40846.84,POS,London,GB,9074,user_002,,
9d396c90-2778-4921-91e2-ca046834be04,2025-10-04,2025-10-06,Tesco,5411,Groceries,Supermarket,-31.53,GBP,-40878.37,POS,London,GB,2219,user_001,,
d135d4ca-7a69-41be-9d0c-c017b4a71989,2025-10-04,2025-10-06,Pret A Manger,5814,Food & Drink,Eating Out,-10.5,GBP,-40888.87,POS,London,GB,4488,user_001,,
33c6a2ef-fe0d-484a-9209-110a3c683a6e,2025-10-05,2025-10-06,Tesco,5411,Groceries,Supermarket,-84.92,GBP,-40973.79,POS,London,GB,4488,user_001,,
5c174a79-f48a-4f0a-90d2-03de23d240aa,2025-10-05,2025-10-07,Waitrose,5411,Groceries,Supermarket,-64.37,GBP,-41038.16,POS,London,GB,9074,user_001,,
9308e226-1598-419b-bfbe-3486264e0794,2025-10-05,2025-10-06,Uber UK,4121,Transport,Ride Hailing,-18.7,GBP,-41056.86,E-Com,London,GB,4488,user_002,,
551267b7-a6ed-40ed-bf77-265169bb5f86,2025-10-06,2025-10-07,Shell,5541,Transport,Fuel,-81.5,GBP,-41138.36,POS,London,GB,1045,user_001,,
6272d3e6-84f7-4378-a5f9-512ae2c1f227,2025-10-06,2025-10-06,Sainsbury's,5411,Groceries,Supermarket,-68.46,GBP,-41206.82,POS,London,GB,4488,user_001,,
d37cd3b6-6796-455d-868e-045bc8e49643,2025-10-06,2025-10-07,Transport for London,4111,Transport,Transit,-10.47,GBP,-41217.29,POS,London,GB,1045,user_001,,
12104ea9-7475-4837-815e-11e55fd875f4,2025-10-07,2025-10-07,Sainsbury's,5411,Groceries,Supermarket,-48.45,GBP,-41265.74,POS,London,GB,1045,user_001,,
3e1cc9c6-7ff9-4de3-99b1-2e8514585bb2,2025-10-07,2025-10-07,Shell,5541,Transport,Fuel,-46.47,GBP,-41312.21,POS,London,GB,2219,user_001,,
4745d24a-ee63-4cf0-b03a-c78450b19c41,2025-10-07,2025-10-09,Octopus Energy,4900,Utilities,Electricity,-116.29,GBP,-41428.5,Direct Debit,London,GB,9074,user_002,rec_09c3f12b18,
91b6ede6-bcb0-4686-85ab-8feb787bdd24,2025-10-07,2025-10-07,Sainsbury's,5411,Groceries,Supermarket,-59.55,GBP,-41488.05,POS,London,GB,1045,user_001,,
b0be6279-7e5a-4b80-b64d-b027c6830364,2025-10-07,2025-10-09,Pret A Manger,5814,Food & Drink,Eating Out,-5.74,GBP,-41493.79,POS,London,GB,2219,user_001,,
aab19334-6308-449f-af26-b63d61dcbaff,2025-10-08,2025-10-08,Uber UK,4121,Transport,Ride Hailing,-13.13,GBP,-41506.92,E-Com,London,GB,2219,user_001,,
e891c7e9-1291-49fd-8f2d-1c1817c8130c,2025-10-08,2025-10-09,Pret A Manger,5814,Food & Drink,Eating Out,-11.6,GBP,-41518.52,POS,London,GB,2219,user_001,,
2ec86592-f9a3-4966-b484-23f42ab409f0,2025-10-09,2025-10-13,Shell,5541,Transport,Fuel,-67.29,GBP,-41585.81,POS,London,GB,4488,user_001,,
6f41b68c-d26b-4d92-b226-734d27eb6cbf,2025-10-09,2025-10-13,Uber UK,4121,Transport,Ride Hailing,-29.76,GBP,-41615.57,E-Com,London,GB,1045,user_001,,
8eec1382-06ea-4b6e-ab5b-c5f1f10d24c2,2025-10-09,2025-10-10,Tesco,5411,Groceries,Supermarket,-37.46,GBP,-41653.03,POS,London,GB,4488,user_001,,
c22cfd69-ab4f-4a41-9346-c918cf4bd6a6,2025-10-09,2025-10-09,Amazon UK,5942,Shopping,Online Retail,-87.97,GBP,-41741.0,E-Com,London,GB,2219,user_001,,
363b3b36-4182-419a-9e49-96532c689ddc,2025-10-10,2025-10-10,Sainsbury's,5411,Groceries,Supermarket,-26.64,GBP,-41767.64,POS,London,GB,2219,user_001,,
62c4098f-e0ce-4639-a365-c7e286a9c637,2025-10-10,2025-10-13,Sainsbury's,5411,Groceries,Supermarket,-26.74,GBP,-41794.38,POS,London,GB,2219,user_001,,
a0626470-08f3-4c40-a18e-cd6bd47a5c8e,2025-10-10,2025-10-13,Transport for London,4111,Transport,Transit,-11.32,GBP,-41805.7,POS,London,GB,4488,user_001,,
ab042e0b-98ad-4b8a-b1d6-2be9a2c5220a,2025-10-10,2025-10-13,Local Market,5499,Groceries,Specialty,-9.24,GBP,-41814.94,POS,London,GB,9074,user_001,,
bc376f92-f265-4a11-adf8-57a5c9e8b4ea,2025-10-10,2025-10-13,ATM Withdrawal,6011,Cash,ATM,-100.84,GBP,-41915.78,ATM,London,GB,2219,user_001,,
e032da49-54f0-459e-a40f-5595fa3048bb,2025-10-10,2025-10-13,Shell,5541,Transport,Fuel,-77.42,GBP,-41993.2,POS,London,GB,2219,user_001,,
06d56ffc-ab78-4a5a-ba18-cb0fe88dd068,2025-10-11,2025-10-13,Pret A Manger,5814,Food & Drink,Eating Out,-8.26,GBP,-42001.46,POS,London,GB,9074,user_002,,
0c8abab8-3fc7-4b0c-8b2f-64eebd2f1fde,2025-10-11,2025-10-13,Waitrose,5411,Groceries,Supermarket,-69.05,GBP,-42070.51,POS,London,GB,2219,user_001,,
6720ddcc-0291-4c80-961c-17d58b356310,2025-10-11,2025-10-13,Uber UK,4121,Transport,Ride Hailing,-10.8,GBP,-42081.31,E-Com,London,GB,1045,user_001,,
7cc951a5-ae4a-43db-a6cd-9353e6b1e620,2025-10-11,2025-10-13,Tesco,5411,Groceries,Supermarket,-49.6,GBP,-42130.91,POS,London,GB,1045,user_001,,
0dc75294-d48d-472c-a070-1a2551d3eea6,2025-10-12,2025-10-14,Tesco,5411,Groceries,Supermarket,-44.3,GBP,-42175.21,POS,London,GB,4488,user_002,,
4b6f421a-3cb9-4742-a52f-2cb2ade3f532,2025-10-12,2025-10-13,Apple.com/bill,5734,Shopping,Electronics,-129.31,USD,-42304.52,E-Com,Cupertino,US,1045,user_001,,FX purchase 159.44 USD @ rate 1.23
6ab0537e-83b3-4706-899d-93cac9f08343,2025-10-12,2025-10-13,Apple.com/bill,5734,Shopping,Electronics,-189.54,GBP,-42494.06,E-Com,Cupertino,US,2219,user_001,,
9d9b6511-017f-4c5e-9801-1f50c66d0c66,2025-10-12,2025-10-14,Sainsbury's,5411,Groceries,Supermarket,-41.27,GBP,-42535.33,POS,London,GB,9074,user_001,,
0748ed37-2299-4b86-9b08-3dc53346d4a5,2025-10-13,2025-10-15,Sainsbury's,5411,Groceries,Supermarket,-27.36,GBP,-42562.69,POS,London,GB,2219,user_001,,
4555a26c-58f8-439d-ada9-407114354cf5,2025-10-13,2025-10-14,Waitrose,5411,Groceries,Supermarket,-25.63,GBP,-42588.32,POS,London,GB,1045,user_001,,
8183c1ae-9124-444d-aaa7-4d84319076a9,2025-10-13,2025-10-13,Waitrose,5411,Groceries,Supermarket,-69.79,GBP,-42658.11,POS,London,GB,9074,user_001,,
af347b88-0985-4171-aa75-53fd0791198d,2025-10-13,2025-10-13,City Council Tax,9399,Utilities,Council Tax,-154.88,GBP,-42812.99,Direct Debit,London,GB,4488,user_002,rec_6feaa5d43f,
b6531c2f-7582-43c6-98a8-ff1eaf714cea,2025-10-13,2025-10-15,Thames Water,4900,Utilities,Water,-39.09,GBP,-42852.08,Direct Debit,Reading,GB,1045,user_001,rec_3a34d62842,
c3573ae0-bacf-4a24-ad14-79d1e1d1133d,2025-10-14,2025-10-14,Shell,5541,Transport,Fuel,-58.34,GBP,-42910.42,POS,London,GB,2219,user_002,,
0583ac30-a395-4dd0-a70d-3ee2fda135f8,2025-10-15,2025-10-17,Shell,5541,Transport,Fuel,-32.07,GBP,-42942.49,POS,London,GB,4488,user_001,,
1138d125-7cae-4f3c-be20-07752ca0d5bb,2025-10-15,2025-10-16,Amazon UK,5942,Shopping,Online Retail,-76.96,GBP,-43019.45,E-Com,London,GB,2219,user_001,,
2882e78f-8e07-40b4-a267-09f8e3de9dc4,2025-10-15,2025-10-16,O2 UK,4814,Bills,Mobile,-52.56,GBP,-43072.01,Direct Debit,Slough,GB,2219,user_001,rec_95042d8101,
0ffc2228-8f96-4801-8641-0fb53d545bb2,2025-10-16,2025-10-20,Local Market,5499,Groceries,Specialty,-21.41,GBP,-43093.42,POS,London,GB,9074,user_001,,
ad7b7082-23ba-4e07-b93f-9c70c6f01abc,2025-10-16,2025-10-20,Local Market,5499,Groceries,Specialty,-15.53,GBP,-43108.95,POS,London,GB,4488,user_001,,
6210c72c-12ab-441a-bd7f-f2de885ec82a,2025-10-17,2025-10-17,GymBox,7997,Wellness,Gym,-56.21,GBP,-43165.16,Direct Debit,London,GB,4488,user_001,rec_3906953fd2,
6a4f2e83-fbbe-429b-85c8-8c4302d483f4,2025-10-17,2025-10-20,Airbnb,7011,Travel,Accommodation,-245.74,GBP,-43410.9,E-Com,Dublin,IE,9074,user_001,,Holiday booking
3ae6334b-1fe2-401b-9950-33a498f9aa04,2025-10-18,2025-10-20,Apple.com/bill,5734,Shopping,Electronics,-129.56,GBP,-43540.46,E-Com,Cupertino,US,1045,user_002,,
605b39c5-db35-4ba2-8919-d2ae7b8cfbc4,2025-10-18,2025-10-20,Amazon UK,5942,Shopping,Online Retail,-71.37,GBP,-43611.83,E-Com,London,GB,4488,user_001,,
7e7db72e-8701-4d82-8f0f-82cdf20b88db,2025-10-18,2025-10-20,Amazon UK,5942,Shopping,Online Retail,-25.93,GBP,-43637.76,E-Com,London,GB,9074,user_001,,
c1011934-321f-45bd-a404-6dce1681ac7e,2025-10-18,2025-10-20,Sainsbury's,5411,Groceries,Supermarket,-40.36,GBP,-43678.12,POS,London,GB,1045,user_001,,
e8716091-87d3-4ef4-bbc5-33a7b08657dc,2025-10-18,2025-10-20,Pret A Manger,5814,Food & Drink,Eating Out,-11.73,GBP,-43689.85,POS,London,GB,4488,user_001,,
4ec129bf-36d8-4067-9079-24ba80114497,2025-10-19,2025-10-21,Local Market,5499,Groceries,Specialty,-16.34,GBP,-43706.19,POS,London,GB,9074,user_002,,
73a30ab5-56a7-46be-a53f-ab264d6ec2fb,2025-10-19,2025-10-20,Amazon UK,5942,Shopping,Online Retail,-58.08,GBP,-43764.27,E-Com,London,GB,9074,user_001,,
900bc3db-68d0-4128-b21b-1c370c7f116f,2025-10-19,2025-10-20,Transport for London,4111,Transport,Transit,-11.48,GBP,-43775.75,POS,London,GB,4488,user_001,,
e7e600a3-9e67-40a4-b149-15d7eb98a849,2025-10-19,2025-10-21,Local Market,5499,Groceries,Specialty,-21.8,GBP,-43797.55,POS,London,GB,9074,user_001,,
002240dc-63f6-4911-b188-e10f21f64258,2025-10-20,2025-10-20,Spotify,5735,Entertainment,Subscriptions,-8.82,EUR,-43806.37,E-Com,Stockholm,SE,1045,user_002,rec_34b6e9e33f,FX purchase 9.63 EUR @ rate 1.09
fa0f7003-df4c-4cd8-a5f8-9d9182980766,2025-10-20,2025-10-21,Deliveroo,5812,Food & Drink,Delivery,-30.51,GBP,-43836.88,E-Com,London,GB,2219,user_001,,
022b43c9-5b18-434a-b730-1a1433b96a40,2025-10-21,2025-10-22,Shell,5541,Transport,Fuel,-57.33,GBP,-43894.21,POS,London,GB,9074,user_001,,
107836e0-a4b8-4284-b530-8c1cb5962745,2025-10-21,2025-10-21,Netflix,7841,Entertainment,Subscriptions,-15.73,GBP,-43909.94,E-Com,Los Gatos,US,9074,user_002,rec_d9322c1382,
366d55c4-788f-41f2-a690-3554b506cb83,2025-10-21,2025-10-22,Pret A Manger,5814,Food & Drink,Eating Out,-11.1,GBP,-43921.04,POS,London,GB,1045,user_001,,
1ff90dac-4fd9-4ea9-846c-e786f06c12ab,2025-10-22,2025-10-24,Pret A Manger,5814,Food & Drink,Eating Out,-11.85,GBP,-43932.89,POS,London,GB,2219,user_001,,
407bd27a-a15e-4718-82e1-ff4ca9b20efd,2025-10-22,2025-10-24,Sainsbury's,5411,Groceries,Supermarket,-26.95,GBP,-43959.84,POS,London,GB,4488,user_001,,
53773037-cd61-49d5-981d-c2ad2697a5d4,2025-10-22,2025-10-22,Deliveroo,5812,Food & Drink,Delivery,-24.49,GBP,-43984.33,E-Com,London,GB,9074,user_001,,
be3c8060-75a8-4d65-899d-294611bac350,2025-10-22,2025-10-22,Airline Refund,4511,Travel,Refund,37.71,GBP,-43946.62,Credit,London,GB,1045,user_001,,Refund for Shell
eea9daa8-b4a2-4f53-a5f8-c8708fee5961,2025-10-22,2025-10-23,Pret A Manger,5814,Food & Drink,Eating Out,-5.61,GBP,-43952.23,POS,London,GB,4488,user_001,,
97afea86-6f58-4ec9-b7f0-e54a3961b5dc,2025-10-23,2025-10-27,ATM Withdrawal,6011,Cash,ATM,-90.62,GBP,-44042.85,ATM,London,GB,1045,user_001,,
e316ce32-008d-4412-8e72-f884ca827985,2025-10-23,2025-10-24,ATM Withdrawal,6011,Cash,ATM,-78.35,GBP,-44121.2,ATM,London,GB,1045,user_001,,
2c56ecce-db7e-4823-ba68-983432f02899,2025-10-24,2025-10-27,Shell,5541,Transport,Fuel,-91.83,GBP,-44213.03,POS,London,GB,9074,user_001,,
48b0289a-deb4-434d-b0c6-34f0e6938609,2025-10-24,2025-10-27,Local Market,5499,Groceries,Specialty,-12.56,GBP,-44225.59,POS,London,GB,1045,user_001,,
50ebeaf4-df2b-4301-93f6-bfd455cc05b5,2025-10-24,2025-10-24,Sainsbury's,5411,Groceries,Supermarket,-19.84,GBP,-44245.43,POS,London,GB,4488,user_001,,
cbf7b43b-2718-4c86-b7cf-fcd073f5f7e2,2025-10-24,2025-10-24,T212 Capital,6011,Income,Salary,3334.65,GBP,-40910.78,Credit,London,GB,1045,user_001,rec_2ff8f778d0,
d09b9abf-2448-46af-a0c6-db0e796663ba,2025-10-24,2025-10-27,Deliveroo,5812,Food & Drink,Delivery,-22.82,GBP,-40933.6,E-Com,London,GB,9074,user_001,,
05d24e37-56de-4322-92a8-915a9e6d618c,2025-10-25,2025-10-27,Amazon UK,5942,Shopping,Online Retail,-34.5,GBP,-40968.1,E-Com,London,GB,4488,user_001,,
170fe48e-05d9-4f17-b2f8-16c2638cfd7d,2025-10-25,2025-10-27,Sainsbury's,5411,Groceries,Supermarket,-46.7,GBP,-41014.8,POS,London,GB,1045,user_001,,
852a87a6-862d-4ec6-87ad-015149dad294,2025-10-25,2025-10-27,Sainsbury's,5411,Groceries,Supermarket,-15.61,GBP,-41030.41,POS,London,GB,9074,user_001,,
8fd09075-43b1-4f15-9d1d-19e603c908bf,2025-10-25,2025-10-27,Uber UK,4121,Transport,Ride Hailing,-26.97,GBP,-41057.38,E-Com,London,GB,9074,user_002,,
a03c377f-0e31-4a14-a925-c7f904215407,2025-10-25,2025-10-27,Pret A Manger,5814,Food & Drink,Eating Out,-6.25,GBP,-41063.63,POS,London,GB,4488,user_001,,
de2758a7-f274-40cd-93ce-c4ac17d8d6ee,2025-10-25,2025-10-27,Local Market,5499,Groceries,Specialty,-17.27,GBP,-41080.9,POS,London,GB,2219,user_001,,
f29a18f7-965b-4dc1-9a58-f105784178cc,2025-10-25,2025-10-27,Shell,5541,Transport,Fuel,-34.69,GBP,-41115.59,POS,London,GB,9074,user_001,,
f8611209-0e25-4d74-8e4c-1078e75f5acd,2025-10-25,2025-10-27,Shell,5541,Transport,Fuel,-76.05,GBP,-41191.64,POS,London,GB,4488,user_001,,
95e4a70a-d8d4-46f4-ae6e-b0c4de94a5da,2025-10-26,2025-10-27,Apple.com/bill,5734,Shopping,Electronics,-186.5,GBP,-41378.14,E-Com,Cupertino,US,9074,user_001,,
a130bcae-ff40-45d2-a2b7-71247645e7fe,2025-10-26,2025-10-27,Uber UK,4121,Transport,Ride Hailing,-21.48,GBP,-41399.62,E-Com,London,GB,9074,user_001,,
ab9aab3c-4e3b-410e-8110-adc8e0dfb621,2025-10-26,2025-10-27,Pret A Manger,5814,Food & Drink,Eating Out,-9.0,GBP,-41408.62,POS,London,GB,4488,user_001,,
d7002663-b879-4f58-b415-3c5eae422858,2025-10-26,2025-10-28,Deliveroo,5812,Food & Drink,Delivery,-14.77,GBP,-41423.39,E-Com,London,GB,1045,user_001,,
494de5bf-57df-494a-927f-07557305bcbb,2025-10-27,2025-10-29,Amazon UK,5942,Shopping,Online Retail,-88.87,GBP,-41512.26,E-Com,London,GB,1045,user_001,,
4d0d7136-c9ea-468c-a61f-1b9d7fcbf503,2025-10-27,2025-10-29,Waitrose,5411,Groceries,Supermarket,-84.29,GBP,-41596.55,POS,London,GB,2219,user_001,,
561c65ac-2145-47f6-b847-9bfadbf91553,2025-10-28,2025-10-29,Shell,5541,Transport,Fuel,-39.0,GBP,-41635.55,POS,London,GB,4488,user_001,,
fad2d779-c0dd-4a5e-9c17-5d30cd8e28a0,2025-10-28,2025-10-29,Transport for London,4111,Transport,Transit,-8.64,GBP,-41644.19,POS,London,GB,2219,user_001,,
49db895f-89ad-48e8-b379-448f4ec688fc,2025-10-29,2025-10-29,Sainsbury's,5411,Groceries,Supermarket,-16.02,GBP,-41660.21,POS,London,GB,2219,user_001,,
c32b83f2-87b7-4f30-9980-54c358f8d7b1,2025-10-30,2025-11-03,ATM Withdrawal,6011,Cash,ATM,-97.74,GBP,-41757.95,ATM,London,GB,9074,user_002,,
e3f5e746-cd0a-415e-b50e-eeffd3cc37f2,2025-10-31,2025-10-31,Waitrose,5411,Groceries,Supermarket,-21.57,GBP,-41779.52,POS,London,GB,1045,user_001,,
13989849-1e8c-454c-bf59-3512d2d5eca7,2025-11-01,2025-11-03,Shell,5541,Transport,Fuel,-39.68,GBP,-41819.2,POS,London,GB,9074,user_001,,
5584da1e-8321-4e18-8d7e-9a3a867dfa40,2025-11-01,2025-11-03,Deliveroo,5812,Food & Drink,Delivery,-17.21,GBP,-41836.41,E-Com,London,GB,9074,user_001,,
917e1c83-2751-43dd-a9a7-e4dd046ceab4,2025-11-01,2025-11-03,Local Market,5499,Groceries,Specialty,-10.21,GBP,-41846.62,POS,London,GB,4488,user_001,,
abe3d167-726f-4eb5-9f27-e6417a89d207,2025-11-01,2025-11-03,Sainsbury's,5411,Groceries,Supermarket,-26.28,GBP,-41872.9,POS,London,GB,9074,user_001,,
76674b48-f1ce-42f0-99dc-699e71168f89,2025-11-02,2025-11-03,Waitrose,5411,Groceries,Supermarket,-33.55,GBP,-41906.45,POS,London,GB,1045,user_001,,
bb3e15af-5024-4c0f-9320-0b8ec9b88b5d,2025-11-02,2025-11-03,Airline Refund,4511,Travel,Refund,5.8,GBP,-41900.65,Credit,London,GB,1045,user_001,,Refund for Pret A Manger
f0110e7e-d499-4a6c-ae95-15ebf5e32c3a,2025-11-02,2025-11-03,Shell,5541,Transport,Fuel,-55.91,GBP,-41956.56,POS,London,GB,9074,user_001,,
42ca2f00-f564-4c21-94a5-1fd767e01f9c,2025-11-03,2025-11-03,Crown Estates Lettings,6513,Housing,Rent,-1461.21,GBP,-43417.77,POS,London,GB,1045,user_001,rec_19f70fbcce,
4a43e744-5dfc-4eb7-91eb-075c33904c77,2025-11-03,2025-11-03,Waitrose,5411,Groceries,Supermarket,-89.91,GBP,-43507.68,POS,London,GB,4488,user_001,,
baabe467-e6b2-48e6-9509-11c97e6bdb88,2025-11-03,2025-11-05,Waitrose,5411,Groceries,Supermarket,-44.63,GBP,-43552.31,POS,London,GB,1045,user_001,,
e43e7983-292b-4f8a-8e9c-40e8c4b91f88,2025-11-03,2025-11-04,Uber UK,4121,Transport,Ride Hailing,-23.09,GBP,-43575.4,E-Com,London,GB,9074,user_001,,
a10c74e8-1781-46dd-8822-c064f6fbfb8a,2025-11-04,2025-11-04,Pret A Manger,5814,Food & Drink,Eating Out,-8.44,GBP,-43583.84,POS,London,GB,4488,user_001,,
af31987e-e6c7-4910-b3a9-cd47f19f459a,2025-11-05,2025-11-05,Waitrose,5411,Groceries,Supermarket,-28.32,GBP,-43612.16,POS,London,GB,4488,user_001,,
03a4cf58-7928-4458-9092-fc0e6f8dcbd3,2025-11-06,2025-11-07,Amazon UK,5942,Shopping,Online Retail,-54.32,GBP,-43666.48,E-Com,London,GB,9074,user_002,,
376ee6a1-8557-42bc-9adf-553123957a40,2025-11-06,2025-11-10,Airbnb,7011,Travel,Accommodation,-398.99,GBP,-44065.47,E-Com,Dublin,IE,1045,user_001,,Holiday booking
aa466359-e1f7-40a5-97a9-7e7db8d67cd3,2025-11-07,2025-11-10,Octopus Energy,4900,Utilities,Electricity,-137.25,GBP,-44202.72,Direct Debit,London,GB,1045,user_001,rec_141a4a0666,
0f6770f3-13ac-4eb3-b3bd-133b51a80b14,2025-11-08,2025-11-10,Local Market,5499,Groceries,Specialty,-11.92,GBP,-44214.64,POS,London,GB,9074,user_001,,
982dcff1-ac83-4bc3-944d-5b5f5f1f770c,2025-11-08,2025-11-10,Transport for London,4111,Transport,Transit,-5.97,GBP,-44220.61,POS,London,GB,4488,user_001,,
9eca21e4-70e6-43ee-9cda-d5f9b6f3cbee,2025-11-08,2025-11-10,Waitrose,5411,Groceries,Supermarket,-77.15,GBP,-44297.76,POS,London,GB,1045,user_001,,
b35b383a-edce-465c-b071-59dfe74dcc28,2025-11-08,2025-11-10,Uber UK,4121,Transport,Ride Hailing,-10.39,GBP,-44308.15,E-Com,London,GB,9074,user_001,,
b5d093ef-6208-4fae-bec1-68ba332f4e7b,2025-11-08,2025-11-10,Uber UK,4121,Transport,Ride Hailing,-13.85,GBP,-44322.0,E-Com,London,GB,4488,user_002,,
d8f0b11b-e16b-471c-af0d-681f90aa2bf6,2025-11-08,2025-11-10,Pret A Manger,5814,Food & Drink,Eating Out,-11.1,GBP,-44333.1,POS,London,GB,2219,user_001,,
26d4c3ab-7c99-4e24-9560-782bd8dc5dea,2025-11-09,2025-11-10,Transport for London,4111,Transport,Transit,-4.47,GBP,-44337.57,POS,London,GB,4488,user_001,,
af1ae735-b4eb-4dee-b67a-999750c0e48a,2025-11-09,2025-11-11,Local Market,5499,Groceries,Specialty,-15.3,GBP,-44352.87,POS,London,GB,9074,user_001,,
b42517b9-16c2-4eb2-a723-c51bfbf8c984,2025-11-09,2025-11-11,Waitrose,5411,Groceries,Supermarket,-85.04,GBP,-44437.91,POS,London,GB,2219,user_001,,
d9f78444-319a-4933-8872-8b69629dbef8,2025-11-09,2025-11-11,Amazon UK,5942,Shopping,Online Retail,-84.16,GBP,-44522.07,E-Com,London,GB,1045,user_001,,
828b26ab-027e-4448-9685-ca675d22f2e6,2025-11-10,2025-11-11,Transport for London,4111,Transport,Transit,-11.88,GBP,-44533.95,POS,London,GB,9074,user_001,,
9fa775c5-ce33-4430-9813-a2ab9dbb64f6,2025-11-10,2025-11-11,Amazon UK,5942,Shopping,Online Retail,-77.72,GBP,-44611.67,E-Com,London,GB,4488,user_001,,
4e15a39c-09f6-4013-8ebc-cfff98955135,2025-11-11,2025-11-13,Apple.com/bill,5734,Shopping,Electronics,-184.58,GBP,-44796.25,E-Com,Cupertino,US,1045,user_002,,
59875096-1316-4e9e-8088-bac6a810ba65,2025-11-11,2025-11-11,Shell,5541,Transport,Fuel,-36.47,GBP,-44832.72,POS,London,GB,4488,user_002,,
b1b09ce8-03d0-4e42-a5ed-fe234118773f,2025-11-11,2025-11-12,Thames Water,4900,Utilities,Water,-34.69,GBP,-44867.41,Direct Debit,Reading,GB,2219,user_001,rec_3a34d62842,
b3639e5e-5f54-4094-8811-6888e9e72dd7,2025-11-11,2025-11-13,Shell,5541,Transport,Fuel,-91.39,GBP,-44958.8,POS,London,GB,4488,user_001,,
439e9142-2da1-4532-94f7-f1858ca898cf,2025-11-13,2025-11-13,Uber UK,4121,Transport,Ride Hailing,-30.56,GBP,-44989.36,E-Com,London,GB,2219,user_001,,
4df0bcea-0fe8-4c70-9ae6-b3628d658059,2025-11-13,2025-11-13,City Council Tax,9399,Utilities,Council Tax,-189.25,GBP,-45178.61,Direct Debit,London,GB,9074,user_001,rec_f531495db5,
4b5bd97d-1076-4171-9a34-9e76b4c65165,2025-11-14,2025-11-17,Shell,5541,Transport,Fuel,-93.21,GBP,-45271.82,POS,London,GB,2219,user_001,,
c4a4b109-acb4-4b10-b72a-55a16a51930a,2025-11-14,2025-11-17,Amazon UK,5942,Shopping,Online Retail,-92.95,GBP,-45364.77,E-Com,London,GB,4488,user_001,,
8f36fc12-c6ac-4c13-bd76-7eed8bad58a5,2025-11-15,2025-11-17,Waitrose,5411,Groceries,Supermarket,-50.99,GBP,-45415.76,POS,London,GB,4488,user_001,,
a5b28605-3ea0-41a1-82f3-172134e3e6fb,2025-11-15,2025-11-17,Waitrose,5411,Groceries,Supermarket,-37.64,GBP,-45453.4,POS,London,GB,4488,user_001,,
2e008fc0-679f-4758-ba7b-134a61a17267,2025-11-16,2025-11-18,Apple.com/bill,5734,Shopping,Electronics,-59.86,USD,-45513.26,E-Com,Cupertino,US,9074,user_001,,FX purchase 76.01 USD @ rate 1.27
5ebda5d3-30d8-4abd-a7c3-a38fbac96bca,2025-11-16,2025-11-17,Tesco,5411,Groceries,Supermarket,-19.88,GBP,-45533.14,POS,London,GB,2219,user_002,,
cc0bf779-5370-464d-9997-114b8ac60df0,2025-11-17,2025-11-18,O2 UK,4814,Bills,Mobile,-49.2,GBP,-45582.34,Direct Debit,Slough,GB,2219,user_001,rec_95042d8101,
e2f223eb-d7d2-4aac-90c9-a95a6e142af5,2025-11-17,2025-11-18,Apple.com/bill,5734,Shopping,Electronics,-204.39,USD,-45786.73,E-Com,Cupertino,US,2219,user_001,,FX purchase 262.42 USD @ rate 1.28
ec465161-223e-4d52-bf0f-60db7851158e,2025-11-17,2025-11-19,GymBox,7997,Wellness,Gym,-47.87,GBP,-45834.6,Direct Debit,London,GB,2219,user_001,rec_3906953fd2,
cb02f33d-3652-466c-b4ff-548910e65ef2,2025-11-18,2025-11-18,Transport for London,4111,Transport,Transit,-4.8,GBP,-45839.4,POS,London,GB,4488,user_001,,
0350280b-360f-469f-93a4-1c38ec336670,2025-11-19,2025-11-21,Sainsbury's,5411,Groceries,Supermarket,-68.85,GBP,-45908.25,POS,London,GB,9074,user_001,,
40e9b75e-1c6a-4ca4-877b-3cb61abd321c,2025-11-19,2025-11-21,Spotify,5735,Entertainment,Subscriptions,-9.11,EUR,-45917.36,E-Com,Stockholm,SE,9074,user_001,rec_4c746d2c3b,FX purchase 10.75 EUR @ rate 1.18
77c82215-9f58-48fa-a2d4-16db0ef00d16,2025-11-19,2025-11-21,Shell,5541,Transport,Fuel,-86.07,GBP,-46003.43,POS,London,GB,1045,user_001,,
dc05a976-35dc-4ef7-a461-4c2f58218f9e,2025-11-19,2025-11-20,Shell,5541,Transport,Fuel,-75.25,GBP,-46078.68,POS,London,GB,1045,user_001,,
6990c222-a911-4596-970c-d35d1ef4baaa,2025-11-20,2025-11-24,Waitrose,5411,Groceries,Supermarket,-70.84,GBP,-46149.52,POS,London,GB,9074,user_001,,
9a0bfe4c-3efe-4d81-b42f-686672c09a2b,2025-11-21,2025-11-24,Netflix,7841,Entertainment,Subscriptions,-10.04,GBP,-46159.56,E-Com,Los Gatos,US,2219,user_001,rec_1bfe33738d,
aca803b8-8eec-4180-80e2-a5b1e1594ff2,2025-11-21,2025-11-24,Waitrose,5411,Groceries,Supermarket,-40.17,GBP,-46199.73,POS,London,GB,4488,user_001,,
b0d514e8-75db-4d3f-a122-4fe495f07481,2025-11-21,2025-11-24,Sainsbury's,5411,Groceries,Supermarket,-19.72,GBP,-46219.45,POS,London,GB,9074,user_001,,
b0fb6247-af8b-4ad9-acec-1da0fc1c6c9f,2025-11-21,2025-11-24,Pret A Manger,5814,Food & Drink,Eating Out,-9.6,GBP,-46229.05,POS,London,GB,9074,user_001,,
15e4caaa-5c9d-402f-a11b-ec50690bce67,2025-11-22,2025-11-24,Sainsbury's,5411,Groceries,Supermarket,-35.42,GBP,-46264.47,POS,London,GB,9074,user_001,,
5cb2de76-4a73-4318-9f65-658fab9bc6cd,2025-11-22,2025-11-24,Transport for London,4111,Transport,Transit,-9.61,GBP,-46274.08,POS,London,GB,9074,user_001,,
7d27b8b6-96b0-4ce6-97d1-eb86901bcad8,2025-11-22,2025-11-24,Uber UK,4121,Transport,Ride Hailing,-22.35,GBP,-46296.43,E-Com,London,GB,2219,user_002,,
f2136fa2-de3f-4b66-8ebd-f2942b3596f2,2025-11-22,2025-11-24,Transport for London,4111,Transport,Transit,-4.46,GBP,-46300.89,POS,London,GB,4488,user_001,,
24b80937-6a32-40fe-b532-4a8772e274fb,2025-11-23,2025-11-24,Sainsbury's,5411,Groceries,Supermarket,-57.7,GBP,-46358.59,POS,London,GB,2219,user_002,,
8e1fa5b0-9bff-4a88-afb9-f1c994469acc,2025-11-23,2025-11-25,Amazon UK,5942,Shopping,Online Retail,-65.04,GBP,-46423.63,E-Com,London,GB,2219,user_001,,
b0fcaf5d-f843-4b4c-8155-c6ebcc28ba95,2025-11-23,2025-11-25,Waitrose,5411,Groceries,Supermarket,-27.74,GBP,-46451.37,POS,London,GB,1045,user_002,,
ca737baf-13f6-4940-8d4a-d3e79ac5b6ac,2025-11-23,2025-11-24,Shell,5541,Transport,Fuel,-46.48,GBP,-46497.85,POS,London,GB,4488,user_001,,
cc1f6859-f0d4-4d74-b69c-4eb028680ea4,2025-11-23,2025-11-24,Shell,5541,Transport,Fuel,-45.72,GBP,-46543.57,POS,London,GB,4488,user_001,,
ddeadb4d-e0da-4484-af1d-db2c12395f62,2025-11-23,2025-11-24,Deliveroo,5812,Food & Drink,Delivery,-21.26,GBP,-46564.83,E-Com,London,GB,1045,user_001,,
e7a61272-2427-4dd2-a71f-a0f20f47b656,2025-11-23,2025-11-25,Local Market,5499,Groceries,Specialty,-18.04,GBP,-46582.87,POS,London,GB,2219,user_001,,
f4011ad4-9975-425b-b5f8-1a62b1e76ab6,2025-11-23,2025-11-25,Apple.com/bill,5734,Shopping,Electronics,-91.27,GBP,-46674.14,E-Com,Cupertino,US,2219,user_002,,
556536a0-5e8a-4bc6-b017-1f98dad8e607,2025-11-24,2025-11-25,Waitrose,5411,Groceries,Supermarket,-42.75,GBP,-46716.89,POS,London,GB,1045,user_001,,
654d0a47-fb4a-40bf-9f71-d18e63f984fc,2025-11-24,2025-11-24,Apple.com/bill,5734,Shopping,Electronics,-53.33,GBP,-46770.22,E-Com,Cupertino,US,1045,user_001,,
e91da59d-1422-4e1d-8808-c05ee62a7449,2025-11-25,2025-11-25,T212 Capital,6011,Income,Salary,2997.07,GBP,-43773.15,Credit,London,GB,2219,user_001,rec_2ff8f778d0,
29d1c67d-5161-46cc-86b1-bc9fbe27f426,2025-11-26,2025-11-28,Waitrose,5411,Groceries,Supermarket,-21.59,GBP,-43794.74,POS,London,GB,9074,user_001,,
3bee825f-8ce4-4e46-b257-3530c28784b7,2025-11-26,2025-11-27,Uber UK,4121,Transport,Ride Hailing,-30.8,GBP,-43825.54,E-Com,London,GB,2219,user_001,,
9d2bc386-e87d-49a5-a361-75434f34d7d8,2025-11-26,2025-11-27,Apple.com/bill,5734,Shopping,Electronics,-141.05,USD,-43966.59,E-Com,Cupertino,US,2219,user_001,,FX purchase 172.91 USD @ rate 1.23
3ad5a241-391f-435c-af05-38fa23cdb282,2025-11-28,2025-12-01,Local Market,5499,Groceries,Specialty,-10.98,GBP,-43977.57,POS,London,GB,4488,user_002,,
7847415a-17e3-4133-aca0-88ff4c593c89,2025-11-28,2025-12-01,Local Market,5499,Groceries,Specialty,-13.44,GBP,-43991.01,POS,London,GB,2219,user_001,,
fd80ab69-f3a2-477b-8333-124c08fe8ccb,2025-11-28,2025-12-01,Waitrose,5411,Groceries,Supermarket,-73.71,GBP,-44064.72,POS,London,GB,4488,user_002,,
ffcec1dc-7bb5-435a-a40c-ed938a3a5181,2025-11-28,2025-12-01,Transport for London,4111,Transport,Transit,-6.79,GBP,-44071.51,POS,London,GB,1045,user_001,,
168ee02d-54a1-4367-a830-25321871b51e,2025-11-29,2025-12-01,Sainsbury's,5411,Groceries,Supermarket,-23.51,GBP,-44095.02,POS,London,GB,1045,user_001,,
2e9bf7bb-77b6-4f3f-89ee-d3897fc439f7,2025-11-29,2025-12-01,Deliveroo,5812,Food & Drink,Delivery,-15.86,GBP,-44110.88,E-Com,London,GB,9074,user_001,,
36b08285-8dc4-4cd1-8892-981d049379d4,2025-11-29,2025-12-01,Apple.com/bill,5734,Shopping,Electronics,-198.58,GBP,-44309.46,E-Com,Cupertino,US,1045,user_001,,
9ab52e20-3c3f-4343-9dcf-ebcd4efcd2cb,2025-11-29,2025-12-01,Sainsbury's,5411,Groceries,Supermarket,-64.16,GBP,-44373.62,POS,London,GB,4488,user_002,,
a9cf5df7-3f98-41c9-8b2c-b33a592a43d5,2025-11-29,2025-12-01,Pret A Manger,5814,Food & Drink,Eating Out,-10.89,GBP,-44384.51,POS,London,GB,2219,user_001,,
e2192f25-8600-43b7-8178-7b6f23a2d96b,2025-11-29,2025-12-01,Local Market,5499,Groceries,Specialty,-15.06,GBP,-44399.57,POS,London,GB,4488,user_001,,
ea9ca98f-5687-4772-a0b1-3ddba1e64a36,2025-11-29,2025-12-01,Local Market,5499,Groceries,Specialty,-11.28,GBP,-44410.85,POS,London,GB,4488,user_001,,
05a7bc18-5064-4580-bfc3-2e30d93d12b6,2025-11-30,2025-12-01,Tesco,5411,Groceries,Supermarket,-25.54,GBP,-44436.39,POS,London,GB,2219,user_001,,
c4abd2b5-ed9d-445c-8ba7-6bdc7cfb852d,2025-11-30,2025-12-02,Amazon UK,5942,Shopping,Online Retail,-119.67,GBP,-44556.06,E-Com,London,GB,4488,user_001,,
dc5bde54-626a-4c6b-b819-1e5096852378,2025-11-30,2025-12-01,Shell,5541,Transport,Fuel,-69.15,GBP,-44625.21,POS,London,GB,9074,user_001,,
f17c2ebd-f5eb-4a40-930d-366ab3954641,2025-11-30,2025-12-01,Sainsbury's,5411,Groceries,Supermarket,-28.41,GBP,-44653.62,POS,London,GB,9074,user_001,,
1278e958-fe53-42be-99d6-efcc3cbb9b6f,2025-12-01,2025-12-03,Local Market,5499,Groceries,Specialty,-16.17,GBP,-44669.79,POS,London,GB,2219,user_001,,
9a99094b-bb64-4320-b116-da0c035e6a79,2025-12-01,2025-12-02,Crown Estates Lettings,6513,Housing,Rent,-1629.86,GBP,-46299.65,POS,London,GB,4488,user_002,rec_fc2ae06846,
cb27c4f3-1085-4e37-a49c-0f355facb8cd,2025-12-01,2025-12-01,Sainsbury's,5411,Groceries,Supermarket,-27.53,GBP,-46327.18,POS,London,GB,9074,user_001,,
e11e74b3-b622-4a4f-88f3-696ab79307bf,2025-12-02,2025-12-04,Local Market,5499,Groceries,Specialty,-13.17,GBP,-46340.35,POS,London,GB,1045,user_001,,
48da969b-40b8-4017-86c9-50c989348122,2025-12-03,2025-12-03,Apple.com/bill,5734,Shopping,Electronics,-158.7,USD,-46499.05,E-Com,Cupertino,US,2219,user_001,,FX purchase 200.82 USD @ rate 1.27
373cadbe-453c-405c-b66f-1c0729e5f9f3,2025-12-04,2025-12-04,Shell,5541,Transport,Fuel,-62.18,GBP,-46561.23,POS,London,GB,2219,user_001,,
9f70bf80-4971-4369-8008-7ffc4bd015da,2025-12-04,2025-12-08,Apple.com/bill,5734,Shopping,Electronics,-164.54,USD,-46725.77,E-Com,Cupertino,US,2219,user_001,,FX purchase 198.63 USD @ rate 1.21
f147b521-d114-43ae-adfd-71e74f9fb82c,2025-12-04,2025-12-08,Amazon UK,5942,Shopping,Online Retail,-16.07,GBP,-46741.84,E-Com,London,GB,9074,user_001,,
543ea64a-e8e1-4cd4-b3aa-d15d63f43db5,2025-12-05,2025-12-08,Deliveroo,5812,Food & Drink,Delivery,-16.89,GBP,-46758.73,E-Com,London,GB,4488,user_001,,
cc237cbc-c9f2-4cfe-963d-b9e992e941b8,2025-12-05,2025-12-05,Airline Refund,4511,Travel,Refund,45.2,GBP,-46713.53,Credit,London,GB,4488,user_001,,Refund for Apple.com/bill
aff93688-28ff-4247-ab41-f04195063cf8,2025-12-06,2025-12-08,Local Market,5499,Groceries,Specialty,-18.49,GBP,-46732.02,POS,London,GB,4488,user_002,,
bc607eaf-69cf-445e-bebb-8e5db3b2199b,2025-12-06,2025-12-08,Waitrose,5411,Groceries,Supermarket,-59.65,GBP,-46791.67,POS,London,GB,2219,user_001,,
5cb4d6ff-2255-46f6-92ce-d297a8ab43da,2025-12-07,2025-12-08,Apple.com/bill,5734,Shopping,Electronics,-12.22,GBP,-46803.89,E-Com,Cupertino,US,9074,user_001,,
c83dcd27-c552-42b2-a814-e9d1690cd4a3,2025-12-07,2025-12-08,Waitrose,5411,Groceries,Supermarket,-71.52,GBP,-46875.41,POS,London,GB,9074,user_001,,
bbe627b7-b9ff-4316-a0bd-57693c897153,2025-12-08,2025-12-10,Octopus Energy,4900,Utilities,Electricity,-121.93,GBP,-46997.34,Direct Debit,London,GB,2219,user_001,rec_141a4a0666,
202cabfe-e2ba-4c9f-86ea-d45cce5727c6,2025-12-09,2025-12-10,Shell,5541,Transport,Fuel,-59.38,GBP,-47056.72,POS,London,GB,4488,user_001,,
ed861c49-4dc6-4f36-88ef-03d3163ea34e,2025-12-09,2025-12-09,HM Revenue & Customs,9311,Income,Tax Refund,56.68,GBP,-47000.04,Credit,London,GB,2219,user_001,,Refund for Amazon UK
7b3eea0d-dafd-4be9-93c7-a74ba885f1be,2025-12-10,2025-12-12,Waitrose,5411,Groceries,Supermarket,-21.7,GBP,-47021.74,POS,London,GB,9074,user_001,,
7d1a0831-9c31-4ff4-8802-8bc96246f968,2025-12-10,2025-12-10,Sainsbury's,5411,Groceries,Supermarket,-16.76,GBP,-47038.5,POS,London,GB,2219,user_001,,
47f3c731-066f-4012-88bc-8b475b9232b0,2025-12-11,2025-12-15,Local Market,5499,Groceries,Specialty,-10.14,GBP,-47048.64,POS,London,GB,4488,user_001,,
8fd6e175-9b4b-448e-a5bc-492869376c4d,2025-12-11,2025-12-11,Uber UK,4121,Transport,Ride Hailing,-33.06,GBP,-47081.7,E-Com,London,GB,2219,user_001,,
a0d11819-1e54-4d24-be18-0b5cea337a81,2025-12-11,2025-12-15,Apple.com/bill,5734,Shopping,Electronics,-190.93,GBP,-47272.63,E-Com,Cupertino,US,2219,user_001,,
d14a9bce-6c36-463b-9b8e-8c53eb427505,2025-12-11,2025-12-15,Thames Water,4900,Utilities,Water,-43.19,GBP,-47315.82,Direct Debit,Reading,GB,9074,user_001,rec_3a34d62842,
fad2dc14-4cc5-4632-8992-eba103ad62d4,2025-12-11,2025-12-11,HM Revenue & Customs,9311,Income,Tax Refund,110.1,GBP,-47205.72,Credit,London,GB,2219,user_001,,Refund for Apple.com/bill
ebfebbbc-656e-4c99-9338-7dc60e7ea442,2025-12-12,2025-12-12,Pret A Manger,5814,Food & Drink,Eating Out,-10.45,GBP,-47216.17,POS,London,GB,9074,user_001,,
3f6726ca-7ba5-48f0-af16-d52c978dedac,2025-12-13,2025-12-15,Amazon UK,5942,Shopping,Online Retail,-15.32,GBP,-47231.49,E-Com,London,GB,2219,user_001,,
011a26ad-bc6a-4432-b033-0b42cae2db6e,2025-12-14,2025-12-16,Tesco,5411,Groceries,Supermarket,-84.45,GBP,-47315.94,POS,London,GB,2219,user_001,,
1c8447cb-6d5d-4b08-a3aa-9fdabdf21088,2025-12-14,2025-12-15,Uber UK,4121,Transport,Ride Hailing,-22.9,GBP,-47338.84,E-Com,London,GB,2219,user_002,,
4f460d5d-f6f4-454d-aedf-ae28289365d2,2025-12-14,2025-12-16,Tesco,5411,Groceries,Supermarket,-25.91,GBP,-47364.75,POS,London,GB,2219,user_001,,
3378fe0d-52a5-437f-978a-cbe3a1bae5b9,2025-12-15,2025-12-17,O2 UK,4814,Bills,Mobile,-53.74,GBP,-47418.49,Direct Debit,Slough,GB,2219,user_001,rec_95042d8101,
59fe9923-a41f-470e-9c64-51cf8359b8c4,2025-12-15,2025-12-16,City Council Tax,9399,Utilities,Council Tax,-170.42,GBP,-47588.91,Direct Debit,London,GB,4488,user_001,rec_f531495db5,
a5d9a618-6dfa-4ab5-8104-dd2a2461c8df,2025-12-15,2025-12-17,Apple.com/bill,5734,Shopping,Electronics,-37.86,USD,-47626.77,E-Com,Cupertino,US,4488,user_002,,FX purchase 46.69 USD @ rate 1.23
b1ce0659-7f0a-40ae-8a1d-15ff72fc22f4,2025-12-15,2025-12-17,Waitrose,5411,Groceries,Supermarket,-71.48,GBP,-47698.25,POS,London,GB,2219,user_001,,
2769cf79-af20-42e4-a420-dfa08f6e6b38,2025-12-17,2025-12-17,Deliveroo,5812,Food & Drink,Delivery,-12.82,GBP,-47711.07,E-Com,London,GB,2219,user_001,,
6ea6d847-d779-4502-aeeb-f84e688b0fdb,2025-12-17,2025-12-19,Apple.com/bill,5734,Shopping,Electronics,-112.26,GBP,-47823.33,E-Com,Cupertino,US,1045,user_001,,
879d5980-35c0-48f0-9a93-f234b50ace5d,2025-12-17,2025-12-17,GymBox,7997,Wellness,Gym,-51.63,GBP,-47874.96,Direct Debit,London,GB,1045,user_001,rec_3906953fd2,
e8069d93-2c06-4a7b-8b2b-e1bdd3e92d29,2025-12-18,2025-12-19,Tesco,5411,Groceries,Supermarket,-46.54,GBP,-47921.5,POS,London,GB,9074,user_001,,
4ccd4933-05c3-4117-b628-e8d216a693fe,2025-12-19,2025-12-19,Spotify,5735,Entertainment,Subscriptions,-9.9,GBP,-47931.4,E-Com,Stockholm,SE,9074,user_001,rec_4c746d2c3b,
5b638958-d283-4364-be3d-713f1d30953e,2025-12-19,2025-12-19,Uber UK,4121,Transport,Ride Hailing,-9.5,GBP,-47940.9,E-Com,London,GB,9074,user_002,,
ae298b1f-5354-42d4-90cb-15379c2a8f2a,2025-12-19,2025-12-19,Pret A Manger,5814,Food & Drink,Eating Out,-8.52,GBP,-47949.42,POS,London,GB,4488,user_001,,
e4551835-e3c9-4582-86ec-896c3106130e,2025-12-19,2025-12-22,Sainsbury's,5411,Groceries,Supermarket,-51.18,GBP,-48000.6,POS,London,GB,2219,user_001,,
fa1076dd-ff30-4e42-a63d-31582b1777d5,2025-12-19,2025-12-22,Transport for London,4111,Transport,Transit,-4.15,GBP,-48004.75,POS,London,GB,4488,user_001,,
1b64054f-c8c1-4d3f-9f92-30eb5bbddc34,2025-12-20,2025-12-22,Deliveroo,5812,Food & Drink,Delivery,-12.79,GBP,-48017.54,E-Com,London,GB,4488,user_001,,
2f380e95-b1a4-4f58-9d87-a954c6f09954,2025-12-20,2025-12-22,Apple.com/bill,5734,Shopping,Electronics,-100.32,GBP,-48117.86,E-Com,Cupertino,US,1045,user_001,,
4ad2f70a-f2bd-493b-97a3-ee05ae67924b,2025-12-20,2025-12-22,Shell,5541,Transport,Fuel,-65.49,GBP,-48183.35,POS,London,GB,2219,user_002,,
725dfc91-eeb4-46b7-a29d-9fe4f70f577f,2025-12-20,2025-12-22,Sainsbury's,5411,Groceries,Supermarket,-30.87,GBP,-48214.22,POS,London,GB,2219,user_001,,
dfddae7f-d89d-49c1-8cb8-b568e728c740,2025-12-20,2025-12-22,Tesco,5411,Groceries,Supermarket,-37.7,GBP,-48251.92,POS,London,GB,1045,user_001,,
26b3fd41-4b56-41bf-93f4-7456e62ad092,2025-12-21,2025-12-23,Shell,5541,Transport,Fuel,-68.79,GBP,-48320.71,POS,London,GB,2219,user_001,,
2b123f2d-7541-4cb6-b64d-b4d97faadc82,2025-12-21,2025-12-23,Transport for London,4111,Transport,Transit,-6.32,GBP,-48327.03,POS,London,GB,4488,user_001,,
45715e4c-a09e-4119-a248-7e3032adbdf9,2025-12-21,2025-12-22,Amazon UK,5942,Shopping,Online Retail,-43.43,GBP,-48370.46,E-Com,London,GB,4488,user_001,,
b15cf379-6bdd-41a4-8121-2a294f3db441,2025-12-21,2025-12-23,Pret A Manger,5814,Food & Drink,Eating Out,-9.66,GBP,-48380.12,POS,London,GB,4488,user_001,,
d46faccf-7642-4496-a398-d8d688e49f13,2025-12-22,2025-12-22,Netflix,7841,Entertainment,Subscriptions,-15.5,GBP,-48395.62,E-Com,Los Gatos,US,1045,user_001,rec_1bfe33738d,
2aeabc0c-58b2-4fbb-b53e-b124c3744c6b,2025-12-23,2025-12-25,Pret A Manger,5814,Food & Drink,Eating Out,-6.79,GBP,-48402.41,POS,London,GB,2219,user_001,,
37449df0-c8c9-473d-9f48-fd08402cb889,2025-12-24,2025-12-25,Airbnb,7011,Travel,Accommodation,-356.51,EUR,-48758.92,E-Com,Dublin,IE,1045,user_001,,Business travel
bdcd573d-784e-4f83-9911-43e03039bf7d,2025-12-25,2025-12-25,T212 Capital,6011,Income,Salary,3437.02,GBP,-45321.9,Credit,London,GB,2219,user_001,rec_2ff8f778d0,
3dbed8e6-f000-4c92-b002-d913a6388819,2025-12-26,2025-12-29,Local Market,5499,Groceries,Specialty,-6.79,GBP,-45328.69,POS,London,GB,4488,user_001,,
4cdc4dee-f23b-4d68-97c4-ed0ab6036719,2025-12-27,2025-12-29,Local Market,5499,Groceries,Specialty,-12.05,GBP,-45340.74,POS,London,GB,4488,user_002,,
5473b82e-99c3-4371-8bdc-91594eb6e9bc,2025-12-27,2025-12-29,Deliveroo,5812,Food & Drink,Delivery,-28.17,GBP,-45368.91,E-Com,London,GB,9074,user_001,,
67d97e31-6385-4bc3-9ae0-1f00f334cc9f,2025-12-27,2025-12-29,Shell,5541,Transport,Fuel,-39.3,GBP,-45408.21,POS,London,GB,4488,user_001,,
700665cc-738c-4ea2-9fdb-eba0a7c50a61,2025-12-27,2025-12-29,Local Market,5499,Groceries,Specialty,-10.23,GBP,-45418.44,POS,London,GB,2219,user_001,,
d2566d90-09f5-4f95-b49b-f6914ee56884,2025-12-27,2025-12-29,Amazon UK,5942,Shopping,Online Retail,-14.61,GBP,-45433.05,E-Com,London,GB,1045,user_001,,
e3d8a2c6-f7ea-4558-9013-4985190365c7,2025-12-27,2025-12-29,Transport for London,4111,Transport,Transit,-9.06,GBP,-45442.11,POS,London,GB,9074,user_001,,
4d6632c9-3622-4f4b-9312-7f08611a6360,2025-12-28,2025-12-29,Transport for London,4111,Transport,Transit,-7.84,GBP,-45449.95,POS,London,GB,9074,user_001,,
6abf98b1-aee5-486e-bfcf-cdd14cdc008f,2025-12-28,2025-12-29,Local Market,5499,Groceries,Specialty,-13.62,GBP,-45463.57,POS,London,GB,2219,user_001,,
85c61aa1-c972-4a56-8805-c1e9d7077907,2025-12-28,2025-12-30,Apple.com/bill,5734,Shopping,Electronics,-80.89,GBP,-45544.46,E-Com,Cupertino,US,1045,user_002,,
e1b6d670-054a-42b1-8388-f96265ffa503,2025-12-28,2025-12-29,Pret A Manger,5814,Food & Drink,Eating Out,-10.34,GBP,-45554.8,POS,London,GB,1045,user_001,,
2c0af652-140b-4278-9329-d32715dba463,2025-12-29,2025-12-31,Sainsbury's,5411,Groceries,Supermarket,-16.78,GBP,-45571.58,POS,London,GB,4488,user_001,,
3c8f8acd-2910-40e3-8ddf-e7099f4edf5a,2025-12-29,2025-12-29,Local Market,5499,Groceries,Specialty,-21.16,GBP,-45592.74,POS,London,GB,2219,user_001,,
12996e47-9ee4-4790-8ebc-28fccccbc845,2025-12-30,2025-12-31,Local Market,5499,Groceries,Specialty,-7.18,GBP,-45599.92,POS,London,GB,9074,user_002,,
b0bb9991-7732-4c55-a2b5-b860a89625e6,2025-12-30,2025-12-31,Deliveroo,5812,Food & Drink,Delivery,-30.49,GBP,-45630.41,E-Com,London,GB,9074,user_001,,
8557f337-2939-45f0-a0d7-36b053905e43,2025-12-31,2025-12-31,Airline Refund,4511,Travel,Refund,36.99,GBP,-45593.42,Credit,London,GB,9074,user_001,,Refund for Tesco
66724aea-6558-45e9-80e0-1f26743001ec,2026-01-01,2026-01-05,Crown Estates Lettings,6513,Housing,Rent,-1594.24,GBP,-47187.66,POS,London,GB,4488,user_001,rec_19f70fbcce,
87aff51b-2181-4046-b486-800be3c9fa1e,2026-01-01,2026-01-05,Deliveroo,5812,Food & Drink,Delivery,-28.75,GBP,-47216.41,E-Com,London,GB,9074,user_001,,
99a306ef-946b-48f9-9515-db7fbe60603a,2026-01-02,2026-01-05,Sainsbury's,5411,Groceries,Supermarket,-35.83,GBP,-47252.24,POS,London,GB,9074,user_001,,
9b072890-4803-4da7-a527-b0291c7b128d,2026-01-02,2026-01-05,Shell,5541,Transport,Fuel,-81.98,GBP,-47334.22,POS,London,GB,1045,user_001,,
baa2ca2c-3668-4e28-ab35-f416252af921,2026-01-02,2026-01-02,Uber UK,4121,Transport,Ride Hailing,-14.9,GBP,-47349.12,E-Com,London,GB,2219,user_001,,
c53d1ad3-731e-4715-9a1f-adcc4e08a3f2,2026-01-02,2026-01-02,Tesco,5411,Groceries,Supermarket,-20.37,GBP,-47369.49,POS,London,GB,4488,user_001,,
4afa434a-5909-4fce-ad91-38281b67c820,2026-01-03,2026-01-05,Tesco,5411,Groceries,Supermarket,-36.48,GBP,-47405.97,POS,London,GB,2219,user_001,,
5fa3d428-10bb-4c3a-83c8-b5b9c6cbd6a0,2026-01-03,2026-01-05,Local Market,5499,Groceries,Specialty,-11.55,GBP,-47417.52,POS,London,GB,1045,user_001,,
e2a6557e-d45c-442a-be38-febab1a3f8cb,2026-01-03,2026-01-05,Sainsbury's,5411,Groceries,Supermarket,-64.91,GBP,-47482.43,POS,London,GB,1045,user_002,,
52c7b6e5-9a2c-48dd-bf50-041aa1d359b1,2026-01-04,2026-01-05,Deliveroo,5812,Food & Drink,Delivery,-20.35,GBP,-47502.78,E-Com,London,GB,9074,user_001,,
7ccecd89-cd81-47e9-b767-c029b749e516,2026-01-04,2026-01-06,Deliveroo,5812,Food & Drink,Delivery,-31.57,GBP,-47534.35,E-Com,London,GB,1045,user_001,,
840761d1-ce59-4ee8-9279-34e8648e3c85,2026-01-04,2026-01-06,Transport for London,4111,Transport,Transit,-9.23,GBP,-47543.58,POS,London,GB,1045,user_001,,
94d5d9b1-1803-4add-84c8-bb55554d41bb,2026-01-04,2026-01-05,Sainsbury's,5411,Groceries,Supermarket,-68.37,GBP,-47611.95,POS,London,GB,4488,user_002,,
c79ddcd9-01c1-4a15-9947-4d26387d3ccb,2026-01-04,2026-01-06,Tesco,5411,Groceries,Supermarket,-73.87,GBP,-47685.82,POS,London,GB,1045,user_001,,
fcc18cfe-dd0b-443a-9dba-45a9038bf320,2026-01-04,2026-01-05,Pret A Manger,5814,Food & Drink,Eating Out,-7.8,GBP,-47693.62,POS,London,GB,9074,user_002,,
424994ce-db04-4b72-adaa-07b911d22fc6,2026-01-05,2026-01-06,Waitrose,5411,Groceries,Supermarket,-47.39,GBP,-47741.01,POS,London,GB,4488,user_001,,
582e4bd5-1773-4bd5-9dc6-87d6d2026dc6,2026-01-05,2026-01-07,Sainsbury's,5411,Groceries,Supermarket,-31.54,GBP,-47772.55,POS,London,GB,2219,user_001,,
25b89d1d-4290-4561-80c7-8b56bdc0be79,2026-01-07,2026-01-08,Octopus Energy,4900,Utilities,Electricity,-122.41,GBP,-47894.96,Direct Debit,London,GB,1045,user_001,rec_141a4a0666,
3bbcceee-ee97-4dbf-841c-6bcb069419f3,2026-01-07,2026-01-07,Airline Refund,4511,Travel,Refund,3.15,GBP,-47891.81,Credit,London,GB,2219,user_001,,Refund for Transport for London
4193cf66-9cf8-4c62-bdc9-610c928353f7,2026-01-07,2026-01-09,Shell,5541,Transport,Fuel,-88.8,GBP,-47980.61,POS,London,GB,4488,user_002,,
a646e5a0-f4d8-4acc-b4c6-27c92a8a106a,2026-01-07,2026-01-09,ATM Withdrawal,6011,Cash,ATM,-105.66,GBP,-48086.27,ATM,London,GB,1045,user_001,,
109f6ea0-6c09-4d9b-a6fb-cdd99781d0b2,2026-01-08,2026-01-12,Uber UK,4121,Transport,Ride Hailing,-21.34,GBP,-48107.61,E-Com,London,GB,4488,user_001,,
24cf4bcb-015b-4790-ad38-dcdd927f3682,2026-01-08,2026-01-09,Amazon UK,5942,Shopping,Online Retail,-46.51,GBP,-48154.12,E-Com,London,GB,9074,user_001,,
cc31869a-1d1a-4d1b-bbc3-97e51bb1da6c,2026-01-08,2026-01-08,Airline Refund,4511,Travel,Refund,5.54,GBP,-48148.58,Credit,London,GB,2219,user_001,,Refund for Pret A Manger
49b90ff0-0998-4fe4-9f9c-49f70a0c6e4c,2026-01-09,2026-01-12,Local Market,5499,Groceries,Specialty,-20.98,GBP,-48169.56,POS,London,GB,2219,user_001,,
8a2bf4e0-1602-4644-b9fb-b694c0a021b0,2026-01-09,2026-01-09,Apple.com/bill,5734,Shopping,Electronics,-43.5,GBP,-48213.06,E-Com,Cupertino,US,9074,user_001,,
c3c7b79e-84a2-4226-9263-ee5a6a1e37d4,2026-01-09,2026-01-12,Shell,5541,Transport,Fuel,-49.51,GBP,-48262.57,POS,London,GB,1045,user_001,,
c7714cc0-8343-4e1b-a817-361f8890cd09,2026-01-10,2026-01-12,Sainsbury's,5411,Groceries,Supermarket,-44.87,GBP,-48307.44,POS,London,GB,9074,user_001,,
0b1d5a53-a318-4a2d-a2c2-b766c98ce189,2026-01-11,2026-01-13,Tesco,5411,Groceries,Supermarket,-21.28,GBP,-48328.72,POS,London,GB,1045,user_001,,
15d5c014-55e9-4935-8cb9-ccdae2cb2c66,2026-01-11,2026-01-12,Shell,5541,Transport,Fuel,-46.85,GBP,-48375.57,POS,London,GB,4488,user_002,,
3bfa5e57-0dfe-412d-b02c-8845eb9df474,2026-01-11,2026-01-12,Deliveroo,5812,Food & Drink,Delivery,-24.24,GBP,-48399.81,E-Com,London,GB,4488,user_001,,
471ca825-29f5-4bfa-befc-54d06e28eabe,2026-01-11,2026-01-12,Pret A Manger,5814,Food & Drink,Eating Out,-11.94,GBP,-48411.75,POS,London,GB,1045,user_001,,
49b85e8f-5b76-4e75-90fd-ad8b32308d6f,2026-01-11,2026-01-12,Waitrose,5411,Groceries,Supermarket,-46.01,GBP,-48457.76,POS,London,GB,9074,user_001,,
7f8813da-9ed4-4322-9fe5-cb3f45b49545,2026-01-11,2026-01-13,Transport for London,4111,Transport,Transit,-11.01,GBP,-48468.77,POS,London,GB,4488,user_001,,
23786fae-6412-4bda-8a6f-4ad5fc67fc95,2026-01-12,2026-01-14,Sainsbury's,5411,Groceries,Supermarket,-61.84,GBP,-48530.61,POS,London,GB,4488,user_001,,
8ed80430-ac39-4aa5-840a-b53fa4667b22,2026-01-12,2026-01-13,Apple.com/bill,5734,Shopping,Electronics,-34.75,GBP,-48565.36,E-Com,Cupertino,US,9074,user_001,,
b1a52cc9-5f5e-4337-87a1-8fe9e14b0dba,2026-01-12,2026-01-14,Thames Water,4900,Utilities,Water,-40.79,GBP,-48606.15,Direct Debit,Reading,GB,2219,user_001,rec_3a34d62842,
ccf2d11c-7ea6-4138-a8d0-24402f52f3ee,2026-01-12,2026-01-13,Deliveroo,5812,Food & Drink,Delivery,-30.15,GBP,-48636.3,E-Com,London,GB,9074,user_001,,
0303f577-0d1e-4553-8f45-be21d56f2d18,2026-01-13,2026-01-14,Transport for London,4111,Transport,Transit,-8.67,GBP,-48644.97,POS,London,GB,4488,user_001,,
66e337b5-a1ff-49f5-8095-aa438ce6ba2e,2026-01-13,2026-01-13,Uber UK,4121,Transport,Ride Hailing,-22.02,GBP,-48666.99,E-Com,London,GB,1045,user_001,,
aaa3aead-dcfb-4901-843e-7c20b728f3a9,2026-01-13,2026-01-15,Uber UK,4121,Transport,Ride Hailing,-27.55,GBP,-48694.54,E-Com,London,GB,2219,user_001,,
cf5527dc-2b07-4e41-b58c-127fe1551493,2026-01-13,2026-01-15,ATM Withdrawal,6011,Cash,ATM,-104.61,GBP,-48799.15,ATM,London,GB,2219,user_001,,
e997e47f-5dbf-42e1-b9ab-1e85ac3dab51,2026-01-13,2026-01-15,City Council Tax,9399,Utilities,Council Tax,-175.59,GBP,-48974.74,Direct Debit,London,GB,4488,user_002,rec_6feaa5d43f,
30d9fc5f-47d3-423e-9ab2-02bd48247ed6,2026-01-14,2026-01-15,Sainsbury's,5411,Groceries,Supermarket,-51.35,GBP,-49026.09,POS,London,GB,4488,user_002,,
6723d3fa-70f5-4eee-8bdd-42bb939b36ed,2026-01-14,2026-01-14,Amazon UK,5942,Shopping,Online Retail,-10.48,GBP,-49036.57,E-Com,London,GB,4488,user_001,,
a202f211-4891-4aa8-a845-792db0aa22c4,2026-01-14,2026-01-14,Shell,5541,Transport,Fuel,-30.84,GBP,-49067.41,POS,London,GB,1045,user_001,,
1cd5598b-155c-44ef-b756-f29c0ec2fbf9,2026-01-15,2026-01-15,Transport for London,4111,Transport,Transit,-8.33,GBP,-49075.74,POS,London,GB,2219,user_001,,
5625ceec-4695-48f9-83bd-dd1f2e7f49af,2026-01-15,2026-01-16,Transport for London,4111,Transport,Transit,-10.32,GBP,-49086.06,POS,London,GB,1045,user_001,,
5bc3accf-50ff-4eb6-855b-f86cc3f7312b,2026-01-15,2026-01-19,Amazon UK,5942,Shopping,Online Retail,-76.82,GBP,-49162.88,E-Com,London,GB,9074,user_001,,
6645866a-d6ea-424b-b016-4fc1005db2a0,2026-01-15,2026-01-19,O2 UK,4814,Bills,Mobile,-35.61,GBP,-49198.49,Direct Debit,Slough,GB,1045,user_002,rec_d2dce4c42f,
2faf02df-2c26-4f0f-9e67-f3bbc6708567,2026-01-16,2026-01-16,Airline Refund,4511,Travel,Refund,12.81,GBP,-49185.68,Credit,London,GB,2219,user_001,,Refund for Amazon UK
7cf1107a-2e31-42ca-991c-10556b89f538,2026-01-16,2026-01-19,Deliveroo,5812,Food & Drink,Delivery,-23.21,GBP,-49208.89,E-Com,London,GB,2219,user_002,,
571f672c-9dba-4a5a-9c7f-a25fb893aa70,2026-01-17,2026-01-19,Amazon UK,5942,Shopping,Online Retail,-12.12,GBP,-49221.01,E-Com,London,GB,9074,user_002,,
706c6eec-6ec6-4773-bb97-3198261f16ed,2026-01-17,2026-01-19,Shell,5541,Transport,Fuel,-64.84,GBP,-49285.85,POS,London,GB,1045,user_001,,
8e8d1607-05a6-4aa4-82c9-c2e6179f8079,2026-01-17,2026-01-19,Amazon UK,5942,Shopping,Online Retail,-59.87,GBP,-49345.72,E-Com,London,GB,2219,user_002,,
d9c7fbd7-6837-48a5-8a26-77ad39581888,2026-01-17,2026-01-19,Transport for London,4111,Transport,Transit,-11.21,GBP,-49356.93,POS,London,GB,4488,user_001,,
7d7dfe2c-fe59-4a2b-b161-3d1e5ed869d5,2026-01-18,2026-01-20,Apple.com/bill,5734,Shopping,Electronics,-137.88,GBP,-49494.81,E-Com,Cupertino,US,2219,user_001,,
acb64b5c-0b0d-40ae-9ab8-85c0ffb7fc73,2026-01-18,2026-01-19,Transport for London,4111,Transport,Transit,-8.07,GBP,-49502.88,POS,London,GB,2219,user_002,,
b1b85681-13a2-408a-bd88-39da1e44396d,2026-01-18,2026-01-19,Sainsbury's,5411,Groceries,Supermarket,-24.44,GBP,-49527.32,POS,London,GB,2219,user_001,,
0dc27ee1-28ed-4e59-b099-d7740b2bf5f7,2026-01-19,2026-01-19,Spotify,5735,Entertainment,Subscriptions,-9.84,GBP,-49537.16,E-Com,Stockholm,SE,4488,user_001,rec_4c746d2c3b,
0df237c2-0076-4a58-9867-e3cd3dbe2a91,2026-01-19,2026-01-20,Amazon UK,5942,Shopping,Online Retail,-76.12,GBP,-49613.28,E-Com,London,GB,1045,user_001,,
10dada57-ff47-49f0-b5c2-0e58b6c5407b,2026-01-19,2026-01-20,Deliveroo,5812,Food & Drink,Delivery,-31.3,GBP,-49644.58,E-Com,London,GB,1045,user_002,,
4df4dcc5-0717-4c3a-bb21-cb9850525c68,2026-01-19,2026-01-21,GymBox,7997,Wellness,Gym,-54.85,GBP,-49699.43,Direct Debit,London,GB,4488,user_001,rec_3906953fd2,
5cd11149-3218-4d5c-8026-e4a211ac4ae1,2026-01-19,2026-01-20,Sainsbury's,5411,Groceries,Supermarket,-49.59,GBP,-49749.02,POS,London,GB,1045,user_002,,
704af733-f397-40d3-80f5-004bc9c963a6,2026-01-19,2026-01-19,Sainsbury's,5411,Groceries,Supermarket,-54.86,GBP,-49803.88,POS,London,GB,9074,user_001,,
b91217dd-65d1-4f41-8de4-4b30528c3944,2026-01-19,2026-01-20,Tesco,5411,Groceries,Supermarket,-54.85,GBP,-49858.73,POS,London,GB,1045,user_001,,
56018815-8409-4fe0-8b80-9dfbbbf80b2a,2026-01-20,2026-01-22,Shell,5541,Transport,Fuel,-39.76,GBP,-49898.49,POS,London,GB,9074,user_001,,
ef27cb38-805b-4f11-a81f-37f67815f09e,2026-01-20,2026-01-20,Amazon UK,5942,Shopping,Online Retail,-99.47,GBP,-49997.96,E-Com,London,GB,9074,user_001,,
fc5e4988-df0c-42ce-9028-e66bae089e8a,2026-01-20,2026-01-20,Pret A Manger,5814,Food & Drink,Eating Out,-7.85,GBP,-50005.81,POS,London,GB,4488,user_001,,
90cd3008-888c-4c6a-998a-1065d6c846bd,2026-01-21,2026-01-22,Netflix,7841,Entertainment,Subscriptions,-13.02,USD,-50018.83,E-Com,Los Gatos,US,4488,user_001,rec_1bfe33738d,FX purchase 15.99 USD @ rate 1.23
d270153f-dbd6-469b-931e-5f9bf1447f44,2026-01-21,2026-01-23,Sainsbury's,5411,Groceries,Supermarket,-18.07,GBP,-50036.9,POS,London,GB,1045,user_002,,
63064d52-43cb-4925-8829-033f215add45,2026-01-22,2026-01-23,Apple.com/bill,5734,Shopping,Electronics,-59.27,GBP,-50096.17,E-Com,Cupertino,US,1045,user_002,,
803c1e80-2ec2-40fb-ac5b-8a22c8ad2d4b,2026-01-22,2026-01-23,Transport for London,4111,Transport,Transit,-3.83,GBP,-50100.0,POS,London,GB,4488,user_001,,
870c8419-bb39-41a0-a8df-74a5a252a01f,2026-01-22,2026-01-23,Shell,5541,Transport,Fuel,-85.96,GBP,-50185.96,POS,London,GB,9074,user_001,,
dbcb8760-8014-4d83-a82a-5dc3350868da,2026-01-22,2026-01-26,Sainsbury's,5411,Groceries,Supermarket,-21.29,GBP,-50207.25,POS,London,GB,9074,user_001,,
0dc663d2-d5e4-4ab8-8258-9b937a42e96d,2026-01-23,2026-01-23,Local Market,5499,Groceries,Specialty,-6.51,GBP,-50213.76,POS,London,GB,4488,user_002,,
2d98752d-5cb1-4026-85a5-8ee64fa95167,2026-01-23,2026-01-26,Sainsbury's,5411,Groceries,Supermarket,-16.07,GBP,-50229.83,POS,London,GB,2219,user_001,,
32949db1-6623-499a-9936-bf88c52be282,2026-01-23,2026-01-26,Local Market,5499,Groceries,Specialty,-19.45,GBP,-50249.28,POS,London,GB,9074,user_002,,
ba899e3b-ab69-4f0c-8c89-88a205a22d25,2026-01-23,2026-01-23,T212 Capital,6011,Income,Salary,3043.85,GBP,-47205.43,Credit,London,GB,2219,user_001,rec_2ff8f778d0,
78d5cb56-9a58-4bf1-b869-6e30c06b5346,2026-01-24,2026-01-26,Amazon UK,5942,Shopping,Online Retail,-108.25,GBP,-47313.68,E-Com,London,GB,9074,user_001,,
863943ea-5971-4d61-9d66-0c9248542756,2026-01-24,2026-01-26,Waitrose,5411,Groceries,Supermarket,-37.25,GBP,-47350.93,POS,London,GB,4488,user_001,,
c45aadd9-eea9-4975-97b1-51f0b2705db3,2026-01-24,2026-01-26,Pret A Manger,5814,Food & Drink,Eating Out,-11.63,GBP,-47362.56,POS,London,GB,9074,user_001,,
48092d70-c120-4608-94cd-818be44f1f7e,2026-01-25,2026-01-26,Waitrose,5411,Groceries,Supermarket,-89.06,GBP,-47451.62,POS,London,GB,1045,user_002,,
75b5060a-47a0-4e52-baa5-e4e2fdc9ca48,2026-01-25,2026-01-26,HM Revenue & Customs,9311,Income,Tax Refund,11.59,GBP,-47440.03,Credit,London,GB,9074,user_001,,Refund for Pret A Manger
856cbda3-faa6-44e5-a573-b393f5335d5e,2026-01-25,2026-01-26,Shell,5541,Transport,Fuel,-61.31,GBP,-47501.34,POS,London,GB,4488,user_001,,
c33c0cd4-8582-4785-9cb8-a38a96a77901,2026-01-25,2026-01-26,Local Market,5499,Groceries,Specialty,-13.01,GBP,-47514.35,POS,London,GB,9074,user_001,,
c42dd9a1-c95f-4486-9bed-9ca1adc40eb1,2026-01-25,2026-01-26,Amazon UK,5942,Shopping,Online Retail,-41.5,GBP,-47555.85,E-Com,London,GB,4488,user_001,,
2c2c01a3-9d06-457c-aeb8-bf8168ddbca1,2026-01-26,2026-01-26,Uber UK,4121,Transport,Ride Hailing,-19.42,GBP,-47575.27,E-Com,London,GB,4488,user_001,,
a5d12107-e56e-4fb1-8098-51af058d7ee0,2026-01-26,2026-01-26,Transport for London,4111,Transport,Transit,-3.95,GBP,-47579.22,POS,London,GB,2219,user_001,,
25823c5d-4d4b-49b9-a24c-674edffcb936,2026-01-27,2026-01-29,Amazon UK,5942,Shopping,Online Retail,-77.06,GBP,-47656.28,E-Com,London,GB,9074,user_001,,
a4cd123a-9740-40db-9b20-ac60ca60ab5f,2026-01-27,2026-01-28,Apple.com/bill,5734,Shopping,Electronics,-120.97,GBP,-47777.25,E-Com,Cupertino,US,9074,user_001,,
af38a661-b8ee-4e09-8fe5-765dd87eded0,2026-01-28,2026-01-30,Shell,5541,Transport,Fuel,-44.43,GBP,-47821.68,POS,London,GB,2219,user_001,,
cb670fbb-ce5f-4a60-8b0a-a93b53c22c46,2026-01-28,2026-01-28,Tesco,5411,Groceries,Supermarket,-32.59,GBP,-47854.27,POS,London,GB,4488,user_002,,
234693dd-15b0-4904-b1d1-ae61b4faec64,2026-01-29,2026-01-29,Amazon UK,5942,Shopping,Online Retail,-60.6,GBP,-47914.87,E-Com,London,GB,4488,user_001,,
7239f0a0-3de7-431e-89e6-d90c55051a72,2026-01-30,2026-02-02,Waitrose,5411,Groceries,Supermarket,-34.51,GBP,-47949.38,POS,London,GB,2219,user_001,,
3ab9e69d-88d6-4612-bacb-1fbdd3d901f7,2026-01-31,2026-02-02,Sainsbury's,5411,Groceries,Supermarket,-44.1,GBP,-47993.48,POS,London,GB,4488,user_001,,
75cb18e3-fb66-4480-92a5-0678157dfe24,2026-01-31,2026-02-02,Deliveroo,5812,Food & Drink,Delivery,-25.08,GBP,-48018.56,E-Com,London,GB,1045,user_001,,
99b60076-206d-4cd7-86bb-a8c7b3ee426d,2026-01-31,2026-02-02,Uber UK,4121,Transport,Ride Hailing,-12.02,GBP,-48030.58,E-Com,London,GB,4488,user_001,,
b977a126-28a0-42c7-9da1-bcb1d6a020e8,2026-01-31,2026-02-02,Sainsbury's,5411,Groceries,Supermarket,-25.83,GBP,-48056.41,POS,London,GB,4488,user_001,,
cf4f7001-0cb3-489d-ab8a-893b9a7cf75e,2026-01-31,2026-02-02,Transport for London,4111,Transport,Transit,-10.86,GBP,-48067.27,POS,London,GB,2219,user_001,,
d113b23d-8733-4319-9165-497b6a70512d,2026-01-31,2026-02-02,Uber UK,4121,Transport,Ride Hailing,-16.51,GBP,-48083.78,E-Com,London,GB,2219,user_001,,
ef344aea-c368-47f7-94ae-ba763dc60af3,2026-01-31,2026-02-02,Sainsbury's,5411,Groceries,Supermarket,-56.14,GBP,-48139.92,POS,London,GB,2219,user_001,,
0c1c019e-331c-410f-baf7-97ea53817fa0,2026-02-01,2026-02-02,Deliveroo,5812,Food & Drink,Delivery,-28.11,GBP,-48168.03,E-Com,London,GB,9074,user_002,,
56522d11-92e1-4809-b091-853421fc19ba,2026-02-01,2026-02-03,Deliveroo,5812,Food & Drink,Delivery,-20.59,GBP,-48188.62,E-Com,London,GB,4488,user_002,,
62b2a324-7c39-40ed-a058-b19ca0f11bc7,2026-02-01,2026-02-03,Transport for London,4111,Transport,Transit,-11.59,GBP,-48200.21,POS,London,GB,2219,user_002,,
64910b42-ebea-4b9b-bf39-ff9d7cd41157,2026-02-01,2026-02-02,Local Market,5499,Groceries,Specialty,-14.44,GBP,-48214.65,POS,London,GB,1045,user_001,,
8227ba1e-8d1d-417e-be4c-cc7e16e91faa,2026-02-01,2026-02-03,Apple.com/bill,5734,Shopping,Electronics,-127.2,USD,-48341.85,E-Com,Cupertino,US,4488,user_001,,FX purchase 151.94 USD @ rate 1.19
d13b6dbf-8e9e-4a9c-b2ea-d5b592ff8be5,2026-02-01,2026-02-02,Uber UK,4121,Transport,Ride Hailing,-15.97,GBP,-48357.82,E-Com,London,GB,9074,user_002,,
3960febd-a2a4-495e-a546-d4a419145a32,2026-02-02,2026-02-02,Uber UK,4121,Transport,Ride Hailing,-14.72,GBP,-48372.54,E-Com,London,GB,4488,user_001,,
4065a6e7-7fa3-46d3-b972-c4e1a751125c,2026-02-02,2026-02-04,Crown Estates Lettings,6513,Housing,Rent,-1644.73,GBP,-50017.27,POS,London,GB,9074,user_001,rec_19f70fbcce,
f4be5da8-a49f-4793-bbc3-42f40631371a,2026-02-02,2026-02-02,Sainsbury's,5411,Groceries,Supermarket,-15.94,GBP,-50033.21,POS,London,GB,9074,user_001,,
22fe062c-5f3f-4c0a-9179-20991a71df78,2026-02-04,2026-02-05,Transport for London,4111,Transport,Transit,-10.33,GBP,-50043.54,POS,London,GB,9074,user_001,,
a758a9f6-63c3-4a81-9dde-018009090504,2026-02-04,2026-02-06,Transport for London,4111,Transport,Transit,-8.07,GBP,-50051.61,POS,London,GB,4488,user_001,,
044c52d3-4792-414e-aa25-dc175e25c3d8,2026-02-05,2026-02-05,Waitrose,5411,Groceries,Supermarket,-25.33,GBP,-50076.94,POS,London,GB,9074,user_001,,
9f282012-3c01-47e0-982b-9c83db6b2034,2026-02-05,2026-02-06,Waitrose,5411,Groceries,Supermarket,-83.71,GBP,-50160.65,POS,London,GB,4488,user_002,,
3933b586-8c67-4b4f-9a94-d82e145cb6fd,2026-02-06,2026-02-06,Local Market,5499,Groceries,Specialty,-7.28,GBP,-50167.93,POS,London,GB,2219,user_001,,
c62220cd-4415-40a0-87a8-55643486569d,2026-02-06,2026-02-09,Waitrose,5411,Groceries,Supermarket,-26.55,GBP,-50194.48,POS,London,GB,4488,user_001,,
ebd4dc0b-21b9-46d2-8df9-e56ae2f41a73,2026-02-06,2026-02-09,Tesco,5411,Groceries,Supermarket,-79.41,GBP,-50273.89,POS,London,GB,9074,user_001,,
fc8f102f-5ac1-4b2a-aa20-4b2a557825bc,2026-02-06,2026-02-09,Tesco,5411,Groceries,Supermarket,-38.31,GBP,-50312.2,POS,London,GB,9074,user_002,,
30ddb5a7-392e-450b-a67a-85f819f583b8,2026-02-07,2026-02-09,Deliveroo,5812,Food & Drink,Delivery,-15.32,GBP,-50327.52,E-Com,London,GB,4488,user_001,,
4f38d9ad-d554-44a7-8ead-97ec78a8188b,2026-02-07,2026-02-09,Deliveroo,5812,Food & Drink,Delivery,-27.68,GBP,-50355.2,E-Com,London,GB,9074,user_001,,
a92eafc9-9641-4d2c-aadb-d800c9cead7a,2026-02-07,2026-02-09,Airline Refund,4511,Travel,Refund,6.84,GBP,-50348.36,Credit,London,GB,1045,user_001,,Refund for Sainsbury's
e0109535-846a-4fac-8a7d-619a4341bcd5,2026-02-07,2026-02-09,Pret A Manger,5814,Food & Drink,Eating Out,-7.58,GBP,-50355.94,POS,London,GB,4488,user_002,,
feb5fcde-dca3-45e9-b176-115417599824,2026-02-07,2026-02-09,Waitrose,5411,Groceries,Supermarket,-85.98,GBP,-50441.92,POS,London,GB,4488,user_001,,
02a8ea1d-d335-40ec-9ea2-46b48ceea27a,2026-02-08,2026-02-10,Shell,5541,Transport,Fuel,-86.97,GBP,-50528.89,POS,London,GB,2219,user_002,,
228000f8-2a40-459d-9040-48e155de8b36,2026-02-08,2026-02-09,Transport for London,4111,Transport,Transit,-7.85,GBP,-50536.74,POS,London,GB,9074,user_002,,
a7a61e45-08e9-407b-af1b-1b54c8f6823a,2026-02-08,2026-02-09,Amazon UK,5942,Shopping,Online Retail,-10.29,GBP,-50547.03,E-Com,London,GB,2219,user_001,,
dd68387d-05a0-46f7-b155-686fc0bebcda,2026-02-08,2026-02-10,Amazon UK,5942,Shopping,Online Retail,-50.59,GBP,-50597.62,E-Com,London,GB,2219,user_001,,
ed68fd4e-b30c-4289-a16f-eda894f0c5d2,2026-02-08,2026-02-10,Apple.com/bill,5734,Shopping,Electronics,-197.72,USD,-50795.34,E-Com,Cupertino,US,2219,user_001,,FX purchase 251.66 USD @ rate 1.27
0b3e33fb-d391-45f9-b5d3-5b22d72800d4,2026-02-09,2026-02-11,Octopus Energy,4900,Utilities,Electricity,-137.72,GBP,-50933.06,Direct Debit,London,GB,1045,user_002,rec_09c3f12b18,
1aad1820-9588-441f-a686-722fc45189c5,2026-02-09,2026-02-11,Transport for London,4111,Transport,Transit,-7.91,GBP,-50940.97,POS,London,GB,2219,user_001,,
3f912d49-d57b-48f8-b00d-de6a92d4e079,2026-02-09,2026-02-11,Apple.com/bill,5734,Shopping,Electronics,-86.37,GBP,-51027.34,E-Com,Cupertino,US,2219,user_001,,
821aa37c-40a4-4f8e-990f-4e704e52318c,2026-02-09,2026-02-11,Shell,5541,Transport,Fuel,-44.63,GBP,-51071.97,POS,London,GB,4488,user_001,,
0a156b2b-afaf-4d72-817c-f82ba83d226f,2026-02-10,2026-02-11,Transport for London,4111,Transport,Transit,-3.9,GBP,-51075.87,POS,London,GB,9074,user_001,,
29133b15-0559-4e58-b35a-a3af38ca8092,2026-02-10,2026-02-11,Waitrose,5411,Groceries,Supermarket,-30.88,GBP,-51106.75,POS,London,GB,2219,user_001,,
94e22088-9275-4d45-ad05-cb810a9ccab5,2026-02-11,2026-02-11,Thames Water,4900,Utilities,Water,-39.3,GBP,-51146.05,Direct Debit,Reading,GB,9074,user_002,rec_954d02400c,
e50ec5b1-9d02-4825-bb5d-fd1ec8c1f0a8,2026-02-11,2026-02-13,Uber UK,4121,Transport,Ride Hailing,-35.49,GBP,-51181.54,E-Com,London,GB,9074,user_002,,
1288fe74-5573-4352-900d-382a88b836f3,2026-02-12,2026-02-13,Uber UK,4121,Transport,Ride Hailing,-11.51,GBP,-51193.05,E-Com,London,GB,2219,user_002,,
7e364fa9-30a6-4ad6-9b67-881aa08de8e0,2026-02-13,2026-02-16,Local Market,5499,Groceries,Specialty,-16.01,GBP,-51209.06,POS,London,GB,4488,user_001,,
8b3c8c9a-8d7d-4091-90b9-8384ee5b180a,2026-02-13,2026-02-13,City Council Tax,9399,Utilities,Council Tax,-173.39,GBP,-51382.45,Direct Debit,London,GB,2219,user_002,rec_6feaa5d43f,
559307f8-16bc-404b-a77b-9ef58db630b0,2026-02-14,2026-02-16,Uber UK,4121,Transport,Ride Hailing,-28.92,GBP,-51411.37,E-Com,London,GB,4488,user_001,,
6a9a4e0f-ce92-4ca0-918b-9668e2345203,2026-02-14,2026-02-16,Transport for London,4111,Transport,Transit,-9.16,GBP,-51420.53,POS,London,GB,4488,user_001,,
8daef86e-2493-47d1-8d53-1b9a079acb93,2026-02-14,2026-02-16,Transport for London,4111,Transport,Transit,-7.04,GBP,-51427.57,POS,London,GB,9074,user_001,,
ae2b0014-3e56-48ed-a43c-8cc61ecef016,2026-02-14,2026-02-16,Shell,5541,Transport,Fuel,-43.53,GBP,-51471.1,POS,London,GB,1045,user_001,,
fbc6e018-8ba3-4fd0-8ae7-85644c3362ba,2026-02-14,2026-02-16,Shell,5541,Transport,Fuel,-61.27,GBP,-51532.37,POS,London,GB,9074,user_001,,
71e06ce8-3f98-4cb8-85da-57c5a5886cd8,2026-02-15,2026-02-16,Sainsbury's,5411,Groceries,Supermarket,-52.46,GBP,-51584.83,POS,London,GB,9074,user_001,,
9067f169-826a-4bd7-b451-c496568a18c1,2026-02-15,2026-02-17,ATM Withdrawal,6011,Cash,ATM,-96.96,GBP,-51681.79,ATM,London,GB,9074,user_001,,
9245c456-047a-45f1-96b7-e818517a14c5,2026-02-16,2026-02-18,O2 UK,4814,Bills,Mobile,-50.89,GBP,-51732.68,Direct Debit,Slough,GB,4488,user_001,rec_95042d8101,
b6661e98-41d6-4579-87c1-b39e6a9a6c5d,2026-02-16,2026-02-17,Waitrose,5411,Groceries,Supermarket,-63.44,GBP,-51796.12,POS,London,GB,2219,user_001,,
2bae5057-47b3-4abb-bc25-ebea36d68cc7,2026-02-17,2026-02-18,GymBox,7997,Wellness,Gym,-53.1,GBP,-51849.22,Direct Debit,London,GB,2219,user_002,rec_19771e79cd,
87277a5b-6f35-4e09-b429-ef43e9095cb8,2026-02-17,2026-02-17,Shell,5541,Transport,Fuel,-90.59,GBP,-51939.81,POS,London,GB,1045,user_002,,
150e3c10-4229-4199-add2-b63decb743de,2026-02-19,2026-02-19,Amazon UK,5942,Shopping,Online Retail,-31.37,GBP,-51971.18,E-Com,London,GB,2219,user_001,,
1d91c46e-3454-4255-819f-360b862bba4c,2026-02-19,2026-02-19,Apple.com/bill,5734,Shopping,Electronics,-72.42,GBP,-52043.6,E-Com,Cupertino,US,1045,user_001,,
b8560a13-e3ec-4671-b603-009f2b19b620,2026-02-19,2026-02-19,Spotify,5735,Entertainment,Subscriptions,-9.88,EUR,-52053.48,E-Com,Stockholm,SE,4488,user_001,rec_4c746d2c3b,FX purchase 11.34 EUR @ rate 1.15
94536216-b7b9-487c-8d08-dacf829f8941,2026-02-20,2026-02-20,Uber UK,4121,Transport,Ride Hailing,-10.77,GBP,-52064.25,E-Com,London,GB,2219,user_001,,
ab540add-5a32-4810-9628-195ff803102c,2026-02-20,2026-02-23,Waitrose,5411,Groceries,Supermarket,-45.74,GBP,-52109.99,POS,London,GB,4488,user_001,,
0fb0cdbc-103e-4e32-9734-c9626400c74b,2026-02-21,2026-02-23,Deliveroo,5812,Food & Drink,Delivery,-19.53,GBP,-52129.52,E-Com,London,GB,9074,user_002,,
27523d84-e250-4e31-8d7e-3d177a36b160,2026-02-21,2026-02-23,Deliveroo,5812,Food & Drink,Delivery,-15.18,GBP,-52144.7,E-Com,London,GB,2219,user_002,,
2e25a499-cf9b-4d6d-adec-de46e5988a95,2026-02-21,2026-02-23,Tesco,5411,Groceries,Supermarket,-67.8,GBP,-52212.5,POS,London,GB,4488,user_001,,
38c55e2a-490f-4be2-a75d-1f6a45e7055d,2026-02-21,2026-02-23,Local Market,5499,Groceries,Specialty,-16.15,GBP,-52228.65,POS,London,GB,2219,user_001,,
6029a496-d36e-4ac7-ba93-b69d78a239ca,2026-02-21,2026-02-23,Sainsbury's,5411,Groceries,Supermarket,-65.07,GBP,-52293.72,POS,London,GB,9074,user_001,,
8802fbca-42f6-4b75-a3a1-88559821d4ea,2026-02-21,2026-02-23,Amazon UK,5942,Shopping,Online Retail,-66.4,GBP,-52360.12,E-Com,London,GB,4488,user_001,,
aaf4192c-8ad0-4f08-8c41-931fb7e5797b,2026-02-21,2026-02-23,Amazon UK,5942,Shopping,Online Retail,-118.67,GBP,-52478.79,E-Com,London,GB,9074,user_001,,
f7731f29-042d-4470-97b7-00d58900ba74,2026-02-21,2026-02-23,Transport for London,4111,Transport,Transit,-4.91,GBP,-52483.7,POS,London,GB,1045,user_001,,
05afd765-ecc8-4d9e-b77f-fb1e9a4050bb,2026-02-22,2026-02-24,Pret A Manger,5814,Food & Drink,Eating Out,-10.83,GBP,-52494.53,POS,London,GB,9074,user_002,,
2995b291-dc41-4bf6-b7ed-d1b7f4568ea6,2026-02-22,2026-02-24,Amazon UK,5942,Shopping,Online Retail,-83.65,GBP,-52578.18,E-Com,London,GB,9074,user_001,,
c0154c82-0f60-4d32-894b-ff81809b9fd5,2026-02-22,2026-02-23,Local Market,5499,Groceries,Specialty,-14.22,GBP,-52592.4,POS,London,GB,2219,user_001,,
d6ff2858-2112-4606-8cc8-56b99555bc5b,2026-02-22,2026-02-23,Deliveroo,5812,Food & Drink,Delivery,-31.85,GBP,-52624.25,E-Com,London,GB,2219,user_001,,
e13317c6-b00e-485a-b03d-0d39cdc148fb,2026-02-22,2026-02-23,Amazon UK,5942,Shopping,Online Retail,-117.02,GBP,-52741.27,E-Com,London,GB,1045,user_001,,
f1902e73-9a93-46e6-b744-640d9e4cac47,2026-02-22,2026-02-23,Shell,5541,Transport,Fuel,-53.97,GBP,-52795.24,POS,London,GB,2219,user_001,,
f3dd8330-4ee5-4ca8-95a6-c608b5d50568,2026-02-22,2026-02-24,Shell,5541,Transport,Fuel,-31.23,GBP,-52826.47,POS,London,GB,9074,user_002,,
a539e5c9-97c8-4969-957b-27334c2a5d5b,2026-02-23,2026-02-23,Netflix,7841,Entertainment,Subscriptions,-12.75,GBP,-52839.22,E-Com,Los Gatos,US,9074,user_001,rec_1bfe33738d,
d08319be-6d71-4668-a492-1268387bc5a3,2026-02-23,2026-02-24,Deliveroo,5812,Food & Drink,Delivery,-24.3,GBP,-52863.52,E-Com,London,GB,4488,user_001,,
9b5d6632-4cd7-4cba-82c8-933a99b394aa,2026-02-24,2026-02-26,Transport for London,4111,Transport,Transit,-8.88,GBP,-52872.4,POS,London,GB,1045,user_001,,
c9df1bd9-e10a-47d7-9380-c1e54f1a2954,2026-02-24,2026-02-24,Local Market,5499,Groceries,Specialty,-16.79,GBP,-52889.19,POS,London,GB,2219,user_001,,
2a863f96-4725-46cb-9b09-ddca19f85a94,2026-02-25,2026-02-25,T212 Capital,6011,Income,Salary,3165.48,GBP,-49723.71,Credit,London,GB,9074,user_001,rec_2ff8f778d0,
505be5a3-5f55-4bc5-9a2d-41bda701cdba,2026-02-25,2026-02-27,Transport for London,4111,Transport,Transit,-6.13,GBP,-49729.84,POS,London,GB,9074,user_001,,
6539cd13-f29c-4f89-93a5-d7e4890c3daa,2026-02-25,2026-02-26,Tesco,5411,Groceries,Supermarket,-60.8,GBP,-49790.64,POS,London,GB,2219,user_002,,
6def3931-f30a-4ba9-8b9b-ac91edfc689b,2026-02-25,2026-02-27,Deliveroo,5812,Food & Drink,Delivery,-14.78,GBP,-49805.42,E-Com,London,GB,9074,user_002,,
97838faa-d3b1-4d20-85e0-6248b787633e,2026-02-25,2026-02-25,Shell,5541,Transport,Fuel,-39.69,GBP,-49845.11,POS,London,GB,9074,user_001,,
c0a95d25-0fa3-4029-afaf-3180ea2a7d9c,2026-02-25,2026-02-27,Sainsbury's,5411,Groceries,Supermarket,-61.57,GBP,-49906.68,POS,London,GB,9074,user_001,,
db0b5325-3c6f-4cc8-8248-550e3b11a281,2026-02-25,2026-02-25,Amazon UK,5942,Shopping,Online Retail,-102.19,GBP,-50008.87,E-Com,London,GB,9074,user_001,,
e7615b8c-b1c7-461d-ad1f-3958b75e5da0,2026-02-25,2026-02-25,Airline Refund,4511,Travel,Refund,162.98,GBP,-49845.89,Credit,London,GB,9074,user_002,,Refund for City Council Tax
d8f632b8-af72-4070-ad98-f4ae4da6c415,2026-02-26,2026-02-26,Local Market,5499,Groceries,Specialty,-16.84,GBP,-49862.73,POS,London,GB,4488,user_001,,
f3ecf087-c646-4a85-ab77-86552371cd2a,2026-02-26,2026-03-02,Shell,5541,Transport,Fuel,-40.25,GBP,-49902.98,POS,London,GB,9074,user_001,,
098d402a-6feb-43ac-a962-aac613e1909c,2026-02-27,2026-03-02,Uber UK,4121,Transport,Ride Hailing,-14.21,GBP,-49917.19,E-Com,London,GB,2219,user_001,,
3135f077-6985-441f-9407-b964348d49da,2026-02-27,2026-03-02,Apple.com/bill,5734,Shopping,Electronics,-54.75,USD,-49971.94,E-Com,Cupertino,US,4488,user_001,,FX purchase 64.71 USD @ rate 1.18
551bbb83-95b3-4a83-aac2-7f1fb7c0e376,2026-02-27,2026-03-02,Shell,5541,Transport,Fuel,-52.55,GBP,-50024.49,POS,London,GB,1045,user_002,,
d2f0919d-7875-4243-aa6a-c60c793b6da1,2026-02-27,2026-02-27,Transport for London,4111,Transport,Transit,-5.58,GBP,-50030.07,POS,London,GB,1045,user_001,,
09056972-3cbc-43b0-a723-dd20abeab080,2026-02-28,2026-03-02,Shell,5541,Transport,Fuel,-81.37,GBP,-50111.44,POS,London,GB,2219,user_001,,
5b0c2118-e346-45b8-9730-ea04ffab0475,2026-02-28,2026-03-02,Tesco,5411,Groceries,Supermarket,-68.82,GBP,-50180.26,POS,London,GB,4488,user_001,,
800bf797-5982-4f94-8c66-bfa37901d252,2026-02-28,2026-03-02,Transport for London,4111,Transport,Transit,-10.49,GBP,-50190.75,POS,London,GB,9074,user_002,,
9d5706fa-7dca-44a8-bf75-278b82c39532,2026-02-28,2026-03-02,Apple.com/bill,5734,Shopping,Electronics,-153.57,GBP,-50344.32,E-Com,Cupertino,US,2219,user_001,,
e6ad6db6-20d3-4c25-87c8-4797cd4aae7e,2026-02-28,2026-03-02,Waitrose,5411,Groceries,Supermarket,-32.26,GBP,-50376.58,POS,London,GB,1045,user_001,,
b41407a5-f045-4fc0-956a-bf5775fd454e,2026-03-01,2026-03-03,Waitrose,5411,Groceries,Supermarket,-55.48,GBP,-50432.06,POS,London,GB,2219,user_001,,
d383cf61-213f-49c1-bbae-46d9d8fdc44b,2026-03-01,2026-03-03,Uber UK,4121,Transport,Ride Hailing,-12.02,GBP,-50444.08,E-Com,London,GB,9074,user_002,,
16b0f74a-a154-4fab-9c48-18e4a924dde5,2026-03-02,2026-03-03,Deliveroo,5812,Food & Drink,Delivery,-18.93,GBP,-50463.01,E-Com,London,GB,2219,user_002,,
773c3596-fe29-41ae-b5b8-3f4b3118d2d7,2026-03-02,2026-03-04,Pret A Manger,5814,Food & Drink,Eating Out,-6.84,GBP,-50469.85,POS,London,GB,2219,user_001,,
e7e605dc-538c-498b-ab60-7f6c184aad67,2026-03-02,2026-03-04,Crown Estates Lettings,6513,Housing,Rent,-1480.17,GBP,-51950.02,POS,London,GB,2219,user_002,rec_fc2ae06846,
11a47994-ccc0-4b8d-a2c1-6b49fa581172,2026-03-03,2026-03-04,Shell,5541,Transport,Fuel,-89.76,GBP,-52039.78,POS,London,GB,9074,user_001,,
2cf69199-b75e-432e-8e03-161cb3da89a5,2026-03-03,2026-03-03,Uber UK,4121,Transport,Ride Hailing,-10.52,GBP,-52050.3,E-Com,London,GB,4488,user_001,,
c3b0f843-eaa6-4a04-a4bb-4ca1c50ca319,2026-03-03,2026-03-03,Local Market,5499,Groceries,Specialty,-17.65,GBP,-52067.95,POS,London,GB,9074,user_001,,
ec15a5d7-d3e2-4de3-a4cf-880ab138e30d,2026-03-03,2026-03-04,Pret A Manger,5814,Food & Drink,Eating Out,-8.75,GBP,-52076.7,POS,London,GB,4488,user_001,,
6a4978f7-9d21-4b4d-a0d1-c4340583fe07,2026-03-04,2026-03-05,Transport for London,4111,Transport,Transit,-11.4,GBP,-52088.1,POS,London,GB,4488,user_002,,
f59eb369-51d6-41a9-8cf6-6426e2f5e2d3,2026-03-05,2026-03-05,Sainsbury's,5411,Groceries,Supermarket,-52.52,GBP,-52140.62,POS,London,GB,9074,user_001,,
3d578274-5579-4459-aeb0-2bbec03cf4ce,2026-03-06,2026-03-09,Amazon UK,5942,Shopping,Online Retail,-92.32,GBP,-52232.94,E-Com,London,GB,1045,user_001,,
11a14743-adef-40af-9fbf-311b89c25c74,2026-03-07,2026-03-09,Transport for London,4111,Transport,Transit,-4.84,GBP,-52237.78,POS,London,GB,9074,user_001,,
564c6420-3824-4fde-9beb-7298980f169a,2026-03-07,2026-03-09,Uber UK,4121,Transport,Ride Hailing,-22.04,GBP,-52259.82,E-Com,London,GB,9074,user_002,,
5ba771dd-5234-49f5-9adb-ae7d2ad41ce2,2026-03-07,2026-03-09,Apple.com/bill,5734,Shopping,Electronics,-178.36,USD,-52438.18,E-Com,Cupertino,US,2219,user_001,,FX purchase 211.28 USD @ rate 1.18
677cb004-0552-4911-a624-0845a4f6a345,2026-03-07,2026-03-09,Sainsbury's,5411,Groceries,Supermarket,-26.99,GBP,-52465.17,POS,London,GB,4488,user_001,,
6780a9b7-580b-4606-aca0-47bf7049c8d7,2026-03-07,2026-03-09,Tesco,5411,Groceries,Supermarket,-58.2,GBP,-52523.37,POS,London,GB,9074,user_001,,
91dc7307-e3c8-4003-ae9e-48d23cb43110,2026-03-07,2026-03-09,Uber UK,4121,Transport,Ride Hailing,-31.09,GBP,-52554.46,E-Com,London,GB,4488,user_001,,
ccb5767a-c02e-480b-9298-d794d3b740e1,2026-03-07,2026-03-09,Pret A Manger,5814,Food & Drink,Eating Out,-8.58,GBP,-52563.04,POS,London,GB,1045,user_002,,
5188a150-97d9-44fd-9655-08cf92e869e8,2026-03-08,2026-03-09,Shell,5541,Transport,Fuel,-52.33,GBP,-52615.37,POS,London,GB,1045,user_001,,
9458fc7e-bf24-4179-9957-f998a8afc3e3,2026-03-08,2026-03-09,Shell,5541,Transport,Fuel,-53.83,GBP,-52669.2,POS,London,GB,4488,user_002,,
95d03794-8c7b-401f-897d-ff28fb2bb3de,2026-03-08,2026-03-10,Deliveroo,5812,Food & Drink,Delivery,-19.37,GBP,-52688.57,E-Com,London,GB,2219,user_001,,
18843d4f-f0f7-4f52-bdc2-07eecb7cf62e,2026-03-09,2026-03-09,Local Market,5499,Groceries,Specialty,-16.07,GBP,-52704.64,POS,London,GB,4488,user_001,,
b61a3de5-70ab-4867-86fd-ccee03ed1156,2026-03-09,2026-03-09,Uber UK,4121,Transport,Ride Hailing,-35.92,GBP,-52740.56,E-Com,London,GB,4488,user_001,,
cbc26943-e5bf-485b-8b53-5a7caebdca52,2026-03-09,2026-03-10,Octopus Energy,4900,Utilities,Electricity,-136.81,GBP,-52877.37,Direct Debit,London,GB,9074,user_001,rec_141a4a0666,
6d3f4c1f-6b62-456e-88a9-86877ee1398c,2026-03-10,2026-03-10,Waitrose,5411,Groceries,Supermarket,-41.26,GBP,-52918.63,POS,London,GB,1045,user_001,,
bfe1aaec-3931-423f-9658-6e5b2012e3ad,2026-03-10,2026-03-11,Amazon UK,5942,Shopping,Online Retail,-31.85,GBP,-52950.48,E-Com,London,GB,2219,user_001,,
e816acf0-4eba-4cf3-9d76-ea3991d01c59,2026-03-10,2026-03-12,Deliveroo,5812,Food & Drink,Delivery,-29.66,GBP,-52980.14,E-Com,London,GB,9074,user_001,,
3b51f11a-188b-451b-923b-05274c8570f6,2026-03-11,2026-03-11,Thames Water,4900,Utilities,Water,-37.84,GBP,-53017.98,Direct Debit,Reading,GB,4488,user_001,rec_3a34d62842,
49803498-cd13-41bd-917f-0442f4ed81ce,2026-03-11,2026-03-11,Amazon UK,5942,Shopping,Online Retail,-92.68,GBP,-53110.66,E-Com,London,GB,1045,user_001,,
514571e6-ed10-4a1c-866c-53b7001b5b4a,2026-03-11,2026-03-13,Transport for London,4111,Transport,Transit,-5.31,GBP,-53115.97,POS,London,GB,9074,user_001,,
1886684f-05df-4d21-b059-c09c44c14af1,2026-03-12,2026-03-16,Amazon UK,5942,Shopping,Online Retail,-74.06,GBP,-53190.03,E-Com,London,GB,9074,user_001,,
5fa85798-77ec-4361-9063-a039c543e634,2026-03-13,2026-03-13,Local Market,5499,Groceries,Specialty,-18.55,GBP,-53208.58,POS,London,GB,4488,user_001,,
89ef3c9c-776c-4b3d-9aea-118ad65a9354,2026-03-13,2026-03-16,Deliveroo,5812,Food & Drink,Delivery,-17.91,GBP,-53226.49,E-Com,London,GB,2219,user_001,,
940dc4bc-2356-422b-a400-71009a8f5e67,2026-03-13,2026-03-13,Transport for London,4111,Transport,Transit,-5.99,GBP,-53232.48,POS,London,GB,4488,user_001,,
c4243c49-5ae2-41c1-9f1c-beca64fb53d7,2026-03-13,2026-03-16,City Council Tax,9399,Utilities,Council Tax,-164.71,GBP,-53397.19,Direct Debit,London,GB,2219,user_001,rec_f531495db5,
c6124cc0-31b9-4410-9ed7-2848530dc1b6,2026-03-13,2026-03-16,Pret A Manger,5814,Food & Drink,Eating Out,-9.0,GBP,-53406.19,POS,London,GB,1045,user_001,,
083fa6dc-e621-45c5-9993-2ffdae50ba2b,2026-03-14,2026-03-16,Apple.com/bill,5734,Shopping,Electronics,-3.4,GBP,-53409.59,E-Com,Cupertino,US,9074,user_001,,
30d0de60-8736-45bc-b00a-27acb62a1378,2026-03-14,2026-03-16,Pret A Manger,5814,Food & Drink,Eating Out,-9.75,GBP,-53419.34,POS,London,GB,1045,user_001,,
393a4151-b5c1-47ad-8a0b-997beb2c923c,2026-03-14,2026-03-16,Local Market,5499,Groceries,Specialty,-7.74,GBP,-53427.08,POS,London,GB,9074,user_001,,
49ec1911-1995-4dfa-9e71-722bf7187bf9,2026-03-14,2026-03-16,Local Market,5499,Groceries,Specialty,-17.0,GBP,-53444.08,POS,London,GB,1045,user_001,,
764033d0-29ab-4cdc-a0f5-f6a4f62a244a,2026-03-14,2026-03-16,Apple.com/bill,5734,Shopping,Electronics,-49.42,GBP,-53493.5,E-Com,Cupertino,US,9074,user_001,,
88c26013-0bf6-41a5-ba91-72126866134b,2026-03-15,2026-03-17,Apple.com/bill,5734,Shopping,Electronics,-57.82,GBP,-53551.32,E-Com,Cupertino,US,1045,user_001,,
c630019e-83a7-438a-8bc2-a5ab5af061c6,2026-03-15,2026-03-16,Local Market,5499,Groceries,Specialty,-20.85,GBP,-53572.17,POS,London,GB,1045,user_001,,
ce551167-8e56-454e-b376-0114f7fc21c9,2026-03-15,2026-03-16,Sainsbury's,5411,Groceries,Supermarket,-65.26,GBP,-53637.43,POS,London,GB,1045,user_001,,
ec6e67ba-d4b7-4c40-b00b-4bdad783b45f,2026-03-15,2026-03-17,Transport for London,4111,Transport,Transit,-9.82,GBP,-53647.25,POS,London,GB,1045,user_001,,
406a867a-5fd9-44be-a94f-00f9ce6b554f,2026-03-16,2026-03-16,O2 UK,4814,Bills,Mobile,-53.71,GBP,-53700.96,Direct Debit,Slough,GB,2219,user_001,rec_95042d8101,
bdcfffa2-cf05-4d2c-be1c-11a05c21f483,2026-03-16,2026-03-17,Amazon UK,5942,Shopping,Online Retail,-82.98,GBP,-53783.94,E-Com,London,GB,4488,user_001,,
156a03a1-2890-4c34-a4ea-b983e5d56fcd,2026-03-17,2026-03-19,Transport for London,4111,Transport,Transit,-7.06,GBP,-53791.0,POS,London,GB,9074,user_001,,
5fe13d08-fcae-4c3b-9fe0-7b4fdd9d534e,2026-03-17,2026-03-19,GymBox,7997,Wellness,Gym,-54.39,GBP,-53845.39,Direct Debit,London,GB,1045,user_001,rec_3906953fd2,
6129b45d-558b-4064-a296-a2d2092d2a53,2026-03-17,2026-03-19,Sainsbury's,5411,Groceries,Supermarket,-66.39,GBP,-53911.78,POS,London,GB,9074,user_002,,
4d737dc1-feeb-4e3c-a493-22dd7596b769,2026-03-18,2026-03-19,Pret A Manger,5814,Food & Drink,Eating Out,-11.44,GBP,-53923.22,POS,London,GB,9074,user_001,,
dbf2f692-bd82-47df-ab84-3c8dafea0882,2026-03-18,2026-03-20,Apple.com/bill,5734,Shopping,Electronics,-42.87,GBP,-53966.09,E-Com,Cupertino,US,4488,user_001,,
7eeda64c-010d-402c-a6ea-f41de56cceb6,2026-03-19,2026-03-19,Uber UK,4121,Transport,Ride Hailing,-22.78,GBP,-53988.87,E-Com,London,GB,2219,user_001,,
f6aa658e-c1ce-4291-9c3c-ff90586bbd82,2026-03-19,2026-03-20,Spotify,5735,Entertainment,Subscriptions,-8.22,GBP,-53997.09,E-Com,Stockholm,SE,4488,user_001,rec_4c746d2c3b,
2e1cf24b-5ba4-48b9-9e15-86e136065139,2026-03-20,2026-03-23,Transport for London,4111,Transport,Transit,-3.85,GBP,-54000.94,POS,London,GB,1045,user_001,,
df5d9f3d-050d-42c8-8006-7120c416a2b1,2026-03-20,2026-03-23,British Airways,4511,Travel,Flights,-339.99,EUR,-54340.93,E-Com,London,GB,2219,user_002,,Holiday booking
49acc73e-2283-4d08-83b8-8124dadd93f9,2026-03-21,2026-03-23,Amazon UK,5942,Shopping,Online Retail,-25.65,GBP,-54366.58,E-Com,London,GB,1045,user_001,,
8e36cb4b-743b-48a8-acf7-b0737e24afe8,2026-03-21,2026-03-23,Transport for London,4111,Transport,Transit,-3.51,GBP,-54370.09,POS,London,GB,4488,user_001,,
a6ece435-afa8-42be-8421-094edae55148,2026-03-21,2026-03-23,Apple.com/bill,5734,Shopping,Electronics,-140.31,GBP,-54510.4,E-Com,Cupertino,US,1045,user_001,,
ba1b10f4-d4b1-4d33-acb0-e05b1f053757,2026-03-21,2026-03-23,Local Market,5499,Groceries,Specialty,-6.38,GBP,-54516.78,POS,London,GB,2219,user_001,,
47350e39-e828-4e11-8864-24b4f54d67fe,2026-03-22,2026-03-23,Shell,5541,Transport,Fuel,-44.28,GBP,-54561.06,POS,London,GB,1045,user_002,,
55d00b95-b3a7-47ea-88ae-24d096b662cd,2026-03-22,2026-03-24,Transport for London,4111,Transport,Transit,-9.1,GBP,-54570.16,POS,London,GB,9074,user_001,,
71dcea1c-7971-4991-86f0-22736c4c9e7f,2026-03-22,2026-03-24,Shell,5541,Transport,Fuel,-61.98,GBP,-54632.14,POS,London,GB,4488,user_001,,
92de45c1-b1a3-4100-badd-616433fc24ad,2026-03-22,2026-03-23,Uber UK,4121,Transport,Ride Hailing,-23.25,GBP,-54655.39,E-Com,London,GB,9074,user_001,,
ebf003c3-3838-4d8a-bf17-d37fc31c22cb,2026-03-22,2026-03-23,Local Market,5499,Groceries,Specialty,-16.99,GBP,-54672.38,POS,London,GB,1045,user_001,,
0542a7b2-0ddf-4a30-9d71-296fe1d721c4,2026-03-23,2026-03-23,Transport for London,4111,Transport,Transit,-4.81,GBP,-54677.19,POS,London,GB,9074,user_001,,
1afa9728-9f98-4d29-b797-2298d2594d3e,2026-03-23,2026-03-24,Tesco,5411,Groceries,Supermarket,-70.58,GBP,-54747.77,POS,London,GB,9074,user_001,,
96aac9e7-ace8-4a61-857e-3528a5e13ff3,2026-03-23,2026-03-24,Netflix,7841,Entertainment,Subscriptions,-11.11,GBP,-54758.88,E-Com,Los Gatos,US,4488,user_001,rec_1bfe33738d,
0a837008-95ff-44f3-b53a-89b570964950,2026-03-25,2026-03-25,T212 Capital,6011,Income,Salary,3272.18,GBP,-51486.7,Credit,London,GB,1045,user_002,rec_c649d24d0f,
8f331587-1ab4-4698-98cb-dedad9e8b2d1,2026-03-25,2026-03-27,Pret A Manger,5814,Food & Drink,Eating Out,-8.29,GBP,-51494.99,POS,London,GB,2219,user_001,,
5ff3e9c6-ae37-4405-87f0-30fb9e295e66,2026-03-26,2026-03-27,Shell,5541,Transport,Fuel,-47.16,GBP,-51542.15,POS,London,GB,2219,user_002,,
ad53cdcd-51e2-4180-ab75-51ee954ada72,2026-03-26,2026-03-26,Shell,5541,Transport,Fuel,-77.94,GBP,-51620.09,POS,London,GB,1045,user_001,,
97686376-6d9a-4ba7-b206-a1cd38c6d65b,2026-03-28,2026-03-30,Transport for London,4111,Transport,Transit,-10.03,GBP,-51630.12,POS,London,GB,9074,user_001,,
ae6925af-004f-43a5-9358-c8cae23c77ab,2026-03-28,2026-03-30,Transport for London,4111,Transport,Transit,-4.28,GBP,-51634.4,POS,London,GB,4488,user_002,,
d49c12e3-3c50-49f3-af33-e413bf765bec,2026-03-28,2026-03-30,Deliveroo,5812,Food & Drink,Delivery,-28.57,GBP,-51662.97,E-Com,London,GB,4488,user_001,,
15d1d5c1-ef56-4c6b-b39a-4b4329088421,2026-03-29,2026-03-31,Transport for London,4111,Transport,Transit,-6.35,GBP,-51669.32,POS,London,GB,4488,user_001,,
7b002c17-ea7a-4a0f-949c-dad89df78af2,2026-03-29,2026-03-30,Amazon UK,5942,Shopping,Online Retail,-79.42,GBP,-51748.74,E-Com,London,GB,4488,user_001,,
afd8f796-2179-4aa9-aa35-aabdb26b8ce4,2026-03-29,2026-03-30,Waitrose,5411,Groceries,Supermarket,-79.03,GBP,-51827.77,POS,London,GB,4488,user_001,,
fb8679e4-9a5f-4487-89a5-fad8512a460d,2026-03-29,2026-03-30,Waitrose,5411,Groceries,Supermarket,-87.25,GBP,-51915.02,POS,London,GB,4488,user_001,,
072ca3ba-e049-4f75-9016-fa6e97476e5c,2026-03-30,2026-03-30,Shell,5541,Transport,Fuel,-32.29,GBP,-51947.31,POS,London,GB,1045,user_001,,
a66dfbec-0283-4a68-8586-c093c0b2539c,2026-03-30,2026-04-01,Amazon UK,5942,Shopping,Online Retail,-63.0,GBP,-52010.31,E-Com,London,GB,1045,user_001,,
3d3216d3-54d5-44b5-8e52-438d524e0408,2026-03-31,2026-04-01,Tesco,5411,Groceries,Supermarket,-73.82,GBP,-52084.13,POS,London,GB,1045,user_001,,
4a1dcccb-7cfa-4ad3-9f2f-b0782ed1ae8b,2026-03-31,2026-04-01,Pret A Manger,5814,Food & Drink,Eating Out,-10.34,GBP,-52094.47,POS,London,GB,1045,user_001,,
12a44191-75d4-49c1-87ce-d4c7189d00a1,2026-04-01,2026-04-02,Pret A Manger,5814,Food & Drink,Eating Out,-5.91,GBP,-52100.38,POS,London,GB,4488,user_001,,
6b286584-131c-4377-b7a8-e1e3c6f5db86,2026-04-01,2026-04-03,Crown Estates Lettings,6513,Housing,Rent,-1539.35,GBP,-53639.73,POS,London,GB,4488,user_002,rec_fc2ae06846,
0117eebd-ba62-4283-80f7-6c6c0377af22,2026-04-02,2026-04-06,Local Market,5499,Groceries,Specialty,-17.24,GBP,-53656.97,POS,London,GB,2219,user_001,,
50a90abf-c684-4145-b02a-c15c5e53537a,2026-04-03,2026-04-03,Deliveroo,5812,Food & Drink,Delivery,-24.68,GBP,-53681.65,E-Com,London,GB,4488,user_001,,
633a4429-b881-4527-aead-db6672a083ba,2026-04-03,2026-04-06,Waitrose,5411,Groceries,Supermarket,-83.51,GBP,-53765.16,POS,London,GB,4488,user_001,,
dd5097d0-7366-45e6-a654-891faff89750,2026-04-03,2026-04-06,Shell,5541,Transport,Fuel,-66.94,GBP,-53832.1,POS,London,GB,1045,user_001,,
02cace21-cbc5-4f25-939d-91c49df50f3e,2026-04-04,2026-04-06,Sainsbury's,5411,Groceries,Supermarket,-65.26,GBP,-53897.36,POS,London,GB,1045,user_001,,
b522cf8e-e32b-4e85-9bc6-75cc5c98c2ce,2026-04-04,2026-04-06,Apple.com/bill,5734,Shopping,Electronics,-127.34,GBP,-54024.7,E-Com,Cupertino,US,9074,user_001,,
09aa14e8-c26d-445a-be85-d39ce8867e8d,2026-04-05,2026-04-06,Apple.com/bill,5734,Shopping,Electronics,-113.57,GBP,-54138.27,E-Com,Cupertino,US,1045,user_001,,
5bb07ec4-e5af-4695-86b8-6fe7986016be,2026-04-05,2026-04-06,Pret A Manger,5814,Food & Drink,Eating Out,-5.62,GBP,-54143.89,POS,London,GB,9074,user_001,,
cb6920cd-245a-4d34-bdb4-17738fe9fc4b,2026-04-05,2026-04-07,Transport for London,4111,Transport,Transit,-10.57,GBP,-54154.46,POS,London,GB,9074,user_001,,
3ff20566-fbe2-457f-b2e8-d0d8480ecd3f,2026-04-06,2026-04-06,Amazon UK,5942,Shopping,Online Retail,-116.35,GBP,-54270.81,E-Com,London,GB,4488,user_001,,
68e8f75b-3973-4865-843e-730fa61a90b6,2026-04-06,2026-04-08,ATM Withdrawal,6011,Cash,ATM,-84.84,GBP,-54355.65,ATM,London,GB,2219,user_001,,
64e07f17-9e0d-474a-9362-30465fbcf7ed,2026-04-07,2026-04-07,Waitrose,5411,Groceries,Supermarket,-89.57,GBP,-54445.22,POS,London,GB,2219,user_001,,
a5b76832-d18c-4c63-bf73-a63fdafc3722,2026-04-07,2026-04-09,Octopus Energy,4900,Utilities,Electricity,-115.84,GBP,-54561.06,Direct Debit,London,GB,9074,user_001,rec_141a4a0666,
b2ecc7f6-5076-4823-a252-d16a69922a92,2026-04-08,2026-04-09,Local Market,5499,Groceries,Specialty,-19.5,GBP,-54580.56,POS,London,GB,4488,user_001,,
dfda0a75-eb78-419a-b95c-67332e1fee2a,2026-04-08,2026-04-10,Shell,5541,Transport,Fuel,-36.35,GBP,-54616.91,POS,London,GB,1045,user_001,,
13741dd2-4690-4381-9960-f511e973d3e2,2026-04-10,2026-04-13,Sainsbury's,5411,Groceries,Supermarket,-42.89,GBP,-54659.8,POS,London,GB,1045,user_001,,
f6bca4d8-1217-4363-82e6-4d109a7b4dca,2026-04-10,2026-04-13,Amazon UK,5942,Shopping,Online Retail,-48.23,GBP,-54708.03,E-Com,London,GB,1045,user_002,,
3aea74bb-130b-40ce-9458-7c1a59b0c1b5,2026-04-11,2026-04-13,Transport for London,4111,Transport,Transit,-10.4,GBP,-54718.43,POS,London,GB,4488,user_001,,
7dd39458-592d-4222-bb18-f8dc82c8f655,2026-04-11,2026-04-13,Amazon UK,5942,Shopping,Online Retail,-118.58,GBP,-54837.01,E-Com,London,GB,1045,user_001,,
dc1a7a13-0b35-4de3-a6af-752c55c276cf,2026-04-11,2026-04-13,Amazon UK,5942,Shopping,Online Retail,-88.61,GBP,-54925.62,E-Com,London,GB,2219,user_001,,
f8684f8e-43e0-430c-b823-89fb0d21bc4b,2026-04-11,2026-04-13,Sainsbury's,5411,Groceries,Supermarket,-44.71,GBP,-54970.33,POS,London,GB,9074,user_002,,
16cdcf07-6511-4df5-b9cc-eee77bf5f8ac,2026-04-12,2026-04-13,Shell,5541,Transport,Fuel,-67.14,GBP,-55037.47,POS,London,GB,4488,user_001,,
9cc7f64a-45ab-480c-a769-6bc9d50c988e,2026-04-12,2026-04-14,Amazon UK,5942,Shopping,Online Retail,-64.19,GBP,-55101.66,E-Com,London,GB,1045,user_001,,
ba5e3545-764a-4651-8f78-f43ce54fb622,2026-04-12,2026-04-13,Local Market,5499,Groceries,Specialty,-20.83,GBP,-55122.49,POS,London,GB,9074,user_001,,
c4b3e130-30ce-43c5-bf1c-11d2fdb54eaa,2026-04-12,2026-04-14,Apple.com/bill,5734,Shopping,Electronics,-112.36,USD,-55234.85,E-Com,Cupertino,US,1045,user_001,,FX purchase 144.74 USD @ rate 1.29
17263366-407b-47cc-9bd3-517166f8efa6,2026-04-13,2026-04-14,Tesco,5411,Groceries,Supermarket,-62.54,GBP,-55297.39,POS,London,GB,2219,user_002,,
1fec5fc3-1b89-41a7-847c-16393a261bcf,2026-04-13,2026-04-13,Local Market,5499,Groceries,Specialty,-6.72,GBP,-55304.11,POS,London,GB,9074,user_001,,
b27e54b8-bf64-49e9-8662-7528de2e80cc,2026-04-13,2026-04-14,City Council Tax,9399,Utilities,Council Tax,-185.57,GBP,-55489.68,Direct Debit,London,GB,1045,user_001,rec_f531495db5,
d004d20d-9955-4fd9-9550-d58369271c9f,2026-04-13,2026-04-13,Thames Water,4900,Utilities,Water,-34.19,GBP,-55523.87,Direct Debit,Reading,GB,1045,user_001,rec_3a34d62842,
96ce9465-e9c5-4c2c-ac8d-452dbed0fb86,2026-04-14,2026-04-16,Deliveroo,5812,Food & Drink,Delivery,-25.0,GBP,-55548.87,E-Com,London,GB,9074,user_001,,
0fe9a6e0-e99a-4123-9f39-ae684e9fe419,2026-04-15,2026-04-16,O2 UK,4814,Bills,Mobile,-53.73,GBP,-55602.6,Direct Debit,Slough,GB,1045,user_001,rec_95042d8101,
43797853-2b4d-4a02-bca0-c6d8c246c459,2026-04-15,2026-04-15,Amazon UK,5942,Shopping,Online Retail,-105.71,GBP,-55708.31,E-Com,London,GB,4488,user_001,,
61800677-ca05-4637-9a1e-fbae63f23628,2026-04-15,2026-04-16,Transport for London,4111,Transport,Transit,-8.02,GBP,-55716.33,POS,London,GB,2219,user_001,,
6712e968-4a8d-44c5-86dd-0a5ff62a4990,2026-04-16,2026-04-17,Apple.com/bill,5734,Shopping,Electronics,-56.74,GBP,-55773.07,E-Com,Cupertino,US,2219,user_001,,
d262bb12-c683-4ea6-96ca-b9cdbbe4b721,2026-04-16,2026-04-17,Deliveroo,5812,Food & Drink,Delivery,-27.71,GBP,-55800.78,E-Com,London,GB,9074,user_001,,
2dc4ce15-72cc-44be-81ee-5f1e8690d84e,2026-04-17,2026-04-17,Pret A Manger,5814,Food & Drink,Eating Out,-9.71,GBP,-55810.49,POS,London,GB,1045,user_001,,
4ff0d943-18b6-4c7d-84c3-3db1398aa26b,2026-04-17,2026-04-20,Uber UK,4121,Transport,Ride Hailing,-33.31,GBP,-55843.8,E-Com,London,GB,2219,user_001,,
a4e77eae-ad39-4bce-b0f0-b9d25995ffde,2026-04-17,2026-04-20,GymBox,7997,Wellness,Gym,-50.98,GBP,-55894.78,Direct Debit,London,GB,4488,user_001,rec_3906953fd2,
d1b0f036-7a55-42cc-a28a-40b2f0901228,2026-04-17,2026-04-20,Tesco,5411,Groceries,Supermarket,-26.28,GBP,-55921.06,POS,London,GB,1045,user_001,,
0410e9c7-a9d8-4d1a-a6e3-c2f80b911e43,2026-04-18,2026-04-20,Uber UK,4121,Transport,Ride Hailing,-18.82,GBP,-55939.88,E-Com,London,GB,1045,user_001,,
19d8adde-4cf9-4c66-bcb6-9b013af99d95,2026-04-18,2026-04-20,Shell,5541,Transport,Fuel,-53.45,GBP,-55993.33,POS,London,GB,2219,user_001,,
b0e51d89-65b0-4028-9c53-8e389e7ab96e,2026-04-18,2026-04-20,Deliveroo,5812,Food & Drink,Delivery,-27.93,GBP,-56021.26,E-Com,London,GB,1045,user_001,,
cdc051ac-ba8e-4aef-aeb9-7a6b387ecd97,2026-04-18,2026-04-20,Transport for London,4111,Transport,Transit,-11.5,GBP,-56032.76,POS,London,GB,9074,user_002,,
1cc48d1f-56f4-4ea9-b022-5e5fda2df378,2026-04-19,2026-04-20,Shell,5541,Transport,Fuel,-70.78,GBP,-56103.54,POS,London,GB,4488,user_002,,
5ace2f05-11d7-4206-9919-6949a17ccad5,2026-04-19,2026-04-20,Deliveroo,5812,Food & Drink,Delivery,-23.1,GBP,-56126.64,E-Com,London,GB,1045,user_002,,
80b4165b-f902-4bb6-9215-d2a04c7cb0aa,2026-04-19,2026-04-20,Apple.com/bill,5734,Shopping,Electronics,-90.75,GBP,-56217.39,E-Com,Cupertino,US,1045,user_001,,
0c1c031a-3b25-49e5-9fbf-3287ede35c11,2026-04-20,2026-04-22,Apple.com/bill,5734,Shopping,Electronics,-51.77,GBP,-56269.16,E-Com,Cupertino,US,9074,user_001,,
4c4c42a8-1a23-43e1-bd84-d1da3c7a0888,2026-04-20,2026-04-21,Spotify,5735,Entertainment,Subscriptions,-8.68,GBP,-56277.84,E-Com,Stockholm,SE,2219,user_001,rec_4c746d2c3b,
5bfdf136-5615-47f4-9b05-b66ab4cef86a,2026-04-20,2026-04-22,Amazon UK,5942,Shopping,Online Retail,-26.68,GBP,-56304.52,E-Com,London,GB,2219,user_002,,
7b9f6f76-6e5d-4672-b6cb-170cd0529df8,2026-04-20,2026-04-21,Pret A Manger,5814,Food & Drink,Eating Out,-8.58,GBP,-56313.1,POS,London,GB,4488,user_002,,
edf00bac-5cc4-4573-8b76-614a9724162a,2026-04-20,2026-04-22,Waitrose,5411,Groceries,Supermarket,-64.42,GBP,-56377.52,POS,London,GB,4488,user_002,,
6cc6ad3c-d8b2-49e3-bbb5-7bebc8ff256d,2026-04-21,2026-04-21,Netflix,7841,Entertainment,Subscriptions,-10.02,USD,-56387.54,E-Com,Los Gatos,US,9074,user_002,rec_d9322c1382,FX purchase 12.51 USD @ rate 1.25
a909bc0e-9654-45ab-9342-664f1c0fb284,2026-04-21,2026-04-21,Transport for London,4111,Transport,Transit,-4.18,GBP,-56391.72,POS,London,GB,1045,user_001,,
e714266e-58fd-46be-8221-0363fc13ae1b,2026-04-22,2026-04-24,Pret A Manger,5814,Food & Drink,Eating Out,-11.54,GBP,-56403.26,POS,London,GB,4488,user_001,,
ee822cbd-dfb2-427d-ad81-938db8120860,2026-04-22,2026-04-22,Uber UK,4121,Transport,Ride Hailing,-25.08,GBP,-56428.34,E-Com,London,GB,9074,user_001,,
4ce96eae-a342-4ab0-bc17-e35e544bb636,2026-04-23,2026-04-24,Shell,5541,Transport,Fuel,-38.27,GBP,-56466.61,POS,London,GB,2219,user_001,,
0813c213-851d-43b0-9f21-0fa7aeb75fc4,2026-04-24,2026-04-27,Local Market,5499,Groceries,Specialty,-7.53,GBP,-56474.14,POS,London,GB,2219,user_001,,
13074667-80d3-468e-8f5e-b371b8cf7085,2026-04-24,2026-04-24,Pret A Manger,5814,Food & Drink,Eating Out,-7.72,GBP,-56481.86,POS,London,GB,2219,user_001,,
22740009-c1ce-40d1-a336-7df1a69bcd16,2026-04-24,2026-04-24,T212 Capital,6011,Income,Salary,3351.05,GBP,-53130.81,Credit,London,GB,4488,user_001,rec_2ff8f778d0,
b4bbb48a-9be4-43f6-902f-bc0abdfecdcb,2026-04-24,2026-04-27,Deliveroo,5812,Food & Drink,Delivery,-24.88,GBP,-53155.69,E-Com,London,GB,4488,user_001,,
cbbab670-f791-46db-b0d5-16a3d01472df,2026-04-24,2026-04-27,Pret A Manger,5814,Food & Drink,Eating Out,-7.73,GBP,-53163.42,POS,London,GB,2219,user_001,,
4f484f56-dc36-4432-8958-d80957335666,2026-04-25,2026-04-27,Apple.com/bill,5734,Shopping,Electronics,-87.73,USD,-53251.15,E-Com,Cupertino,US,1045,user_002,,FX purchase 102.68 USD @ rate 1.17
b2154dc2-a26b-475d-9174-71afb45c332e,2026-04-25,2026-04-27,Tesco,5411,Groceries,Supermarket,-19.31,GBP,-53270.46,POS,London,GB,2219,user_001,,
f90eb347-4f22-401d-ac47-5e2c65b3f9da,2026-04-25,2026-04-27,Local Market,5499,Groceries,Specialty,-9.12,GBP,-53279.58,POS,London,GB,9074,user_001,,
1aa4fcdb-78c0-4c44-9016-2d3c9883d4a2,2026-04-26,2026-04-27,Sainsbury's,5411,Groceries,Supermarket,-14.39,GBP,-53293.97,POS,London,GB,1045,user_002,,
1c191fcd-7d22-41e4-956a-3586a5eafc8e,2026-04-26,2026-04-28,Shell,5541,Transport,Fuel,-63.69,GBP,-53357.66,POS,London,GB,9074,user_001,,
1d98d803-14fa-4425-b85e-fb3007741460,2026-04-26,2026-04-27,Sainsbury's,5411,Groceries,Supermarket,-42.41,GBP,-53400.07,POS,London,GB,1045,user_001,,
a9cdc24f-a448-474c-9a98-80da73cecce5,2026-04-26,2026-04-27,Waitrose,5411,Groceries,Supermarket,-89.17,GBP,-53489.24,POS,London,GB,4488,user_001,,
ef007cb3-6f6c-431f-8c1e-8cd8e9805c87,2026-04-26,2026-04-27,Sainsbury's,5411,Groceries,Supermarket,-23.04,GBP,-53512.28,POS,London,GB,2219,user_001,,
f09742ba-fcb5-47f6-a52b-034d417fd360,2026-04-26,2026-04-27,Uber UK,4121,Transport,Ride Hailing,-33.48,GBP,-53545.76,E-Com,London,GB,2219,user_001,,
fa17867c-453f-4b6b-b895-b86afa0a3c99,2026-04-26,2026-04-28,Sainsbury's,5411,Groceries,Supermarket,-19.45,GBP,-53565.21,POS,London,GB,4488,user_001,,
5de6a197-42b6-4929-ab5f-0e8fdca864cb,2026-04-28,2026-04-28,Pret A Manger,5814,Food & Drink,Eating Out,-9.19,GBP,-53574.4,POS,London,GB,4488,user_001,,
0c82f6c4-3961-4c31-8e9a-1856750a233a,2026-04-29,2026-04-30,Transport for London,4111,Transport,Transit,-8.04,GBP,-53582.44,POS,London,GB,4488,user_001,,
fe3bfb35-1fc8-4ced-b821-f503d0d0dbba,2026-04-29,2026-04-29,Shell,5541,Transport,Fuel,-75.67,GBP,-53658.11,POS,London,GB,1045,user_001,,
056d6eda-52e1-4425-bd97-dc71ec48a579,2026-04-30,2026-04-30,Tesco,5411,Groceries,Supermarket,-32.06,GBP,-53690.17,POS,London,GB,2219,user_001,,
da94b1c1-a951-4673-b93c-4f308e3b1f73,2026-04-30,2026-04-30,Amazon UK,5942,Shopping,Online Retail,-99.08,GBP,-53789.25,E-Com,London,GB,4488,user_002,,
9aae6099-baaf-4af3-ab9f-1f6424629e58,2026-05-01,2026-05-04,Crown Estates Lettings,6513,Housing,Rent,-1499.71,GBP,-55288.96,POS,London,GB,9074,user_001,rec_19f70fbcce,
4f9bd2d8-082c-4c32-90d6-e5e6d91600bb,2026-05-02,2026-05-04,Waitrose,5411,Groceries,Supermarket,-80.86,GBP,-55369.82,POS,London,GB,2219,user_001,,
99e98361-929a-45e2-a60c-7d7c0dedb9a2,2026-05-02,2026-05-04,Transport for London,4111,Transport,Transit,-11.23,GBP,-55381.05,POS,London,GB,4488,user_001,,
ba36b4d9-2f13-46c7-8be5-b1e3b54d161c,2026-05-02,2026-05-04,Tesco,5411,Groceries,Supermarket,-53.36,GBP,-55434.41,POS,London,GB,4488,user_002,,
55007f0a-a37c-4d66-8ed4-b373d5953cb7,2026-05-03,2026-05-04,Transport for London,4111,Transport,Transit,-8.95,GBP,-55443.36,POS,London,GB,2219,user_001,,
a9e7a807-6652-418e-9dbe-f5498fa10d4f,2026-05-03,2026-05-04,Local Market,5499,Groceries,Specialty,-15.98,GBP,-55459.34,POS,London,GB,2219,user_001,,
3d091615-1514-48c3-850c-1de28ffdb2e1,2026-05-04,2026-05-06,Amazon UK,5942,Shopping,Online Retail,-34.83,GBP,-55494.17,E-Com,London,GB,4488,user_001,,
3dbabc6f-a03d-4b70-9c07-a4d1eb5aa4a3,2026-05-04,2026-05-05,Waitrose,5411,Groceries,Supermarket,-53.13,GBP,-55547.3,POS,London,GB,1045,user_001,,
5475e694-ed31-4db2-b311-4ae1be905e04,2026-05-04,2026-05-04,Deliveroo,5812,Food & Drink,Delivery,-31.02,GBP,-55578.32,E-Com,London,GB,9074,user_001,,
42771447-e675-496f-bec9-62a5f05a958a,2026-05-06,2026-05-08,Deliveroo,5812,Food & Drink,Delivery,-23.38,GBP,-55601.7,E-Com,London,GB,4488,user_001,,
cc6559dd-1171-438d-a060-a3f6578be056,2026-05-06,2026-05-06,HM Revenue & Customs,9311,Income,Tax Refund,63.09,GBP,-55538.61,Credit,London,GB,9074,user_001,,Refund for Apple.com/bill
d2059c29-428c-4159-aca0-c9b510340acf,2026-05-06,2026-05-08,Sainsbury's,5411,Groceries,Supermarket,-14.63,GBP,-55553.24,POS,London,GB,4488,user_002,,
f88654a0-fcb0-477e-891e-4c4eba753232,2026-05-06,2026-05-07,Uber UK,4121,Transport,Ride Hailing,-8.92,GBP,-55562.16,E-Com,London,GB,1045,user_001,,
57621da5-70e0-4a64-bc31-f5b1c4976275,2026-05-07,2026-05-07,Octopus Energy,4900,Utilities,Electricity,-125.92,GBP,-55688.08,Direct Debit,London,GB,4488,user_002,rec_09c3f12b18,
d76dc28b-e81f-44ae-b1ce-3b13c6e7dd95,2026-05-07,2026-05-11,Tesco,5411,Groceries,Supermarket,-58.53,GBP,-55746.61,POS,London,GB,1045,user_001,,
00deb6fb-5609-4c3e-b9a2-e8c01fe0a4ee,2026-05-08,2026-05-08,Apple.com/bill,5734,Shopping,Electronics,-52.28,GBP,-55798.89,E-Com,Cupertino,US,4488,user_002,,
92bf68cf-61bb-485c-ac82-b24f31b8b918,2026-05-08,2026-05-08,Transport for London,4111,Transport,Transit,-6.09,GBP,-55804.98,POS,London,GB,1045,user_001,,
65d9da0e-f916-4f1e-aba2-e2c0cdf06aa4,2026-05-09,2026-05-11,Tesco,5411,Groceries,Supermarket,-47.64,GBP,-55852.62,POS,London,GB,9074,user_001,,
1438bf04-2b3a-4f65-b666-727c0776e58c,2026-05-10,2026-05-11,Waitrose,5411,Groceries,Supermarket,-76.32,GBP,-55928.94,POS,London,GB,2219,user_001,,
582020e7-4c1f-40bb-9415-6af07e8e2ff1,2026-05-10,2026-05-11,Local Market,5499,Groceries,Specialty,-17.36,GBP,-55946.3,POS,London,GB,1045,user_001,,
698cb981-a59a-444c-ab1a-14ff88c223f1,2026-05-10,2026-05-11,Shell,5541,Transport,Fuel,-57.45,GBP,-56003.75,POS,London,GB,1045,user_001,,
a7e213cc-b7a1-4704-ad42-6e7cbcf00b63,2026-05-10,2026-05-12,Local Market,5499,Groceries,Specialty,-21.44,GBP,-56025.19,POS,London,GB,4488,user_001,,
b550f5e2-37e9-4131-a456-533dd023e3e1,2026-05-10,2026-05-11,Local Market,5499,Groceries,Specialty,-14.12,GBP,-56039.31,POS,London,GB,4488,user_001,,
d7763389-420b-4b75-862f-a5b95e607581,2026-05-10,2026-05-11,Pret A Manger,5814,Food & Drink,Eating Out,-9.42,GBP,-56048.73,POS,London,GB,1045,user_001,,
e6668b58-4ce3-4b59-91e0-86274144ad9d,2026-05-10,2026-05-11,Local Market,5499,Groceries,Specialty,-15.76,GBP,-56064.49,POS,London,GB,9074,user_002,,
90d20157-1daa-40b6-abdd-79639c905797,2026-05-11,2026-05-12,Thames Water,4900,Utilities,Water,-32.3,GBP,-56096.79,Direct Debit,Reading,GB,4488,user_002,rec_954d02400c,
be68654c-5f1f-4148-9052-f169b2c6b922,2026-05-11,2026-05-11,Pret A Manger,5814,Food & Drink,Eating Out,-7.32,GBP,-56104.11,POS,London,GB,2219,user_001,,
e5ed42a5-cb87-4223-841a-5f656e237dce,2026-05-12,2026-05-14,Transport for London,4111,Transport,Transit,-8.79,GBP,-56112.9,POS,London,GB,2219,user_002,,
3613cb10-99ac-441d-a06f-70a5c2d7cf4f,2026-05-13,2026-05-15,Tesco,5411,Groceries,Supermarket,-51.47,GBP,-56164.37,POS,London,GB,4488,user_001,,
956eda4a-c47f-4b01-816a-f066c7811398,2026-05-13,2026-05-14,City Council Tax,9399,Utilities,Council Tax,-188.8,GBP,-56353.17,Direct Debit,London,GB,9074,user_001,rec_f531495db5,
0fb2922c-e287-4a6f-ae46-73601741ef55,2026-05-15,2026-05-18,O2 UK,4814,Bills,Mobile,-38.02,GBP,-56391.19,Direct Debit,Slough,GB,1045,user_002,rec_d2dce4c42f,
1ffaa7f8-d303-4942-8e95-d410d4cdb5f2,2026-05-15,2026-05-18,Apple.com/bill,5734,Shopping,Electronics,-9.65,GBP,-56400.84,E-Com,Cupertino,US,1045,user_001,,
2d051b69-8771-4d74-ab84-89cab437f9c5,2026-05-15,2026-05-18,Amazon UK,5942,Shopping,Online Retail,-119.05,GBP,-56519.89,E-Com,London,GB,2219,user_001,,
72bcf55f-f37e-42dc-8d21-69570e08f065,2026-05-15,2026-05-18,Deliveroo,5812,Food & Drink,Delivery,-15.1,GBP,-56534.99,E-Com,London,GB,1045,user_001,,
3f68ef02-1729-478b-aad6-12b02196d853,2026-05-16,2026-05-18,Tesco,5411,Groceries,Supermarket,-35.83,GBP,-56570.82,POS,London,GB,1045,user_001,,
5c1858c1-a78d-4b15-96aa-434616079ef7,2026-05-16,2026-05-18,Tesco,5411,Groceries,Supermarket,-47.91,GBP,-56618.73,POS,London,GB,2219,user_001,,
a5b8b689-e2bc-448f-9780-28174873f8d6,2026-05-16,2026-05-18,Transport for London,4111,Transport,Transit,-4.92,GBP,-56623.65,POS,London,GB,1045,user_001,,
203f96fd-fa3c-4a01-b70a-6e269438001b,2026-05-17,2026-05-18,Pret A Manger,5814,Food & Drink,Eating Out,-5.6,GBP,-56629.25,POS,London,GB,4488,user_001,,
2b7b7d4d-7d49-433e-8165-7ea794ed869b,2026-05-17,2026-05-18,Local Market,5499,Groceries,Specialty,-8.25,GBP,-56637.5,POS,London,GB,4488,user_001,,
7ebb0c64-a4d8-4cfb-b9ba-350e1288f252,2026-05-17,2026-05-18,Local Market,5499,Groceries,Specialty,-11.6,GBP,-56649.1,POS,London,GB,2219,user_001,,
95291e8a-bd85-4d4f-8cc8-e67c5f2f8a66,2026-05-17,2026-05-18,Shell,5541,Transport,Fuel,-35.83,GBP,-56684.93,POS,London,GB,1045,user_002,,
a28c2269-2ccb-4d3f-bbe1-62c21d0367de,2026-05-17,2026-05-18,Tesco,5411,Groceries,Supermarket,-82.65,GBP,-56767.58,POS,London,GB,4488,user_001,,
8459297c-73e8-416e-a983-d2d66699ef09,2026-05-18,2026-05-20,GymBox,7997,Wellness,Gym,-53.15,GBP,-56820.73,Direct Debit,London,GB,4488,user_001,rec_3906953fd2,
dae9daae-e786-46d7-a6a5-0fa3ffd72b55,2026-05-18,2026-05-20,Pret A Manger,5814,Food & Drink,Eating Out,-10.34,GBP,-56831.07,POS,London,GB,4488,user_002,,
815575fc-2ef5-4c17-878d-f4309bec105b,2026-05-19,2026-05-21,Local Market,5499,Groceries,Specialty,-20.36,GBP,-56851.43,POS,London,GB,4488,user_002,,
a321f700-900c-477b-a097-287533011c09,2026-05-19,2026-05-19,Spotify,5735,Entertainment,Subscriptions,-9.16,GBP,-56860.59,E-Com,Stockholm,SE,4488,user_001,rec_4c746d2c3b,
b6fb9c95-3c8e-4328-b2b9-312a9ff5ddb0,2026-05-19,2026-05-19,Pret A Manger,5814,Food & Drink,Eating Out,-8.6,GBP,-56869.19,POS,London,GB,4488,user_001,,
11150294-63d0-46ef-9337-1b837fb59a64,2026-05-20,2026-05-21,Sainsbury's,5411,Groceries,Supermarket,-50.14,GBP,-56919.33,POS,London,GB,9074,user_001,,
81d8ab10-67c7-4799-95ba-733e754e3fe6,2026-05-20,2026-05-22,Deliveroo,5812,Food & Drink,Delivery,-15.31,GBP,-56934.64,E-Com,London,GB,4488,user_001,,
f1d2da47-9267-4245-8952-8cf5dda1f67a,2026-05-20,2026-05-20,Shell,5541,Transport,Fuel,-44.25,GBP,-56978.89,POS,London,GB,9074,user_001,,
aec0c0b9-b54b-44fb-9829-ff14fe579977,2026-05-21,2026-05-22,Uber UK,4121,Transport,Ride Hailing,-15.99,GBP,-56994.88,E-Com,London,GB,1045,user_001,,
bfd889b7-9d4b-4300-84f1-3b0a7c9d5691,2026-05-21,2026-05-21,Netflix,7841,Entertainment,Subscriptions,-10.27,GBP,-57005.15,E-Com,Los Gatos,US,2219,user_001,rec_1bfe33738d,
cda3b412-b1e1-489e-aa8a-5ada55d74457,2026-05-21,2026-05-22,Waitrose,5411,Groceries,Supermarket,-39.4,GBP,-57044.55,POS,London,GB,2219,user_002,,
471c9f74-4b4f-4676-bbe1-50181f802fba,2026-05-22,2026-05-25,Sainsbury's,5411,Groceries,Supermarket,-43.94,GBP,-57088.49,POS,London,GB,4488,user_001,,
81b7983f-44a0-44f3-9458-2be8f85af700,2026-05-23,2026-05-25,Transport for London,4111,Transport,Transit,-4.94,GBP,-57093.43,POS,London,GB,9074,user_001,,
991b4758-f768-433a-acde-3d1c256fe286,2026-05-23,2026-05-25,Sainsbury's,5411,Groceries,Supermarket,-27.72,GBP,-57121.15,POS,London,GB,4488,user_001,,
a803b1a3-8ad6-4344-9729-b7d3e324a0d2,2026-05-23,2026-05-25,Local Market,5499,Groceries,Specialty,-18.74,GBP,-57139.89,POS,London,GB,9074,user_002,,
b09ae124-2cb6-4533-b17b-b56add7f558d,2026-05-23,2026-05-25,Sainsbury's,5411,Groceries,Supermarket,-44.17,GBP,-57184.06,POS,London,GB,1045,user_002,,
c36acf6b-408e-42e6-bed7-1225b02b497b,2026-05-23,2026-05-25,Local Market,5499,Groceries,Specialty,-9.61,GBP,-57193.67,POS,London,GB,4488,user_002,,
01d54bb5-b0fb-46e7-95a2-b9cec62437e6,2026-05-24,2026-05-26,Amazon UK,5942,Shopping,Online Retail,-68.84,GBP,-57262.51,E-Com,London,GB,4488,user_001,,
0f746376-86aa-49a3-b767-8aca4f5fe676,2026-05-24,2026-05-25,Amazon UK,5942,Shopping,Online Retail,-117.18,GBP,-57379.69,E-Com,London,GB,2219,user_001,,
7ba6fb1a-ee39-42c7-8888-53677e97e8d4,2026-05-24,2026-05-25,Sainsbury's,5411,Groceries,Supermarket,-32.5,GBP,-57412.19,POS,London,GB,1045,user_001,,
52995a2b-9703-4188-afc8-d98e10b2f524,2026-05-25,2026-05-27,Sainsbury's,5411,Groceries,Supermarket,-67.61,GBP,-57479.8,POS,London,GB,9074,user_001,,
61b23196-3c54-4f02-a51e-6e4b02f4a2e9,2026-05-25,2026-05-26,Amazon UK,5942,Shopping,Online Retail,-20.38,GBP,-57500.18,E-Com,London,GB,4488,user_002,,
9031a37c-ef09-47b3-9322-c9091176f23a,2026-05-25,2026-05-25,T212 Capital,6011,Income,Salary,3394.51,GBP,-54105.67,Credit,London,GB,9074,user_001,rec_2ff8f778d0,
92c92e7b-6756-4446-be98-d24bdc848cea,2026-05-25,2026-05-27,Pret A Manger,5814,Food & Drink,Eating Out,-8.71,GBP,-54114.38,POS,London,GB,1045,user_001,,
e9264bba-3b95-47f0-818d-3bf2d05eb66f,2026-05-25,2026-05-26,Tesco,5411,Groceries,Supermarket,-31.44,GBP,-54145.82,POS,London,GB,1045,user_001,,
c248a3d0-622a-4603-ba6d-c12ea0f03fee,2026-05-26,2026-05-27,Waitrose,5411,Groceries,Supermarket,-82.95,GBP,-54228.77,POS,London,GB,1045,user_001,,
c513b055-743b-4f10-991d-5dde91aff39f,2026-05-26,2026-05-26,Deliveroo,5812,Food & Drink,Delivery,-28.72,GBP,-54257.49,E-Com,London,GB,9074,user_001,,
720e14d4-d8d1-46e9-86d4-15f9ad01e511,2026-05-27,2026-05-27,Airline Refund,4511,Travel,Refund,7.8,GBP,-54249.69,Credit,London,GB,2219,user_001,,Refund for Local Market
e34cafb8-0fc3-4820-a782-ea5c91abedc5,2026-05-27,2026-05-28,Apple.com/bill,5734,Shopping,Electronics,-37.93,GBP,-54287.62,E-Com,Cupertino,US,9074,user_001,,
fda4a989-86af-4a76-8e2c-8c8deb555e2f,2026-05-27,2026-05-29,Shell,5541,Transport,Fuel,-62.35,GBP,-54349.97,POS,London,GB,4488,user_001,,
03ebfa7d-058b-4e19-a19c-ecb785ccc898,2026-05-28,2026-06-01,Uber UK,4121,Transport,Ride Hailing,-28.43,GBP,-54378.4,E-Com,London,GB,2219,user_001,,
017ca07c-56b4-4ebd-a3a0-f838a1e64efc,2026-05-29,2026-06-01,Amazon UK,5942,Shopping,Online Retail,-48.65,GBP,-54427.05,E-Com,London,GB,1045,user_001,,
5c398d12-3384-4a40-abbf-89b470743ee8,2026-05-29,2026-06-01,Amazon UK,5942,Shopping,Online Retail,-108.97,GBP,-54536.02,E-Com,London,GB,1045,user_001,,
64e6f4a9-6205-4707-b083-287985bb530f,2026-05-29,2026-05-29,Amazon UK,5942,Shopping,Online Retail,-119.12,GBP,-54655.14,E-Com,London,GB,1045,user_001,,
7137e0e8-3cb9-4c86-9abc-f8360178a739,2026-05-29,2026-05-29,Shell,5541,Transport,Fuel,-35.84,GBP,-54690.98,POS,London,GB,4488,user_001,,
81f4ceae-594e-41c2-a61d-e3b8c04ec68b,2026-05-30,2026-06-01,Local Market,5499,Groceries,Specialty,-11.46,GBP,-54702.44,POS,London,GB,2219,user_001,,
9f08e22c-f404-45a8-97bb-93c2fad61dcd,2026-05-30,2026-06-01,Sainsbury's,5411,Groceries,Supermarket,-31.98,GBP,-54734.42,POS,London,GB,1045,user_001,,
11273438-d083-4434-afb1-d7e3277f2b7d,2026-05-31,2026-06-01,Uber UK,4121,Transport,Ride Hailing,-20.61,GBP,-54755.03,E-Com,London,GB,1045,user_001,,
3ae7f27e-f1cc-440b-891e-711284bc63d7,2026-05-31,2026-06-01,Uber UK,4121,Transport,Ride Hailing,-33.51,GBP,-54788.54,E-Com,London,GB,1045,user_001,,
48f28c09-5031-4978-8dcd-b858e2ad9503,2026-05-31,2026-06-01,Amazon UK,5942,Shopping,Online Retail,-91.65,GBP,-54880.19,E-Com,London,GB,9074,user_001,,
68289f06-9455-4422-85e8-d80e98118f7e,2026-05-31,2026-06-01,Shell,5541,Transport,Fuel,-36.3,GBP,-54916.49,POS,London,GB,9074,user_001,,
6b1a2854-ae8a-4755-af3c-2d4a5d7f8330,2026-05-31,2026-06-01,Pret A Manger,5814,Food & Drink,Eating Out,-5.9,GBP,-54922.39,POS,London,GB,2219,user_002,,
e2298189-57bc-4df1-8144-a91e4b40f34f,2026-05-31,2026-06-01,Deliveroo,5812,Food & Drink,Delivery,-19.65,GBP,-54942.04,E-Com,London,GB,2219,user_001,,
f013fcfc-536e-47b4-9204-36d24eb01625,2026-05-31,2026-06-01,Amazon UK,5942,Shopping,Online Retail,-77.34,GBP,-55019.38,E-Com,London,GB,2219,user_001,,
fa83d5cb-94aa-46f7-a45b-521fff3fc0c6,2026-05-31,2026-06-01,Apple.com/bill,5734,Shopping,Electronics,-74.5,GBP,-55093.88,E-Com,Cupertino,US,2219,user_002,,
7be49b9e-36d9-4078-b172-87d489c51dcc,2026-06-01,2026-06-02,Crown Estates Lettings,6513,Housing,Rent,-1493.52,GBP,-56587.4,POS,London,GB,9074,user_001,rec_19f70fbcce,
03c10497-7530-41b5-881b-e360982e718a,2026-06-03,2026-06-03,Apple.com/bill,5734,Shopping,Electronics,-203.56,GBP,-56790.96,E-Com,Cupertino,US,4488,user_001,,
dd8bc782-22a4-4d3d-9724-a5246036655d,2026-06-03,2026-06-03,ATM Withdrawal,6011,Cash,ATM,-96.19,GBP,-56887.15,ATM,London,GB,9074,user_001,,
150e5833-efa9-41d6-b0a8-7384cd05176c,2026-06-04,2026-06-08,Waitrose,5411,Groceries,Supermarket,-75.54,GBP,-56962.69,POS,London,GB,4488,user_001,,
62ac5a9a-4044-4e97-a030-469c4e405f5d,2026-06-04,2026-06-04,Airline Refund,4511,Travel,Refund,3.49,GBP,-56959.2,Credit,London,GB,9074,user_001,,Refund for Pret A Manger
421fd304-88df-4392-8154-0897a053a24c,2026-06-05,2026-06-08,Apple.com/bill,5734,Shopping,Electronics,-193.0,GBP,-57152.2,E-Com,Cupertino,US,1045,user_001,,
4805bf67-7aef-44cf-9275-5f5f695a71e2,2026-06-05,2026-06-08,Pret A Manger,5814,Food & Drink,Eating Out,-10.19,GBP,-57162.39,POS,London,GB,9074,user_001,,
46febbac-15bc-44b6-8169-1bd598d7eb24,2026-06-06,2026-06-08,Shell,5541,Transport,Fuel,-79.82,GBP,-57242.21,POS,London,GB,2219,user_001,,
6f8719b7-00f2-403e-99ed-eb1aaf11be4c,2026-06-06,2026-06-08,Transport for London,4111,Transport,Transit,-5.87,GBP,-57248.08,POS,London,GB,4488,user_001,,
f058d2fd-6021-4fc9-8539-d9162db2a2cb,2026-06-06,2026-06-08,Shell,5541,Transport,Fuel,-47.63,GBP,-57295.71,POS,London,GB,2219,user_001,,
6b44a63e-8a72-40df-95f4-43adc9858d91,2026-06-07,2026-06-08,Tesco,5411,Groceries,Supermarket,-67.79,GBP,-57363.5,POS,London,GB,4488,user_001,,
a5527fe3-e979-40e6-8536-28c5b11905b0,2026-06-07,2026-06-08,Tesco,5411,Groceries,Supermarket,-64.3,GBP,-57427.8,POS,London,GB,9074,user_001,,
ce8fba76-47cb-48ff-a127-bd53fce58117,2026-06-07,2026-06-09,Amazon UK,5942,Shopping,Online Retail,-81.05,GBP,-57508.85,E-Com,London,GB,9074,user_002,,
0d2b061e-44a8-47cc-b95d-c33efd4f72e0,2026-06-08,2026-06-10,Uber UK,4121,Transport,Ride Hailing,-23.18,GBP,-57532.03,E-Com,London,GB,1045,user_001,,
a1f0fcbd-ab6e-42ee-a330-d1e4c0c3ab84,2026-06-08,2026-06-09,Octopus Energy,4900,Utilities,Electricity,-142.65,GBP,-57674.68,Direct Debit,London,GB,4488,user_001,rec_141a4a0666,
2c29aebf-b555-432c-af72-c6447abcf98c,2026-06-09,2026-06-11,Uber UK,4121,Transport,Ride Hailing,-27.62,GBP,-57702.3,E-Com,London,GB,2219,user_002,,
46cb260f-f4d6-430e-93c1-dc28d0c48131,2026-06-10,2026-06-12,Sainsbury's,5411,Groceries,Supermarket,-41.23,GBP,-57743.53,POS,London,GB,2219,user_001,,
817fcb2a-6d53-4ef1-9f95-8f77544f5f82,2026-06-10,2026-06-11,Transport for London,4111,Transport,Transit,-7.73,GBP,-57751.26,POS,London,GB,9074,user_002,,
f2deb9c2-e033-410a-a4e9-4c073d2c4357,2026-06-10,2026-06-12,Local Market,5499,Groceries,Specialty,-7.12,GBP,-57758.38,POS,London,GB,9074,user_001,,
f7517a7a-025d-47f2-8a32-8c8dad84d568,2026-06-10,2026-06-11,Waitrose,5411,Groceries,Supermarket,-38.58,GBP,-57796.96,POS,London,GB,9074,user_001,,
24b3a6a5-1e9f-46ba-a519-f22d6d60b90c,2026-06-11,2026-06-11,Transport for London,4111,Transport,Transit,-9.2,GBP,-57806.16,POS,London,GB,2219,user_002,,
581ecb48-ef50-44af-b993-0df6215617e9,2026-06-11,2026-06-12,Local Market,5499,Groceries,Specialty,-17.96,GBP,-57824.12,POS,London,GB,1045,user_001,,
b0c2cba0-e88c-4c03-b69a-5049424e1f4a,2026-06-11,2026-06-15,Thames Water,4900,Utilities,Water,-38.03,GBP,-57862.15,Direct Debit,Reading,GB,1045,user_002,rec_954d02400c,
248a6ca0-0e62-4314-96af-4522c8d0d3dd,2026-06-12,2026-06-15,Sainsbury's,5411,Groceries,Supermarket,-65.25,GBP,-57927.4,POS,London,GB,4488,user_001,,
7aae09e2-66b9-42c0-a4a8-0d88e1e5cac6,2026-06-12,2026-06-15,Shell,5541,Transport,Fuel,-32.39,GBP,-57959.79,POS,London,GB,1045,user_001,,
c616b2c0-ebbe-46ec-9da8-4ee511b72250,2026-06-12,2026-06-12,British Airways,4511,Travel,Flights,-476.75,USD,-58436.54,E-Com,London,GB,9074,user_001,,Business travel
736edd4b-5a5b-46ff-b85a-59c90ee42421,2026-06-13,2026-06-15,Sainsbury's,5411,Groceries,Supermarket,-16.61,GBP,-58453.15,POS,London,GB,2219,user_002,,
a6e8a6f2-447c-4755-9db5-0798e1febc2b,2026-06-13,2026-06-15,Shell,5541,Transport,Fuel,-65.13,GBP,-58518.28,POS,London,GB,9074,user_001,,
a7c38285-2b76-49a9-9611-bdd732c48d62,2026-06-13,2026-06-15,Local Market,5499,Groceries,Specialty,-11.6,GBP,-58529.88,POS,London,GB,4488,user_001,,
b06d7dac-832b-4fad-aaf2-8f46b1ba3af4,2026-06-13,2026-06-15,Transport for London,4111,Transport,Transit,-5.14,GBP,-58535.02,POS,London,GB,4488,user_001,,
f43f4fd1-2e84-4b8f-b881-cc5ab11a2168,2026-06-13,2026-06-15,Tesco,5411,Groceries,Supermarket,-75.85,GBP,-58610.87,POS,London,GB,9074,user_001,,
60f4ba5a-e3d7-4ec3-b96a-eb2b8459e6cb,2026-06-14,2026-06-15,Tesco,5411,Groceries,Supermarket,-53.85,GBP,-58664.72,POS,London,GB,2219,user_001,,
6215ab8a-0ce9-43cd-b551-895371ea91c4,2026-06-14,2026-06-16,Waitrose,5411,Groceries,Supermarket,-50.55,GBP,-58715.27,POS,London,GB,4488,user_002,,
bf441680-cd98-45fc-86a7-3bbb2f8826e0,2026-06-14,2026-06-15,Deliveroo,5812,Food & Drink,Delivery,-24.03,GBP,-58739.3,E-Com,London,GB,1045,user_001,,
562a17ca-ce08-45fb-84b9-b8c7ffba3d7a,2026-06-15,2026-06-17,City Council Tax,9399,Utilities,Council Tax,-180.55,GBP,-58919.85,Direct Debit,London,GB,1045,user_001,rec_f531495db5,
dd40d242-153c-47bb-a397-8f2a60a1f15a,2026-06-15,2026-06-17,Waitrose,5411,Groceries,Supermarket,-74.19,GBP,-58994.04,POS,London,GB,2219,user_001,,
dee4eaf3-81aa-480f-9c42-e9ee0f76ab76,2026-06-15,2026-06-15,O2 UK,4814,Bills,Mobile,-52.12,GBP,-59046.16,Direct Debit,Slough,GB,1045,user_001,rec_95042d8101,
226004c5-167f-4df0-a9ea-2b3094723cac,2026-06-17,2026-06-18,Shell,5541,Transport,Fuel,-41.46,GBP,-59087.62,POS,London,GB,9074,user_001,,
9c3c5339-79fd-471f-a35d-64f3e2b57afb,2026-06-17,2026-06-18,Tesco,5411,Groceries,Supermarket,-75.69,GBP,-59163.31,POS,London,GB,1045,user_001,,
c202fa86-fc3c-4a09-bfa1-572599d38bf6,2026-06-17,2026-06-17,GymBox,7997,Wellness,Gym,-49.71,GBP,-59213.02,Direct Debit,London,GB,4488,user_001,rec_3906953fd2,
dd44936f-2a90-44e9-8cd5-be1997e31e6e,2026-06-17,2026-06-19,Amazon UK,5942,Shopping,Online Retail,-20.86,GBP,-59233.88,E-Com,London,GB,4488,user_002,,
2afd378a-83f6-4757-9abe-f46d8dc9b553,2026-06-19,2026-06-22,Amazon UK,5942,Shopping,Online Retail,-106.25,GBP,-59340.13,E-Com,London,GB,2219,user_001,,
d14b128a-85e2-469a-8982-f1202beb282b,2026-06-19,2026-06-19,Tesco,5411,Groceries,Supermarket,-31.94,GBP,-59372.07,POS,London,GB,1045,user_001,,
d824629b-dd3a-4e86-b82f-26d4bcfeafee,2026-06-19,2026-06-22,Spotify,5735,Entertainment,Subscriptions,-8.69,GBP,-59380.76,E-Com,Stockholm,SE,2219,user_001,rec_4c746d2c3b,
04218e71-ff43-42af-b8ed-f6d2399a3f61,2026-06-20,2026-06-22,Apple.com/bill,5734,Shopping,Electronics,-165.69,GBP,-59546.45,E-Com,Cupertino,US,1045,user_001,,
13120486-34be-48f3-b3d0-b8d4a7b8270d,2026-06-20,2026-06-22,Local Market,5499,Groceries,Specialty,-17.21,GBP,-59563.66,POS,London,GB,1045,user_001,,
4891a5b9-f3a3-4b58-ae54-ec47363db48c,2026-06-20,2026-06-22,Apple.com/bill,5734,Shopping,Electronics,-57.77,GBP,-59621.43,E-Com,Cupertino,US,9074,user_001,,
66105187-e6a9-43f5-8065-5df283a33624,2026-06-20,2026-06-22,Pret A Manger,5814,Food & Drink,Eating Out,-10.91,GBP,-59632.34,POS,London,GB,9074,user_001,,
411e6b53-d9ad-4614-a18e-4a2fd89e2bdb,2026-06-21,2026-06-23,Shell,5541,Transport,Fuel,-62.91,GBP,-59695.25,POS,London,GB,2219,user_001,,
55ce03b9-035f-471b-818e-30a60ccccdd9,2026-06-21,2026-06-22,Uber UK,4121,Transport,Ride Hailing,-31.54,GBP,-59726.79,E-Com,London,GB,1045,user_001,,
65b90d96-5f3c-42e5-9a19-f6b40d9e598c,2026-06-21,2026-06-23,Uber UK,4121,Transport,Ride Hailing,-35.29,GBP,-59762.08,E-Com,London,GB,9074,user_001,,
8ac7d288-b235-4141-ad21-f930a9a2de21,2026-06-21,2026-06-22,Deliveroo,5812,Food & Drink,Delivery,-23.46,GBP,-59785.54,E-Com,London,GB,9074,user_001,,
abfd54a9-0bad-4d43-964f-8080998912db,2026-06-21,2026-06-22,Uber UK,4121,Transport,Ride Hailing,-8.92,GBP,-59794.46,E-Com,London,GB,2219,user_001,,
cd1f3820-6bd9-4577-9da3-0237c2ff262d,2026-06-21,2026-06-23,Pret A Manger,5814,Food & Drink,Eating Out,-10.14,GBP,-59804.6,POS,London,GB,1045,user_001,,
7eaadcd7-5486-41f5-b985-323695833274,2026-06-22,2026-06-23,Netflix,7841,Entertainment,Subscriptions,-11.89,USD,-59816.49,E-Com,Los Gatos,US,4488,user_002,rec_d9322c1382,FX purchase 14.72 USD @ rate 1.24
2a88339d-5a10-4fc2-b2a4-7c9061375279,2026-06-23,2026-06-23,Tesco,5411,Groceries,Supermarket,-21.83,GBP,-59838.32,POS,London,GB,2219,user_001,,
d29fe7c8-1436-44f4-8e06-73e7ffc8dcc1,2026-06-23,2026-06-24,Waitrose,5411,Groceries,Supermarket,-77.87,GBP,-59916.19,POS,London,GB,1045,user_001,,
3acc5373-edf8-49a1-a1ac-8bfd9f352206,2026-06-24,2026-06-25,Deliveroo,5812,Food & Drink,Delivery,-22.35,GBP,-59938.54,E-Com,London,GB,9074,user_001,,
d4e17184-56f4-48d1-8edd-aeb676e6a7d6,2026-06-24,2026-06-25,Apple.com/bill,5734,Shopping,Electronics,-32.23,USD,-59970.77,E-Com,Cupertino,US,2219,user_001,,FX purchase 40.11 USD @ rate 1.24
dc14d161-459b-4d15-9222-92b48cf29591,2026-06-24,2026-06-24,Sainsbury's,5411,Groceries,Supermarket,-17.91,GBP,-59988.68,POS,London,GB,2219,user_001,,
0acae56a-4a5b-4799-a747-3ba027ad332b,2026-06-25,2026-06-25,Transport for London,4111,Transport,Transit,-7.62,GBP,-59996.3,POS,London,GB,2219,user_001,,
5f26fb75-a45e-4932-b1fe-c457d651db4e,2026-06-25,2026-06-29,Apple.com/bill,5734,Shopping,Electronics,-41.19,GBP,-60037.49,E-Com,Cupertino,US,9074,user_002,,
785586dc-b9fa-4c00-a73e-0be54189cbde,2026-06-25,2026-06-26,Local Market,5499,Groceries,Specialty,-12.62,GBP,-60050.11,POS,London,GB,4488,user_001,,
91c80eba-f2f6-47eb-b264-b3e997ea9662,2026-06-25,2026-06-25,T212 Capital,6011,Income,Salary,2945.47,GBP,-57104.64,Credit,London,GB,1045,user_002,rec_c649d24d0f,
aa856093-7eaf-419f-8542-f4c0adaf1998,2026-06-25,2026-06-25,Apple.com/bill,5734,Shopping,Electronics,-34.88,GBP,-57139.52,E-Com,Cupertino,US,2219,user_001,,
b30b4832-7be6-4e81-99f0-72d37c5c8e99,2026-06-25,2026-06-25,Tesco,5411,Groceries,Supermarket,-58.09,GBP,-57197.61,POS,London,GB,4488,user_001,,
c89f4fa1-2534-4b30-8a77-5054f3869573,2026-06-25,2026-06-26,Uber UK,4121,Transport,Ride Hailing,-26.89,GBP,-57224.5,E-Com,London,GB,9074,user_001,,
1e0dbf4a-2b0e-4780-aca0-4606e59d9b04,2026-06-27,2026-06-29,Local Market,5499,Groceries,Specialty,-16.31,GBP,-57240.81,POS,London,GB,4488,user_001,,
34fc25bf-c89e-4710-b022-b304f3fc9dea,2026-06-27,2026-06-29,Shell,5541,Transport,Fuel,-45.28,GBP,-57286.09,POS,London,GB,9074,user_001,,
7146edbf-0d1e-40bc-b9e9-d37cb37acefa,2026-06-27,2026-06-29,Shell,5541,Transport,Fuel,-43.76,GBP,-57329.85,POS,London,GB,2219,user_001,,
979c20f2-c8b4-4698-afb0-0d2b5ececc3a,2026-06-27,2026-06-29,Local Market,5499,Groceries,Specialty,-20.65,GBP,-57350.5,POS,London,GB,4488,user_001,,
caa036fc-2442-4477-8932-3e9f95b4d23c,2026-06-27,2026-06-29,Local Market,5499,Groceries,Specialty,-10.93,GBP,-57361.43,POS,London,GB,4488,user_002,,
17d2c3d5-bf18-4a25-8724-40cee0c7fd78,2026-06-28,2026-06-29,Tesco,5411,Groceries,Supermarket,-29.89,GBP,-57391.32,POS,London,GB,1045,user_002,,
88fdf156-0407-4157-9f2e-feeb5e0ab44b,2026-06-28,2026-06-29,Waitrose,5411,Groceries,Supermarket,-51.75,GBP,-57443.07,POS,London,GB,2219,user_001,,
9fbbd382-840c-48ce-aaad-c74be6c042d8,2026-06-28,2026-06-30,Shell,5541,Transport,Fuel,-74.86,GBP,-57517.93,POS,London,GB,2219,user_001,,
da6d474f-645e-412c-b8a1-5a954daec77b,2026-06-28,2026-06-29,Waitrose,5411,Groceries,Supermarket,-80.54,GBP,-57598.47,POS,London,GB,2219,user_001,,
6769bcfc-c9ad-4652-836c-760fa87297f0,2026-06-29,2026-07-01,Transport for London,4111,Transport,Transit,-9.19,GBP,-57607.66,POS,London,GB,2219,user_001,,
7dd43481-16b6-4c31-9a59-8b3d57e41307,2026-06-29,2026-06-30,Amazon UK,5942,Shopping,Online Retail,-102.68,GBP,-57710.34,E-Com,London,GB,2219,user_001,,
3f531230-335e-46ab-97ed-52e0ccf0d2b2,2026-06-30,2026-07-02,Pret A Manger,5814,Food & Drink,Eating Out,-11.61,GBP,-57721.95,POS,London,GB,2219,user_001,,
610c5cb7-9709-463f-95d1-bc5723560358,2026-06-30,2026-07-01,Waitrose,5411,Groceries,Supermarket,-42.59,GBP,-57764.54,POS,London,GB,9074,user_001,,
0ce14ba5-d7a4-4270-a250-5707913055c2,2026-07-01,2026-07-01,ATM Withdrawal,6011,Cash,ATM,-80.93,GBP,-57845.47,ATM,London,GB,9074,user_001,,
c8d41730-538b-4387-893e-9f0a5459c652,2026-07-01,2026-07-01,Deliveroo,5812,Food & Drink,Delivery,-13.19,GBP,-57858.66,E-Com,London,GB,4488,user_001,,
dc8946f3-d6da-4a7e-b8c6-5b860a3a9eaf,2026-07-01,2026-07-03,Crown Estates Lettings,6513,Housing,Rent,-1563.5,GBP,-59422.16,POS,London,GB,2219,user_001,rec_19f70fbcce,
9c126c12-d709-4ac8-8356-e6e28725c637,2026-07-02,2026-07-06,ATM Withdrawal,6011,Cash,ATM,-78.45,GBP,-59500.61,ATM,London,GB,1045,user_001,,
b7b4620d-0d9f-4dfa-bb8b-1def53ebe78a,2026-07-02,2026-07-06,Apple.com/bill,5734,Shopping,Electronics,-154.5,GBP,-59655.11,E-Com,Cupertino,US,9074,user_001,,
26b10726-0e38-4651-bd8c-ecbeafb24300,2026-07-04,2026-07-06,Amazon UK,5942,Shopping,Online Retail,-37.81,GBP,-59692.92,E-Com,London,GB,9074,user_001,,
65353b00-a6fd-44d5-b586-70799305fbd1,2026-07-04,2026-07-06,Shell,5541,Transport,Fuel,-72.31,GBP,-59765.23,POS,London,GB,4488,user_001,,
81362f90-9845-40f8-9d37-6a5e48371535,2026-07-04,2026-07-06,Deliveroo,5812,Food & Drink,Delivery,-13.58,GBP,-59778.81,E-Com,London,GB,1045,user_001,,
bed366e3-6ba5-41af-a511-222d30a983bb,2026-07-04,2026-07-06,Uber UK,4121,Transport,Ride Hailing,-25.19,GBP,-59804.0,E-Com,London,GB,9074,user_001,,
d21cc262-fe1e-4c83-b5fc-a3a4ba681679,2026-07-04,2026-07-06,Apple.com/bill,5734,Shopping,Electronics,-130.48,GBP,-59934.48,E-Com,Cupertino,US,2219,user_001,,
e7050b44-b0bd-434f-9f3c-2493201c99d4,2026-07-04,2026-07-06,Pret A Manger,5814,Food & Drink,Eating Out,-8.1,GBP,-59942.58,POS,London,GB,1045,user_001,,
3c986f96-07c1-44f4-a625-e1290f5e9264,2026-07-05,2026-07-07,Sainsbury's,5411,Groceries,Supermarket,-31.85,GBP,-59974.43,POS,London,GB,9074,user_001,,
d1b73db2-2174-4739-bc70-63fb431d9715,2026-07-05,2026-07-07,Pret A Manger,5814,Food & Drink,Eating Out,-6.78,GBP,-59981.21,POS,London,GB,2219,user_001,,
8a9d043e-e25b-4a7a-84cc-a180f4b749c6,2026-07-06,2026-07-08,Deliveroo,5812,Food & Drink,Delivery,-20.81,GBP,-60002.02,E-Com,London,GB,2219,user_001,,
b320dbb5-00dd-40e1-8d00-ad3cbf52aa70,2026-07-06,2026-07-08,Amazon UK,5942,Shopping,Online Retail,-54.25,GBP,-60056.27,E-Com,London,GB,4488,user_001,,
83d5894b-279f-4f82-ab22-3deff3216dab,2026-07-07,2026-07-08,Octopus Energy,4900,Utilities,Electricity,-143.23,GBP,-60199.5,Direct Debit,London,GB,9074,user_002,rec_09c3f12b18,
dca1f5e1-900b-4354-b159-5c657607c55a,2026-07-09,2026-07-10,Sainsbury's,5411,Groceries,Supermarket,-33.64,GBP,-60233.14,POS,London,GB,9074,user_001,,
e3025d31-f672-4e26-9f1d-8069150f98ee,2026-07-09,2026-07-10,Sainsbury's,5411,Groceries,Supermarket,-60.09,GBP,-60293.23,POS,London,GB,2219,user_001,,
f72981c3-546e-4ec3-a9af-d97b27c467d0,2026-07-09,2026-07-13,Tesco,5411,Groceries,Supermarket,-28.86,GBP,-60322.09,POS,London,GB,9074,user_001,,
3664bc78-f565-4a5f-a0d9-e6e69bac55f4,2026-07-10,2026-07-10,Apple.com/bill,5734,Shopping,Electronics,-19.13,GBP,-60341.22,E-Com,Cupertino,US,2219,user_001,,
9395e052-49d6-4666-93c6-2013ed3c4f1e,2026-07-10,2026-07-13,Sainsbury's,5411,Groceries,Supermarket,-50.98,GBP,-60392.2,POS,London,GB,4488,user_001,,
15fdfeca-edab-4065-a29a-ec2cc7232e00,2026-07-11,2026-07-13,Transport for London,4111,Transport,Transit,-10.01,GBP,-60402.21,POS,London,GB,2219,user_001,,
1e794ddf-295b-47a2-9db2-632c103c64f2,2026-07-11,2026-07-13,Sainsbury's,5411,Groceries,Supermarket,-22.26,GBP,-60424.47,POS,London,GB,4488,user_002,,
28e38bae-cf3e-4344-9b70-b120eb1e9499,2026-07-11,2026-07-13,Tesco,5411,Groceries,Supermarket,-73.82,GBP,-60498.29,POS,London,GB,1045,user_001,,
686c33bf-26b8-414d-8af8-4cfdf5b78b4b,2026-07-11,2026-07-13,Shell,5541,Transport,Fuel,-87.19,GBP,-60585.48,POS,London,GB,2219,user_002,,
ce175d9c-e445-4e42-9169-8f227c781433,2026-07-11,2026-07-13,Shell,5541,Transport,Fuel,-81.06,GBP,-60666.54,POS,London,GB,2219,user_002,,
0e6126fe-fec4-4a6e-8ab3-1cf9bb679c6d,2026-07-12,2026-07-13,Waitrose,5411,Groceries,Supermarket,-75.37,GBP,-60741.91,POS,London,GB,2219,user_001,,
2059b030-d72a-4b63-9cc1-dcd926449e3d,2026-07-12,2026-07-13,Tesco,5411,Groceries,Supermarket,-64.64,GBP,-60806.55,POS,London,GB,2219,user_002,,
55264e9b-1726-4047-9d23-407e8e4ff545,2026-07-12,2026-07-14,Transport for London,4111,Transport,Transit,-8.68,GBP,-60815.23,POS,London,GB,1045,user_001,,
944dee15-3176-4059-8e9b-e46214df2396,2026-07-12,2026-07-14,Amazon UK,5942,Shopping,Online Retail,-30.39,GBP,-60845.62,E-Com,London,GB,2219,user_001,,
98c86a4e-0660-4ffb-8685-dd868f9cae16,2026-07-12,2026-07-13,Apple.com/bill,5734,Shopping,Electronics,-24.67,USD,-60870.29,E-Com,Cupertino,US,4488,user_001,,FX purchase 30.52 USD @ rate 1.24
017f349f-ea0b-485e-ba72-0480c312eaf9,2026-07-13,2026-07-15,City Council Tax,9399,Utilities,Council Tax,-166.19,GBP,-61036.48,Direct Debit,London,GB,1045,user_001,rec_f531495db5,
6cfcda62-884f-4559-bbf9-c88e3992c163,2026-07-13,2026-07-14,Thames Water,4900,Utilities,Water,-34.19,GBP,-61070.67,Direct Debit,Reading,GB,4488,user_001,rec_3a34d62842,
77520834-c50f-4c3c-9115-b1473541a4f8,2026-07-13,2026-07-13,Waitrose,5411,Groceries,Supermarket,-66.24,GBP,-61136.91,POS,London,GB,2219,user_001,,
ca7a886a-c30e-4ef3-a746-294a5a75a54e,2026-07-13,2026-07-15,Tesco,5411,Groceries,Supermarket,-72.9,GBP,-61209.81,POS,London,GB,2219,user_001,,
e359fe0c-82f4-4b73-a9e2-d3f815b5e7c2,2026-07-13,2026-07-13,Deliveroo,5812,Food & Drink,Delivery,-24.61,GBP,-61234.42,E-Com,London,GB,4488,user_001,,
9a3c40d7-731b-4d6c-814e-edfb38dbfd5b,2026-07-14,2026-07-16,Shell,5541,Transport,Fuel,-85.74,GBP,-61320.16,POS,London,GB,9074,user_001,,
b3a55e1e-3476-411b-97e9-e2c04c77e892,2026-07-14,2026-07-15,Tesco,5411,Groceries,Supermarket,-68.79,GBP,-61388.95,POS,London,GB,2219,user_001,,
d1cd8b17-5c92-4ba1-907c-1ac56cef196b,2026-07-15,2026-07-17,ATM Withdrawal,6011,Cash,ATM,-77.71,GBP,-61466.66,ATM,London,GB,9074,user_001,,
f17f1dff-141f-47d4-ab08-b98deb77c769,2026-07-15,2026-07-16,Transport for London,4111,Transport,Transit,-9.1,GBP,-61475.76,POS,London,GB,4488,user_002,,
f2b6f5b6-91f0-44d9-99db-a05c542cfc63,2026-07-15,2026-07-15,O2 UK,4814,Bills,Mobile,-40.27,GBP,-61516.03,Direct Debit,Slough,GB,2219,user_001,rec_95042d8101,
2b7f9f42-4aac-4b99-b25c-5d1a0c6f2314,2026-07-16,2026-07-17,Apple.com/bill,5734,Shopping,Electronics,-143.05,GBP,-61659.08,E-Com,Cupertino,US,4488,user_002,,
c2f736d9-41da-4f7b-8417-b50e7f206970,2026-07-16,2026-07-17,Deliveroo,5812,Food & Drink,Delivery,-30.76,GBP,-61689.84,E-Com,London,GB,1045,user_001,,
38f62407-079d-4794-9962-9e335d269502,2026-07-17,2026-07-20,Pret A Manger,5814,Food & Drink,Eating Out,-5.66,GBP,-61695.5,POS,London,GB,2219,user_001,,
5e95c6d1-b644-473e-9820-6f29e0ed5c00,2026-07-17,2026-07-17,HM Revenue & Customs,9311,Income,Tax Refund,56.96,GBP,-61638.54,Credit,London,GB,2219,user_001,,Refund for ATM Withdrawal
5f5ea85e-5cfc-43d8-b708-8386f5575820,2026-07-17,2026-07-20,GymBox,7997,Wellness,Gym,-45.83,GBP,-61684.37,Direct Debit,London,GB,9074,user_001,rec_3906953fd2,
6ea9371e-3ae7-44e4-8362-76541160226d,2026-07-17,2026-07-20,ATM Withdrawal,6011,Cash,ATM,-111.83,GBP,-61796.2,ATM,London,GB,9074,user_001,,
0b69f0c4-275a-40c4-a018-44f74ea4b7df,2026-07-18,2026-07-20,Shell,5541,Transport,Fuel,-43.66,GBP,-61839.86,POS,London,GB,1045,user_001,,
491cd884-838e-4efb-a7f8-040853f0dbe7,2026-07-18,2026-07-20,Shell,5541,Transport,Fuel,-90.45,GBP,-61930.31,POS,London,GB,4488,user_001,,
bfe458ce-1d98-4ce5-8585-0d0ec607c49a,2026-07-18,2026-07-20,Deliveroo,5812,Food & Drink,Delivery,-22.71,GBP,-61953.02,E-Com,London,GB,4488,user_001,,
ec06565a-c7e0-4af0-89a5-4483e475116b,2026-07-18,2026-07-20,Local Market,5499,Groceries,Specialty,-16.41,GBP,-61969.43,POS,London,GB,2219,user_001,,
88911907-c889-4a91-81e3-169c375b9be9,2026-07-19,2026-07-20,Pret A Manger,5814,Food & Drink,Eating Out,-10.56,GBP,-61979.99,POS,London,GB,9074,user_001,,
069ce4d6-e5f3-4329-ac5f-ae86cf8117a5,2026-07-20,2026-07-20,Sainsbury's,5411,Groceries,Supermarket,-24.75,GBP,-62004.74,POS,London,GB,4488,user_001,,
9b30006e-91aa-4a5b-9392-8df43096ad46,2026-07-20,2026-07-22,Tesco,5411,Groceries,Supermarket,-42.51,GBP,-62047.25,POS,London,GB,4488,user_001,,
f3ea799f-d75b-4efd-ab64-52d4c2176837,2026-07-20,2026-07-22,Spotify,5735,Entertainment,Subscriptions,-9.31,GBP,-62056.56,E-Com,Stockholm,SE,1045,user_001,rec_4c746d2c3b,
fa0a3fb6-58df-4532-831e-c334f5b22d4b,2026-07-20,2026-07-20,Tesco,5411,Groceries,Supermarket,-77.43,GBP,-62133.99,POS,London,GB,4488,user_001,,
243720be-098a-47c4-8a71-3cf0e9048121,2026-07-21,2026-07-22,Transport for London,4111,Transport,Transit,-10.59,GBP,-62144.58,POS,London,GB,2219,user_001,,
72d52b54-e4fc-4bb4-8fcf-14cddf64ac5a,2026-07-21,2026-07-23,Apple.com/bill,5734,Shopping,Electronics,-62.86,GBP,-62207.44,E-Com,Cupertino,US,1045,user_001,,
76cdd64f-48f6-4001-b162-76090904e70f,2026-07-21,2026-07-23,Uber UK,4121,Transport,Ride Hailing,-11.4,GBP,-62218.84,E-Com,London,GB,2219,user_001,,
874973b1-0617-4fce-a446-49679a491073,2026-07-21,2026-07-21,Netflix,7841,Entertainment,Subscriptions,-12.49,GBP,-62231.33,E-Com,Los Gatos,US,2219,user_001,rec_1bfe33738d,
d85d7815-a8eb-49e4-a4a4-301b9986e767,2026-07-21,2026-07-22,Waitrose,5411,Groceries,Supermarket,-71.91,GBP,-62303.24,POS,London,GB,9074,user_001,,
a33f96c9-c34b-4c6f-a711-2a50e0dcd4a1,2026-07-23,2026-07-27,Waitrose,5411,Groceries,Supermarket,-81.47,GBP,-62384.71,POS,London,GB,1045,user_002,,
20bf0e32-a46a-468b-981b-a252381ac8b0,2026-07-24,2026-07-27,Waitrose,5411,Groceries,Supermarket,-35.9,GBP,-62420.61,POS,London,GB,2219,user_001,,
64b3bdbe-f368-4280-9911-808092c1e4df,2026-07-24,2026-07-27,Uber UK,4121,Transport,Ride Hailing,-33.56,GBP,-62454.17,E-Com,London,GB,4488,user_001,,
663457c9-3a71-49c1-8f6b-3c56397088b1,2026-07-24,2026-07-24,Amazon UK,5942,Shopping,Online Retail,-92.37,GBP,-62546.54,E-Com,London,GB,1045,user_001,,
9e6d9d79-5ea0-40f3-82a3-f86af1ec364f,2026-07-24,2026-07-27,Tesco,5411,Groceries,Supermarket,-70.76,GBP,-62617.3,POS,London,GB,9074,user_001,,
e38783c4-5d04-46e5-a3ad-9c871d55b035,2026-07-24,2026-07-24,T212 Capital,6011,Income,Salary,3306.86,GBP,-59310.44,Credit,London,GB,1045,user_001,rec_2ff8f778d0,
2c6a90b3-52b6-404b-99ac-54efa2f9f07c,2026-07-25,2026-07-27,Uber UK,4121,Transport,Ride Hailing,-30.86,GBP,-59341.3,E-Com,London,GB,4488,user_001,,
766c1503-2508-44f0-95c4-fe6e9668bff2,2026-07-25,2026-07-27,Transport for London,4111,Transport,Transit,-9.73,GBP,-59351.03,POS,London,GB,4488,user_001,,
bfaca8cf-f3f5-467a-823f-b5be46d907f0,2026-07-25,2026-07-27,Local Market,5499,Groceries,Specialty,-12.74,GBP,-59363.77,POS,London,GB,2219,user_002,,
ef993dd2-baee-45cf-ac27-b39a1ea69283,2026-07-25,2026-07-27,Waitrose,5411,Groceries,Supermarket,-80.58,GBP,-59444.35,POS,London,GB,1045,user_001,,
5fd3f210-f85b-4f14-b946-6ef512518507,2026-07-26,2026-07-27,Transport for London,4111,Transport,Transit,-10.06,GBP,-59454.41,POS,London,GB,1045,user_001,,
66ba0b04-41b5-45ab-a139-f5d9445d0bd6,2026-07-26,2026-07-27,Deliveroo,5812,Food & Drink,Delivery,-21.43,GBP,-59475.84,E-Com,London,GB,1045,user_001,,
74e991fa-b1f6-41c6-af26-5b9da6ef61ad,2026-07-26,2026-07-27,Waitrose,5411,Groceries,Supermarket,-53.43,GBP,-59529.27,POS,London,GB,9074,user_001,,
4768d641-a3c9-4805-ab46-228795c4da7d,2026-07-28,2026-07-30,Tesco,5411,Groceries,Supermarket,-57.47,GBP,-59586.74,POS,London,GB,2219,user_002,,
af1048fa-eed7-4e71-bc63-aba15cd3e203,2026-07-28,2026-07-28,Pret A Manger,5814,Food & Drink,Eating Out,-6.89,GBP,-59593.63,POS,London,GB,9074,user_001,,
d3f6fb2c-978a-4a0a-b838-6393d99bd403,2026-07-28,2026-07-30,Uber UK,4121,Transport,Ride Hailing,-22.91,GBP,-59616.54,E-Com,London,GB,9074,user_001,,
039418a6-e362-4f62-b1ce-9a973da966da,2026-07-30,2026-07-30,Uber UK,4121,Transport,Ride Hailing,-30.2,GBP,-59646.74,E-Com,London,GB,4488,user_001,,
7cfda40f-8254-4a1f-925f-0b7cc574b725,2026-07-31,2026-08-03,Apple.com/bill,5734,Shopping,Electronics,-104.04,USD,-59750.78,E-Com,Cupertino,US,4488,user_001,,FX purchase 131.22 USD @ rate 1.26
039767d6-5992-43e3-9218-184d22c832f6,2026-08-01,2026-08-03,Waitrose,5411,Groceries,Supermarket,-43.73,GBP,-59794.51,POS,London,GB,2219,user_001,,
1b85629d-21a7-4eb7-8a2c-62b8a839626f,2026-08-01,2026-08-03,Shell,5541,Transport,Fuel,-78.74,GBP,-59873.25,POS,London,GB,2219,user_001,,
944e8338-f937-4707-9f29-486350e9d1c2,2026-08-01,2026-08-03,Deliveroo,5812,Food & Drink,Delivery,-17.52,GBP,-59890.77,E-Com,London,GB,9074,user_002,,
5fb53481-4f9d-4dc5-9f41-358ea186fc29,2026-08-02,2026-08-04,Sainsbury's,5411,Groceries,Supermarket,-69.17,GBP,-59959.94,POS,London,GB,1045,user_001,,
67abd2c7-79f9-46ca-91e1-32fa06e8ba94,2026-08-02,2026-08-03,Waitrose,5411,Groceries,Supermarket,-73.98,GBP,-60033.92,POS,London,GB,4488,user_001,,
7c1399a0-9501-4e6c-a669-4e5ab58edc28,2026-08-02,2026-08-03,Airline Refund,4511,Travel,Refund,7.65,GBP,-60026.27,Credit,London,GB,4488,user_001,,Refund for Transport for London
b4007faf-0533-472f-8257-1edb2aad602e,2026-08-02,2026-08-03,Shell,5541,Transport,Fuel,-62.26,GBP,-60088.53,POS,London,GB,2219,user_001,,
110f2d28-cd8c-4fe3-9abf-f424192a325d,2026-08-03,2026-08-05,Shell,5541,Transport,Fuel,-51.74,GBP,-60140.27,POS,London,GB,1045,user_001,,
17ac80dc-88d9-4d06-8b45-7f470e34b0fe,2026-08-03,2026-08-05,Deliveroo,5812,Food & Drink,Delivery,-16.12,GBP,-60156.39,E-Com,London,GB,2219,user_001,,
804770b4-ca47-42ee-aa13-1714f91664fd,2026-08-03,2026-08-04,Local Market,5499,Groceries,Specialty,-10.53,GBP,-60166.92,POS,London,GB,2219,user_001,,
fb41ef5b-0a6d-412a-b9ad-bf27a02deac3,2026-08-03,2026-08-05,Crown Estates Lettings,6513,Housing,Rent,-1584.6,GBP,-61751.52,POS,London,GB,1045,user_001,rec_19f70fbcce,
5f3abb66-9a7c-4c00-9446-0403a5e0a624,2026-08-04,2026-08-05,Uber UK,4121,Transport,Ride Hailing,-30.68,GBP,-61782.2,E-Com,London,GB,9074,user_001,,
bbeaad35-6fa2-4b8a-aa5a-5a5316a90f0e,2026-08-04,2026-08-05,Local Market,5499,Groceries,Specialty,-19.09,GBP,-61801.29,POS,London,GB,4488,user_001,,
27c5dfed-1619-4af3-9ce1-f1a751fadf95,2026-08-05,2026-08-06,Pret A Manger,5814,Food & Drink,Eating Out,-11.01,GBP,-61812.3,POS,London,GB,9074,user_002,,
595055cf-4994-45e6-a749-8ba30bbe7257,2026-08-05,2026-08-06,Sainsbury's,5411,Groceries,Supermarket,-38.29,GBP,-61850.59,POS,London,GB,2219,user_001,,
fb7c305c-8638-462b-b627-37a84f37b993,2026-08-06,2026-08-07,Transport for London,4111,Transport,Transit,-6.01,GBP,-61856.6,POS,London,GB,9074,user_002,,
0adcee05-89c6-4d8b-896f-43a4d255c8ac,2026-08-07,2026-08-10,Octopus Energy,4900,Utilities,Electricity,-119.63,GBP,-61976.23,Direct Debit,London,GB,4488,user_001,rec_141a4a0666,
746bf38c-0cec-4ea3-93ea-e0ee57252f90,2026-08-07,2026-08-10,Deliveroo,5812,Food & Drink,Delivery,-16.65,GBP,-61992.88,E-Com,London,GB,9074,user_001,,
7f307c69-7438-4644-a1dc-3b2ad0363d94,2026-08-07,2026-08-07,Deliveroo,5812,Food & Drink,Delivery,-33.43,GBP,-62026.31,E-Com,London,GB,2219,user_001,,
33a0e615-1fa2-4689-81fb-849fd81b2025,2026-08-08,2026-08-10,Sainsbury's,5411,Groceries,Supermarket,-27.32,GBP,-62053.63,POS,London,GB,9074,user_001,,
67fba2f5-168f-42b0-a670-ecedf0b1fdfb,2026-08-09,2026-08-11,Tesco,5411,Groceries,Supermarket,-77.26,GBP,-62130.89,POS,London,GB,4488,user_001,,
4451d11f-42ae-49ff-bcb5-5107342d0f29,2026-08-10,2026-08-12,Local Market,5499,Groceries,Specialty,-14.49,GBP,-62145.38,POS,London,GB,1045,user_001,,
d346a464-72d9-462e-94d8-a1bf4d9f964e,2026-08-11,2026-08-12,Deliveroo,5812,Food & Drink,Delivery,-32.25,GBP,-62177.63,E-Com,London,GB,9074,user_001,,
fbc4ae45-ec3a-41a2-95f8-fa19b3adb3c5,2026-08-11,2026-08-13,Thames Water,4900,Utilities,Water,-35.74,GBP,-62213.37,Direct Debit,Reading,GB,9074,user_001,rec_3a34d62842,
0a2a472b-01fc-488d-bd7b-9e433a6af051,2026-08-12,2026-08-13,Waitrose,5411,Groceries,Supermarket,-32.23,GBP,-62245.6,POS,London,GB,4488,user_001,,
2ee1618a-fabe-4095-ac43-02fc094e85ec,2026-08-12,2026-08-13,Sainsbury's,5411,Groceries,Supermarket,-19.04,GBP,-62264.64,POS,London,GB,1045,user_001,,
48061541-f747-4e94-80d9-051f49b07956,2026-08-12,2026-08-12,Pret A Manger,5814,Food & Drink,Eating Out,-7.45,GBP,-62272.09,POS,London,GB,1045,user_001,,
55c4697a-6e2e-40cb-956f-175a6859df29,2026-08-13,2026-08-13,Shell,5541,Transport,Fuel,-46.73,GBP,-62318.82,POS,London,GB,1045,user_002,,
ef52dcd1-f9af-4ace-b0f9-e181a23196c5,2026-08-13,2026-08-13,City Council Tax,9399,Utilities,Council Tax,-187.27,GBP,-62506.09,Direct Debit,London,GB,9074,user_001,rec_f531495db5,
5d805372-485c-4bdd-b1bb-5a35c5fa8349,2026-08-14,2026-08-14,Tesco,5411,Groceries,Supermarket,-29.93,GBP,-62536.02,POS,London,GB,1045,user_001,,
7743efd4-6238-486e-9210-d6e48c7ac180,2026-08-14,2026-08-17,Shell,5541,Transport,Fuel,-84.87,GBP,-62620.89,POS,London,GB,4488,user_001,,
86af8145-1614-4b9e-a127-b99c7a0cf166,2026-08-14,2026-08-14,Waitrose,5411,Groceries,Supermarket,-40.25,GBP,-62661.14,POS,London,GB,9074,user_001,,
f75f52a8-90cc-4aec-a2ef-fbac7602a4db,2026-08-14,2026-08-17,Waitrose,5411,Groceries,Supermarket,-76.23,GBP,-62737.37,POS,London,GB,2219,user_001,,
27521a92-fcb1-4701-91e4-56556c04f9db,2026-08-15,2026-08-17,Uber UK,4121,Transport,Ride Hailing,-23.03,GBP,-62760.4,E-Com,London,GB,4488,user_001,,
93346afb-3f79-49e3-80bb-dd00d2da025c,2026-08-15,2026-08-17,Uber UK,4121,Transport,Ride Hailing,-27.37,GBP,-62787.77,E-Com,London,GB,1045,user_001,,
cdccf671-847a-4afe-b00c-63b0f9f9b358,2026-08-15,2026-08-17,HM Revenue & Customs,9311,Income,Tax Refund,21.02,GBP,-62766.75,Credit,London,GB,4488,user_001,,Refund for Uber UK
3047a066-18df-41e8-815d-37549eddb5e0,2026-08-16,2026-08-17,Local Market,5499,Groceries,Specialty,-17.36,GBP,-62784.11,POS,London,GB,1045,user_001,,
85766105-0d4e-4b8d-b05e-14a8bc6bca29,2026-08-16,2026-08-17,Apple.com/bill,5734,Shopping,Electronics,-197.44,GBP,-62981.55,E-Com,Cupertino,US,1045,user_001,,
94aa3314-d3a1-4f37-8914-c4826d9d1ef2,2026-08-16,2026-08-17,Sainsbury's,5411,Groceries,Supermarket,-69.83,GBP,-63051.38,POS,London,GB,2219,user_002,,
e3e900c6-2315-4dec-878f-2592cbd23541,2026-08-16,2026-08-18,Uber UK,4121,Transport,Ride Hailing,-12.62,GBP,-63064.0,E-Com,London,GB,2219,user_002,,
496b0fb7-c63d-42ce-b246-edb6ad97c7e5,2026-08-17,2026-08-19,GymBox,7997,Wellness,Gym,-61.8,GBP,-63125.8,Direct Debit,London,GB,9074,user_001,rec_3906953fd2,
89a8588f-97d6-4932-b28c-468f59ebd3d9,2026-08-17,2026-08-19,O2 UK,4814,Bills,Mobile,-47.25,GBP,-63173.05,Direct Debit,Slough,GB,4488,user_002,rec_d2dce4c42f,
9ff8f4a6-e8c3-4ab5-b509-0836c0ed8a4b,2026-08-17,2026-08-17,Sainsbury's,5411,Groceries,Supermarket,-34.53,GBP,-63207.58,POS,London,GB,1045,user_001,,
c43d8bc4-de94-428c-b45a-d0d4d60776e6,2026-08-17,2026-08-17,Amazon UK,5942,Shopping,Online Retail,-21.26,GBP,-63228.84,E-Com,London,GB,4488,user_001,,
b4d443b1-4c75-4cb9-bed1-aa5304813620,2026-08-18,2026-08-19,Shell,5541,Transport,Fuel,-68.0,GBP,-63296.84,POS,London,GB,4488,user_001,,
0d650302-6f0f-4fad-9c33-33d2d9f547ba,2026-08-19,2026-08-20,Spotify,5735,Entertainment,Subscriptions,-8.7,EUR,-63305.54,E-Com,Stockholm,SE,1045,user_001,rec_4c746d2c3b,FX purchase 9.55 EUR @ rate 1.10
30557a49-3fcf-44df-b250-7be803e994ed,2026-08-20,2026-08-21,Deliveroo,5812,Food & Drink,Delivery,-18.32,GBP,-63323.86,E-Com,London,GB,9074,user_001,,
ad05a40c-7855-4cfc-8ae5-6a5134d3d23f,2026-08-20,2026-08-20,Transport for London,4111,Transport,Transit,-10.09,GBP,-63333.95,POS,London,GB,4488,user_001,,
ef602ba8-eb38-48c6-83c5-c98351bd9e37,2026-08-20,2026-08-24,Deliveroo,5812,Food & Drink,Delivery,-13.41,GBP,-63347.36,E-Com,London,GB,4488,user_001,,
353e2a82-8bee-468c-bfdb-95315609e71f,2026-08-21,2026-08-21,ATM Withdrawal,6011,Cash,ATM,-74.1,GBP,-63421.46,ATM,London,GB,9074,user_002,,
3f599c54-3eb0-4702-bf9d-819307018f35,2026-08-21,2026-08-21,Sainsbury's,5411,Groceries,Supermarket,-17.58,GBP,-63439.04,POS,London,GB,2219,user_001,,
916f66b9-866c-4544-9d6f-9ddc01cd6cd8,2026-08-21,2026-08-24,Netflix,7841,Entertainment,Subscriptions,-12.92,GBP,-63451.96,E-Com,Los Gatos,US,9074,user_002,rec_d9322c1382,
f4587b4a-5dff-4697-a7e3-29865efde365,2026-08-21,2026-08-24,Apple.com/bill,5734,Shopping,Electronics,-170.95,USD,-63622.91,E-Com,Cupertino,US,9074,user_001,,FX purchase 214.94 USD @ rate 1.26
ff38ea9c-fdd6-47cc-9b8b-24ecc2761098,2026-08-21,2026-08-24,Pret A Manger,5814,Food & Drink,Eating Out,-9.85,GBP,-63632.76,POS,London,GB,9074,user_001,,
8bb98330-c80c-41fe-add0-d99923bf762c,2026-08-22,2026-08-24,Tesco,5411,Groceries,Supermarket,-50.26,GBP,-63683.02,POS,London,GB,2219,user_001,,
913fa900-2ddc-4ca7-8ca8-2c4208150b42,2026-08-22,2026-08-24,Local Market,5499,Groceries,Specialty,-20.06,GBP,-63703.08,POS,London,GB,1045,user_001,,
ee3dad03-e945-48cc-8c60-08f5f5c46e4f,2026-08-22,2026-08-24,Shell,5541,Transport,Fuel,-78.38,GBP,-63781.46,POS,London,GB,1045,user_001,,
ff392046-7469-4643-9267-d63e1424c013,2026-08-22,2026-08-24,Transport for London,4111,Transport,Transit,-10.54,GBP,-63792.0,POS,London,GB,4488,user_001,,
66070e95-9652-4ad7-a136-2d59822590eb,2026-08-23,2026-08-24,Uber UK,4121,Transport,Ride Hailing,-14.83,GBP,-63806.83,E-Com,London,GB,4488,user_001,,
d0bf71c0-8808-449f-a38e-a25aba59fdbe,2026-08-23,2026-08-25,Sainsbury's,5411,Groceries,Supermarket,-24.45,GBP,-63831.28,POS,London,GB,1045,user_001,,
d4c6ba3f-2db0-4619-98ac-1e353952d8bf,2026-08-23,2026-08-24,Sainsbury's,5411,Groceries,Supermarket,-60.61,GBP,-63891.89,POS,London,GB,2219,user_002,,
d87ea99e-fc44-4967-a674-e4ec6b109e5c,2026-08-23,2026-08-25,Shell,5541,Transport,Fuel,-94.44,GBP,-63986.33,POS,London,GB,2219,user_001,,
add47e39-c07f-4fba-b057-2d3d0983a75b,2026-08-24,2026-08-26,ATM Withdrawal,6011,Cash,ATM,-82.35,GBP,-64068.68,ATM,London,GB,9074,user_001,,
a3bea280-4a03-4c54-8272-2cfdba7b16ba,2026-08-25,2026-08-26,Shell,5541,Transport,Fuel,-51.37,GBP,-64120.05,POS,London,GB,9074,user_002,,
ccdb3582-65f8-4fb7-b17c-06c84c21212f,2026-08-25,2026-08-26,Tesco,5411,Groceries,Supermarket,-44.07,GBP,-64164.12,POS,London,GB,1045,user_001,,
d387c239-0569-474c-9a27-8cdbc52e0270,2026-08-25,2026-08-25,T212 Capital,6011,Income,Salary,2899.78,GBP,-61264.34,Credit,London,GB,2219,user_001,rec_2ff8f778d0,
9a22dedb-b27d-4530-8f6d-76e5a1852258,2026-08-26,2026-08-28,Uber UK,4121,Transport,Ride Hailing,-12.47,GBP,-61276.81,E-Com,London,GB,2219,user_001,,
773f86b4-0242-4e6e-9fb6-763af6c4775d,2026-08-27,2026-08-27,Shell,5541,Transport,Fuel,-47.67,GBP,-61324.48,POS,London,GB,9074,user_001,,
d1fd8ea8-f9f9-424d-b598-87b389fb32df,2026-08-27,2026-08-28,Local Market,5499,Groceries,Specialty,-10.26,GBP,-61334.74,POS,London,GB,4488,user_001,,
b5a03d06-4627-4654-8af4-99f59b7b4f7d,2026-08-28,2026-08-31,Shell,5541,Transport,Fuel,-86.39,GBP,-61421.13,POS,London,GB,9074,user_001,,
d2982348-7d31-4ae0-af54-55ad6b55e7c4,2026-08-28,2026-08-31,Sainsbury's,5411,Groceries,Supermarket,-18.94,GBP,-61440.07,POS,London,GB,1045,user_002,,
4407183a-bf94-453e-97f4-79e0c7dacc13,2026-08-29,2026-08-31,Uber UK,4121,Transport,Ride Hailing,-19.22,GBP,-61459.29,E-Com,London,GB,4488,user_001,,
4af412b1-aef6-44ec-b9e4-a16d34f6b812,2026-08-29,2026-08-31,Waitrose,5411,Groceries,Supermarket,-76.02,GBP,-61535.31,POS,London,GB,4488,user_001,,
7aadee0d-ed70-4618-af2b-6734c6a57661,2026-08-29,2026-08-31,Uber UK,4121,Transport,Ride Hailing,-10.19,GBP,-61545.5,E-Com,London,GB,9074,user_001,,
c889347e-f41a-40c4-bda1-6e423c1ab061,2026-08-29,2026-08-31,Local Market,5499,Groceries,Specialty,-21.3,GBP,-61566.8,POS,London,GB,1045,user_001,,
f7b36834-33a2-4bc3-9ece-09a87554078b,2026-08-29,2026-08-31,Amazon UK,5942,Shopping,Online Retail,-118.38,GBP,-61685.18,E-Com,London,GB,4488,user_001,,
9e2766c5-7cb6-4c87-8383-e1f4aad7b793,2026-08-30,2026-08-31,Waitrose,5411,Groceries,Supermarket,-24.22,GBP,-61709.4,POS,London,GB,1045,user_002,,
acbd7565-5097-4022-b321-bfd078a0d015,2026-08-30,2026-09-01,Amazon UK,5942,Shopping,Online Retail,-82.75,GBP,-61792.15,E-Com,London,GB,1045,user_001,,
34b9f4cc-4ac5-4b99-935c-25eddea87a24,2026-09-01,2026-09-03,ATM Withdrawal,6011,Cash,ATM,-82.52,GBP,-61874.67,ATM,London,GB,9074,user_002,,
ab246157-4b8f-4638-82b7-6ec255434ef7,2026-09-01,2026-09-01,Crown Estates Lettings,6513,Housing,Rent,-1569.67,GBP,-63444.34,POS,London,GB,4488,user_001,rec_19f70fbcce,
08b312d6-592a-4231-9de9-856462f0f367,2026-09-02,2026-09-04,Tesco,5411,Groceries,Supermarket,-23.66,GBP,-63468.0,POS,London,GB,4488,user_001,,
66d9ca46-e8dd-425c-8e36-066beb213032,2026-09-02,2026-09-04,Shell,5541,Transport,Fuel,-34.71,GBP,-63502.71,POS,London,GB,9074,user_002,,
3c2634ef-7d2f-41ff-83c4-9d8ee3064c69,2026-09-03,2026-09-07,Sainsbury's,5411,Groceries,Supermarket,-39.27,GBP,-63541.98,POS,London,GB,2219,user_001,,
79a87158-5c49-448b-b329-2c50752b796f,2026-09-04,2026-09-07,Apple.com/bill,5734,Shopping,Electronics,-82.8,USD,-63624.78,E-Com,Cupertino,US,2219,user_001,,FX purchase 101.26 USD @ rate 1.22
b48c95fa-cab8-4557-b8c9-bcb5ae60b4c0,2026-09-04,2026-09-07,Uber UK,4121,Transport,Ride Hailing,-21.0,GBP,-63645.78,E-Com,London,GB,2219,user_001,,
13a88503-1d0c-453f-be80-09d0245ffba4,2026-09-05,2026-09-07,Waitrose,5411,Groceries,Supermarket,-81.49,GBP,-63727.27,POS,London,GB,4488,user_001,,
30a7bf39-cfc9-48e5-b0d0-b069ce0c9dff,2026-09-05,2026-09-07,Deliveroo,5812,Food & Drink,Delivery,-30.9,GBP,-63758.17,E-Com,London,GB,2219,user_001,,
45d32f37-b677-4c50-ab26-b199de6f35d5,2026-09-05,2026-09-07,Apple.com/bill,5734,Shopping,Electronics,-175.35,GBP,-63933.52,E-Com,Cupertino,US,9074,user_001,,
6a08a97a-0b37-409c-9c7b-26d407aa6208,2026-09-05,2026-09-07,Uber UK,4121,Transport,Ride Hailing,-24.8,GBP,-63958.32,E-Com,London,GB,9074,user_001,,
68430524-ffe3-424d-b2e4-b760be6e18b2,2026-09-06,2026-09-07,Pret A Manger,5814,Food & Drink,Eating Out,-8.18,GBP,-63966.5,POS,London,GB,9074,user_001,,
92b18d9b-e28a-4aa8-9a8d-c6f1ebd8fc8d,2026-09-06,2026-09-07,Deliveroo,5812,Food & Drink,Delivery,-22.46,GBP,-63988.96,E-Com,London,GB,9074,user_001,,
ec887186-216f-436c-bb95-4a2e1ae3cc3f,2026-09-06,2026-09-07,Amazon UK,5942,Shopping,Online Retail,-13.38,GBP,-64002.34,E-Com,London,GB,4488,user_001,,
32a4ea7a-1e1b-49ec-ab9c-ed1f84af9139,2026-09-07,2026-09-08,Pret A Manger,5814,Food & Drink,Eating Out,-6.59,GBP,-64008.93,POS,London,GB,1045,user_001,,
af64e81d-27f4-46fa-9d09-a340cf1b9ec8,2026-09-07,2026-09-07,Octopus Energy,4900,Utilities,Electricity,-122.01,GBP,-64130.94,Direct Debit,London,GB,9074,user_001,rec_141a4a0666,
e79ec0a5-eb35-4336-a1e7-735a59789d9a,2026-09-07,2026-09-08,Local Market,5499,Groceries,Specialty,-10.41,GBP,-64141.35,POS,London,GB,2219,user_001,,
9839eda4-1593-466b-a3d7-3b6c745181ac,2026-09-08,2026-09-08,Amazon UK,5942,Shopping,Online Retail,-22.66,GBP,-64164.01,E-Com,London,GB,2219,user_001,,
3fb159b2-66b6-4aab-b4b1-0ff378ee63f4,2026-09-09,2026-09-10,Tesco,5411,Groceries,Supermarket,-21.06,GBP,-64185.07,POS,London,GB,1045,user_001,,
468a6323-b1cf-4d59-82f9-4d4c4e9e34cd,2026-09-09,2026-09-10,Sainsbury's,5411,Groceries,Supermarket,-65.84,GBP,-64250.91,POS,London,GB,9074,user_001,,
e94feadd-aee5-4830-892b-8685b58587b6,2026-09-09,2026-09-09,Apple.com/bill,5734,Shopping,Electronics,-66.72,GBP,-64317.63,E-Com,Cupertino,US,9074,user_001,,
0db5dfd3-a04f-4dad-b704-f2312ce9a078,2026-09-10,2026-09-10,Deliveroo,5812,Food & Drink,Delivery,-18.45,GBP,-64336.08,E-Com,London,GB,9074,user_001,,
96ca69a0-7360-40b6-bb65-5d726a094f38,2026-09-10,2026-09-14,Amazon UK,5942,Shopping,Online Retail,-114.97,GBP,-64451.05,E-Com,London,GB,9074,user_001,,
b8e654e0-2753-4e7c-9b38-aed949a7bbdb,2026-09-10,2026-09-10,Shell,5541,Transport,Fuel,-87.05,GBP,-64538.1,POS,London,GB,9074,user_002,,
d575bb10-f287-4724-b300-628f134a7af2,2026-09-10,2026-09-11,Apple.com/bill,5734,Shopping,Electronics,-68.83,GBP,-64606.93,E-Com,Cupertino,US,4488,user_001,,
dfd93df6-f81c-4c0d-96fe-35f3d90f4779,2026-09-10,2026-09-10,Amazon UK,5942,Shopping,Online Retail,-76.22,GBP,-64683.15,E-Com,London,GB,9074,user_001,,
ce4b57bd-aa78-4dc0-8627-c5a2c2f58922,2026-09-11,2026-09-14,Thames Water,4900,Utilities,Water,-33.84,GBP,-64716.99,Direct Debit,Reading,GB,9074,user_001,rec_3a34d62842,
4e77b0e6-0a68-4386-b363-7dd247d304d0,2026-09-12,2026-09-14,Shell,5541,Transport,Fuel,-90.74,GBP,-64807.73,POS,London,GB,4488,user_001,,
722f84ea-a261-4bea-acea-82e4b24b7e1f,2026-09-12,2026-09-14,Shell,5541,Transport,Fuel,-57.41,GBP,-64865.14,POS,London,GB,2219,user_001,,
7a8a9c53-6ddd-4a3c-8870-6d3f693f05ef,2026-09-12,2026-09-14,Pret A Manger,5814,Food & Drink,Eating Out,-10.49,GBP,-64875.63,POS,London,GB,9074,user_002,,
87ddbab0-046f-4e2f-aed2-328bfe27c61c,2026-09-12,2026-09-14,Shell,5541,Transport,Fuel,-76.3,GBP,-64951.93,POS,London,GB,2219,user_002,,
9dad737a-46a3-40f9-9a13-a6df37038f2a,2026-09-12,2026-09-14,Tesco,5411,Groceries,Supermarket,-39.84,GBP,-64991.77,POS,London,GB,1045,user_002,,
d18bd6b6-be79-441b-ae63-70c5eb42d89e,2026-09-12,2026-09-14,Apple.com/bill,5734,Shopping,Electronics,-33.71,GBP,-65025.48,E-Com,Cupertino,US,1045,user_001,,
fb29da6a-640e-477c-998c-6c250497c8d8,2026-09-12,2026-09-14,Uber UK,4121,Transport,Ride Hailing,-10.93,GBP,-65036.41,E-Com,London,GB,4488,user_001,,
60fd1e45-c144-497c-811c-9834e0eac994,2026-09-13,2026-09-15,Pret A Manger,5814,Food & Drink,Eating Out,-11.67,GBP,-65048.08,POS,London,GB,4488,user_001,,
cc8447e5-176f-41c2-899e-769a42ef157b,2026-09-13,2026-09-15,Pret A Manger,5814,Food & Drink,Eating Out,-10.36,GBP,-65058.44,POS,London,GB,2219,user_001,,
0afcd557-c9eb-4135-8c03-04397a3c7649,2026-09-14,2026-09-14,City Council Tax,9399,Utilities,Council Tax,-155.35,GBP,-65213.79,Direct Debit,London,GB,1045,user_001,rec_f531495db5,
a6fbbdaf-7f2f-478c-92f9-a2e14d05969b,2026-09-14,2026-09-15,Waitrose,5411,Groceries,Supermarket,-27.46,GBP,-65241.25,POS,London,GB,2219,user_001,,
d0569353-683f-438c-8178-fa5fc4bb7993,2026-09-14,2026-09-14,ATM Withdrawal,6011,Cash,ATM,-115.51,GBP,-65356.76,ATM,London,GB,1045,user_001,,
ffc35180-c388-48e7-8251-c2f6d9bdbcc4,2026-09-14,2026-09-15,Uber UK,4121,Transport,Ride Hailing,-9.45,GBP,-65366.21,E-Com,London,GB,2219,user_001,,
5be9e461-fd2c-4b88-911a-a8caf0e1f5ab,2026-09-15,2026-09-15,O2 UK,4814,Bills,Mobile,-41.11,GBP,-65407.32,Direct Debit,Slough,GB,4488,user_002,rec_d2dce4c42f,
bc40d617-2d78-4eb6-9d68-87fdba1b3280,2026-09-15,2026-09-17,Apple.com/bill,5734,Shopping,Electronics,-15.03,GBP,-65422.35,E-Com,Cupertino,US,9074,user_001,,
106b638a-88d5-4e1b-b632-fe0e7bf5350e,2026-09-17,2026-09-17,Tesco,5411,Groceries,Supermarket,-25.75,GBP,-65448.1,POS,London,GB,9074,user_001,,
42cf3b48-572c-463b-b930-fdca53f8bb18,2026-09-17,2026-09-21,Transport for London,4111,Transport,Transit,-8.07,GBP,-65456.17,POS,London,GB,9074,user_001,,
9ff1445a-ce91-49e8-8166-445651d86a1a,2026-09-17,2026-09-18,Amazon UK,5942,Shopping,Online Retail,-105.5,GBP,-65561.67,E-Com,London,GB,1045,user_001,,
d3261882-7be0-47ee-b54a-7f2e0b414758,2026-09-17,2026-09-18,GymBox,7997,Wellness,Gym,-59.83,GBP,-65621.5,Direct Debit,London,GB,9074,user_001,rec_3906953fd2,
0ab8ec1b-a57b-4b62-9c03-47c6511f1bfc,2026-09-18,2026-09-21,Pret A Manger,5814,Food & Drink,Eating Out,-5.72,GBP,-65627.22,POS,London,GB,2219,user_001,,
4b9e2f5e-c540-4f9e-ad6f-e306e46bdd02,2026-09-18,2026-09-18,Sainsbury's,5411,Groceries,Supermarket,-47.21,GBP,-65674.43,POS,London,GB,9074,user_002,,
db3d8b5d-f546-4718-b741-261ce663ee44,2026-09-18,2026-09-18,Pret A Manger,5814,Food & Drink,Eating Out,-10.81,GBP,-65685.24,POS,London,GB,9074,user_001,,
1754f5aa-172e-458a-a2ee-6511c1bff770,2026-09-19,2026-09-21,Tesco,5411,Groceries,Supermarket,-63.73,GBP,-65748.97,POS,London,GB,4488,user_001,,
5e744c2c-b015-45d0-bf97-12dc3338e116,2026-09-19,2026-09-21,Local Market,5499,Groceries,Specialty,-15.75,GBP,-65764.72,POS,London,GB,9074,user_001,,
618c3ab7-bddf-465a-8cd6-4b310f552f2d,2026-09-19,2026-09-21,Uber UK,4121,Transport,Ride Hailing,-11.53,GBP,-65776.25,E-Com,London,GB,9074,user_002,,
b7ba7664-92a4-4546-b182-cb4ce268088d,2026-09-19,2026-09-21,Waitrose,5411,Groceries,Supermarket,-66.01,GBP,-65842.26,POS,London,GB,1045,user_001,,
de98b7ca-f48f-461d-9633-e3520401dd8e,2026-09-19,2026-09-21,Tesco,5411,Groceries,Supermarket,-38.86,GBP,-65881.12,POS,London,GB,9074,user_001,,
184b89db-1c22-4ec6-94e1-b799286541b7,2026-09-20,2026-09-22,Waitrose,5411,Groceries,Supermarket,-67.69,GBP,-65948.81,POS,London,GB,1045,user_001,,
631a14c0-0b4c-4b6c-aaaf-9aa6544a02cb,2026-09-20,2026-09-21,ATM Withdrawal,6011,Cash,ATM,-108.72,GBP,-66057.53,ATM,London,GB,9074,user_001,,
65b244df-60de-43f9-8add-34137ca5b150,2026-09-20,2026-09-21,Apple.com/bill,5734,Shopping,Electronics,-205.12,GBP,-66262.65,E-Com,Cupertino,US,9074,user_001,,
77c65400-ad8c-439c-a3f3-75818fa21d3e,2026-09-20,2026-09-21,Shell,5541,Transport,Fuel,-40.59,GBP,-66303.24,POS,London,GB,9074,user_002,,
84e9cfac-77d8-4d3f-bf42-673c979d90bc,2026-09-20,2026-09-21,Sainsbury's,5411,Groceries,Supermarket,-54.16,GBP,-66357.4,POS,London,GB,2219,user_001,,
2f2cfe37-31e0-4690-82c9-5ee35b9c6548,2026-09-21,2026-09-22,Netflix,7841,Entertainment,Subscriptions,-14.52,GBP,-66371.92,E-Com,Los Gatos,US,2219,user_001,rec_1bfe33738d,
ba432e14-8298-462d-9182-284e047cd2ce,2026-09-21,2026-09-22,Tesco,5411,Groceries,Supermarket,-71.88,GBP,-66443.8,POS,London,GB,9074,user_001,,
e8643c5d-eb37-40a3-9c2c-d8df1c68a047,2026-09-21,2026-09-23,Spotify,5735,Entertainment,Subscriptions,-8.74,EUR,-66452.54,E-Com,Stockholm,SE,1045,user_001,rec_4c746d2c3b,FX purchase 10.77 EUR @ rate 1.23
2d04382f-507b-40e3-a2a0-a1466b1f23fa,2026-09-22,2026-09-22,Apple.com/bill,5734,Shopping,Electronics,-35.65,GBP,-66488.19,E-Com,Cupertino,US,4488,user_001,,
69710737-1ca2-46ff-8838-21a4745bd481,2026-09-22,2026-09-23,Pret A Manger,5814,Food & Drink,Eating Out,-6.85,GBP,-66495.04,POS,London,GB,1045,user_001,,
a86a0fd1-d1fd-451d-9d9d-81b305419e51,2026-09-23,2026-09-24,Waitrose,5411,Groceries,Supermarket,-54.77,GBP,-66549.81,POS,London,GB,4488,user_001,,
8020ac75-2770-4caa-a55f-b8fe190332dc,2026-09-24,2026-09-24,Tesco,5411,Groceries,Supermarket,-50.51,GBP,-66600.32,POS,London,GB,1045,user_001,,
332ae695-7527-4f6f-8d19-5073fbb5c918,2026-09-25,2026-09-25,T212 Capital,6011,Income,Salary,3356.49,GBP,-63243.83,Credit,London,GB,1045,user_001,rec_2ff8f778d0,
14ca9c20-2c9e-439d-824a-be8b805bf382,2026-09-26,2026-09-28,Waitrose,5411,Groceries,Supermarket,-80.42,GBP,-63324.25,POS,London,GB,9074,user_001,,
31b7fd49-490d-4ad4-a9ac-098f5e269c44,2026-09-26,2026-09-28,Sainsbury's,5411,Groceries,Supermarket,-54.63,GBP,-63378.88,POS,London,GB,2219,user_001,,
dd54c120-43c4-4837-ac79-d77f3d5c81d8,2026-09-26,2026-09-28,Sainsbury's,5411,Groceries,Supermarket,-58.96,GBP,-63437.84,POS,London,GB,1045,user_001,,
0ff37d5b-0f88-4044-8e26-0d2718addbb0,2026-09-27,2026-09-28,Transport for London,4111,Transport,Transit,-8.71,GBP,-63446.55,POS,London,GB,2219,user_001,,
35d08d7b-02df-4d38-9a4b-913553c7b649,2026-09-27,2026-09-28,Shell,5541,Transport,Fuel,-41.47,GBP,-63488.02,POS,London,GB,2219,user_001,,
fed033ff-9864-4be4-b145-c8eff9dcd792,2026-09-27,2026-09-29,Waitrose,5411,Groceries,Supermarket,-82.91,GBP,-63570.93,POS,London,GB,1045,user_002,,
ae5f9e0f-f3ab-4834-9c50-2b2e6a3cc351,2026-09-28,2026-09-28,Transport for London,4111,Transport,Transit,-8.44,GBP,-63579.37,POS,London,GB,4488,user_001,,
281ee459-48c4-45a6-981a-2d09b0fe2646,2026-09-29,2026-10-01,Local Market,5499,Groceries,Specialty,-14.54,GBP,-63593.91,POS,London,GB,9074,user_001,,
909752c8-83eb-4dfa-93bb-15b52b037e0f,2026-09-29,2026-10-01,Tesco,5411,Groceries,Supermarket,-76.93,GBP,-63670.84,POS,London,GB,4488,user_001,,
0b1a90d3-d16b-44e8-866b-e58abe62113c,2026-10-01,2026-10-05,Amazon UK,5942,Shopping,Online Retail,-61.3,GBP,-63732.14,E-Com,London,GB,9074,user_001,,
44e62888-11d4-4fab-b056-f1373e13506e,2026-10-01,2026-10-05,Transport for London,4111,Transport,Transit,-7.02,GBP,-63739.16,POS,London,GB,1045,user_001,,
da15dee0-33fa-48f2-957d-00432dd2cf5b,2026-10-01,2026-10-05,Crown Estates Lettings,6513,Housing,Rent,-1450.81,GBP,-65189.97,POS,London,GB,4488,user_002,rec_fc2ae06846,
218bddee-f08e-4348-8634-6a290136eea4,2026-10-02,2026-10-05,Waitrose,5411,Groceries,Supermarket,-42.69,GBP,-65232.66,POS,London,GB,2219,user_001,,
497168bc-b7c1-43f5-aa1b-c26d325745d8,2026-10-03,2026-10-05,Apple.com/bill,5734,Shopping,Electronics,-202.85,USD,-65435.51,E-Com,Cupertino,US,9074,user_001,,FX purchase 247.63 USD @ rate 1.22
590b4302-cbf3-47a1-80e3-c66c8ca534a4,2026-10-03,2026-10-05,Tesco,5411,Groceries,Supermarket,-73.82,GBP,-65509.33,POS,London,GB,1045,user_001,,
d2176772-bae5-43c6-b3a1-cd4a626567da,2026-10-03,2026-10-05,Pret A Manger,5814,Food & Drink,Eating Out,-8.43,GBP,-65517.76,POS,London,GB,9074,user_001,,
e5e7af64-38ee-42ad-87f5-f3957e51b2fe,2026-10-03,2026-10-05,Waitrose,5411,Groceries,Supermarket,-51.01,GBP,-65568.77,POS,London,GB,4488,user_002,,
4acf4a49-592c-4990-8393-354abaafc93a,2026-10-04,2026-10-05,Tesco,5411,Groceries,Supermarket,-34.15,GBP,-65602.92,POS,London,GB,2219,user_002,,
ad5fbd1c-5d07-4edf-96b3-25c5b787254f,2026-10-04,2026-10-05,Uber UK,4121,Transport,Ride Hailing,-32.3,GBP,-65635.22,E-Com,London,GB,1045,user_001,,
e2a6f804-94d0-4dc4-9355-c5ece5969d42,2026-10-04,2026-10-06,Amazon UK,5942,Shopping,Online Retail,-90.34,GBP,-65725.56,E-Com,London,GB,9074,user_002,,
3eba34dd-2933-40ec-a461-0090a508cbb4,2026-10-05,2026-10-06,Tesco,5411,Groceries,Supermarket,-58.6,GBP,-65784.16,POS,London,GB,4488,user_001,,
240e5198-4506-464f-8738-9b6d65cb687c,2026-10-06,2026-10-07,Amazon UK,5942,Shopping,Online Retail,-77.45,GBP,-65861.61,E-Com,London,GB,4488,user_001,,
55641f21-707b-4180-a707-2293cc95e746,2026-10-06,2026-10-07,Waitrose,5411,Groceries,Supermarket,-68.67,GBP,-65930.28,POS,London,GB,2219,user_001,,
d8d29e3d-8e6f-4c2f-984a-dd35b37ad28b,2026-10-06,2026-10-07,Shell,5541,Transport,Fuel,-59.26,GBP,-65989.54,POS,London,GB,2219,user_001,,
5bb27e6d-82db-49d9-b254-3989fe512ac1,2026-10-07,2026-10-07,Uber UK,4121,Transport,Ride Hailing,-27.01,GBP,-66016.55,E-Com,London,GB,4488,user_001,,
9a3a8e4a-b60c-4dc2-9407-9313ba53bd22,2026-10-07,2026-10-07,Octopus Energy,4900,Utilities,Electricity,-126.93,GBP,-66143.48,Direct Debit,London,GB,2219,user_002,rec_09c3f12b18,
c591fab4-ea69-40ce-863a-af0f3bb682f1,2026-10-07,2026-10-07,Deliveroo,5812,Food & Drink,Delivery,-30.11,GBP,-66173.59,E-Com,London,GB,2219,user_001,,
e9624ed8-1150-4cec-befd-bf3e6930c0d7,2026-10-07,2026-10-09,Shell,5541,Transport,Fuel,-31.39,GBP,-66204.98,POS,London,GB,1045,user_001,,
3b8997ae-07af-47a8-a129-51d313ddbb2b,2026-10-09,2026-10-09,Sainsbury's,5411,Groceries,Supermarket,-48.4,GBP,-66253.38,POS,London,GB,2219,user_001,,
94f1816d-748a-421b-9a0c-d949a3f3eaaf,2026-10-10,2026-10-12,Waitrose,5411,Groceries,Supermarket,-77.52,GBP,-66330.9,POS,London,GB,2219,user_001,,
6fe7c4fa-da06-4ce2-868b-98c157fff1ea,2026-10-11,2026-10-12,Sainsbury's,5411,Groceries,Supermarket,-30.41,GBP,-66361.31,POS,London,GB,1045,user_001,,
a4f6e717-24d6-4ba9-bd90-15e72ec1c83f,2026-10-11,2026-10-12,Amazon UK,5942,Shopping,Online Retail,-114.45,GBP,-66475.76,E-Com,London,GB,2219,user_001,,
e224eb37-0158-4bf7-a14d-e2358327c688,2026-10-11,2026-10-12,Apple.com/bill,5734,Shopping,Electronics,-119.35,USD,-66595.11,E-Com,Cupertino,US,4488,user_002,,FX purchase 144.14 USD @ rate 1.21
eada3e87-d0f1-4aea-a083-8dff16cf526f,2026-10-11,2026-10-12,Tesco,5411,Groceries,Supermarket,-35.55,GBP,-66630.66,POS,London,GB,1045,user_002,,
ed9d0871-97d5-41a1-8fd4-aa65666b8a3a,2026-10-11,2026-10-12,Pret A Manger,5814,Food & Drink,Eating Out,-7.44,GBP,-66638.1,POS,London,GB,2219,user_001,,
6554f794-38fc-4349-bdc1-4212e362f116,2026-10-12,2026-10-13,Pret A Manger,5814,Food & Drink,Eating Out,-8.07,GBP,-66646.17,POS,London,GB,2219,user_001,,
f041bac6-86e4-4053-96c1-3b620dbdecba,2026-10-12,2026-10-14,Thames Water,4900,Utilities,Water,-36.02,GBP,-66682.19,Direct Debit,Reading,GB,1045,user_001,rec_3a34d62842,
08aed6df-c5c2-450a-818b-122c0d2dee38,2026-10-13,2026-10-15,Local Market,5499,Groceries,Specialty,-9.23,GBP,-66691.42,POS,London,GB,9074,user_001,,
6d41d676-bdd5-4f20-9963-9e33b6da46a2,2026-10-13,2026-10-14,City Council Tax,9399,Utilities,Council Tax,-157.41,GBP,-66848.83,Direct Debit,London,GB,2219,user_002,rec_6feaa5d43f,
008df47f-57e0-47f7-8aaf-e462a69f9f76,2026-10-14,2026-10-16,Local Market,5499,Groceries,Specialty,-9.44,GBP,-66858.27,POS,London,GB,2219,user_001,,
ad28c493-483b-40a0-94a3-1870e8308ade,2026-10-15,2026-10-16,Deliveroo,5812,Food & Drink,Delivery,-21.03,GBP,-66879.3,E-Com,London,GB,2219,user_001,,
ad4c293d-1541-49a6-ab5e-2762754ba29b,2026-10-15,2026-10-16,O2 UK,4814,Bills,Mobile,-37.19,GBP,-66916.49,Direct Debit,Slough,GB,9074,user_001,rec_95042d8101,
b23967cd-09fe-4bf5-93af-70fe333d2aea,2026-10-15,2026-10-19,Airbnb,7011,Travel,Accommodation,-215.4,GBP,-67131.89,E-Com,Dublin,IE,9074,user_002,,Holiday booking
d7e62169-8b29-45e7-ac8d-745f4cc49864,2026-10-15,2026-10-15,Pret A Manger,5814,Food & Drink,Eating Out,-9.0,GBP,-67140.89,POS,London,GB,9074,user_001,,
d8252403-5bbb-4ca1-adfa-dca4f32de89a,2026-10-16,2026-10-19,Uber UK,4121,Transport,Ride Hailing,-28.43,GBP,-67169.32,E-Com,London,GB,1045,user_001,,
0f656453-7a66-4de5-bc32-d7bca6686c85,2026-10-17,2026-10-19,Apple.com/bill,5734,Shopping,Electronics,-17.13,USD,-67186.45,E-Com,Cupertino,US,1045,user_001,,FX purchase 21.34 USD @ rate 1.25
14ec0627-f352-42cc-b1bc-330abf95dfb6,2026-10-17,2026-10-19,Shell,5541,Transport,Fuel,-34.49,GBP,-67220.94,POS,London,GB,9074,user_001,,
1c9e159e-4adc-4755-bd11-17a2b0ec9656,2026-10-17,2026-10-19,Local Market,5499,Groceries,Specialty,-6.48,GBP,-67227.42,POS,London,GB,2219,user_001,,
3629b237-5928-461a-9b6f-c656044ad600,2026-10-17,2026-10-19,Local Market,5499,Groceries,Specialty,-17.37,GBP,-67244.79,POS,London,GB,9074,user_001,,
1e39f1ce-146f-405c-995d-b738f873093e,2026-10-18,2026-10-19,Amazon UK,5942,Shopping,Online Retail,-104.42,GBP,-67349.21,E-Com,London,GB,2219,user_002,,
566ac1f9-dc4f-4fce-b148-d16b3eaef22c,2026-10-18,2026-10-20,Pret A Manger,5814,Food & Drink,Eating Out,-9.18,GBP,-67358.39,POS,London,GB,1045,user_001,,
72971a50-9fe8-4357-9bd9-f0e1e6ef9362,2026-10-18,2026-10-19,Shell,5541,Transport,Fuel,-72.9,GBP,-67431.29,POS,London,GB,2219,user_002,,
99843e0c-08c9-46f7-8d7e-f403685a40b7,2026-10-18,2026-10-19,ATM Withdrawal,6011,Cash,ATM,-87.72,GBP,-67519.01,ATM,London,GB,9074,user_002,,
a7f67b6a-84e1-49bc-a9a4-0b2a28a558bf,2026-10-18,2026-10-20,Amazon UK,5942,Shopping,Online Retail,-88.06,GBP,-67607.07,E-Com,London,GB,1045,user_001,,
3eb1560d-3df3-4ebd-9b91-1243432f53b1,2026-10-19,2026-10-19,ATM Withdrawal,6011,Cash,ATM,-69.37,GBP,-67676.44,ATM,London,GB,9074,user_001,,
b351d943-385c-4f50-a1b9-0cb474a25e49,2026-10-19,2026-10-21,Spotify,5735,Entertainment,Subscriptions,-8.41,GBP,-67684.85,E-Com,Stockholm,SE,4488,user_001,rec_4c746d2c3b,
e5403653-a8f0-482d-b3fe-463102508b8b,2026-10-19,2026-10-19,GymBox,7997,Wellness,Gym,-54.68,GBP,-67739.53,Direct Debit,London,GB,2219,user_001,rec_3906953fd2,
4d6537ff-e6b7-4abb-b00a-7c71c25f7b60,2026-10-20,2026-10-21,Amazon UK,5942,Shopping,Online Retail,-83.08,GBP,-67822.61,E-Com,London,GB,2219,user_001,,
5d673719-fddc-48ae-baeb-4448839b2e73,2026-10-20,2026-10-22,Uber UK,4121,Transport,Ride Hailing,-17.21,GBP,-67839.82,E-Com,London,GB,1045,user_001,,
f21a4780-e1fb-4baa-a610-0d6a0735d86c,2026-10-20,2026-10-21,Waitrose,5411,Groceries,Supermarket,-59.36,GBP,-67899.18,POS,London,GB,2219,user_001,,
96df5510-a1c4-4878-98df-e957bbaad17e,2026-10-21,2026-10-23,Netflix,7841,Entertainment,Subscriptions,-14.76,USD,-67913.94,E-Com,Los Gatos,US,2219,user_001,rec_1bfe33738d,FX purchase 18.6 USD @ rate 1.26
55fda2e5-2b51-48eb-bb45-4002b415e7f5,2026-10-22,2026-10-22,Sainsbury's,5411,Groceries,Supermarket,-28.02,GBP,-67941.96,POS,London,GB,2219,user_001,,
b5b73536-7e47-45d0-a109-57cc99d92acf,2026-10-22,2026-10-26,Waitrose,5411,Groceries,Supermarket,-28.58,GBP,-67970.54,POS,London,GB,4488,user_001,,
cbdb48f3-9d20-439a-9bcb-815854bd3b0e,2026-10-22,2026-10-26,Transport for London,4111,Transport,Transit,-9.23,GBP,-67979.77,POS,London,GB,2219,user_001,,
b218abab-703d-4b37-9586-112638cdfac7,2026-10-23,2026-10-23,T212 Capital,6011,Income,Salary,2987.82,GBP,-64991.95,Credit,London,GB,4488,user_002,rec_c649d24d0f,
c9f93049-f9a6-42e4-9154-74b7ed56760e,2026-10-23,2026-10-23,ATM Withdrawal,6011,Cash,ATM,-80.57,GBP,-65072.52,ATM,London,GB,4488,user_001,,
310ee833-229b-46f1-8b30-362c662e9767,2026-10-24,2026-10-26,Transport for London,4111,Transport,Transit,-9.79,GBP,-65082.31,POS,London,GB,1045,user_001,,
3d69cb6a-9cdb-4ac5-98f4-8b2290443a7f,2026-10-24,2026-10-26,Tesco,5411,Groceries,Supermarket,-72.93,GBP,-65155.24,POS,London,GB,4488,user_002,,
466aafbe-6baa-4bbf-93a1-bf2d95ff559e,2026-10-24,2026-10-26,Apple.com/bill,5734,Shopping,Electronics,-92.45,GBP,-65247.69,E-Com,Cupertino,US,4488,user_001,,
dd4652de-7e14-4b11-a1e5-d6befd102aeb,2026-10-24,2026-10-26,Apple.com/bill,5734,Shopping,Electronics,-130.15,USD,-65377.84,E-Com,Cupertino,US,4488,user_001,,FX purchase 165.32 USD @ rate 1.27
ea76ead1-4d32-4312-b80e-6fd344efbcee,2026-10-24,2026-10-26,Shell,5541,Transport,Fuel,-39.3,GBP,-65417.14,POS,London,GB,4488,user_002,,
2740e512-ad0c-446d-b197-0c3208a2532c,2026-10-25,2026-10-27,Pret A Manger,5814,Food & Drink,Eating Out,-6.01,GBP,-65423.15,POS,London,GB,4488,user_001,,
3d08a311-ee6f-44e7-8c2f-1e52fd1ec570,2026-10-25,2026-10-26,Deliveroo,5812,Food & Drink,Delivery,-33.59,GBP,-65456.74,E-Com,London,GB,9074,user_001,,
aafd4184-d758-4731-b02f-f3f956819f88,2026-10-25,2026-10-27,Local Market,5499,Groceries,Specialty,-12.91,GBP,-65469.65,POS,London,GB,4488,user_001,,
dfd4a815-aeec-4e10-a113-7e245321b006,2026-10-25,2026-10-26,Transport for London,4111,Transport,Transit,-5.49,GBP,-65475.14,POS,London,GB,1045,user_002,,
f4450e9b-f086-4d38-963e-6ca7cf856e1e,2026-10-25,2026-10-26,Sainsbury's,5411,Groceries,Supermarket,-31.97,GBP,-65507.11,POS,London,GB,4488,user_001,,
3734d033-1e5a-4230-9515-99902b8c3d79,2026-10-26,2026-10-26,Local Market,5499,Groceries,Specialty,-8.2,GBP,-65515.31,POS,London,GB,4488,user_001,,
423670e0-994f-4d2f-b5e3-5b9246ff9709,2026-10-27,2026-10-27,Apple.com/bill,5734,Shopping,Electronics,-166.97,USD,-65682.28,E-Com,Cupertino,US,4488,user_002,,FX purchase 214.04 USD @ rate 1.28
f77c88a2-79fa-4ec7-b20b-48cc49ea9365,2026-10-27,2026-10-28,Pret A Manger,5814,Food & Drink,Eating Out,-8.99,GBP,-65691.27,POS,London,GB,1045,user_001,,
8c330ad8-ddcd-41a3-bf6f-b83d9f57265e,2026-10-28,2026-10-28,Shell,5541,Transport,Fuel,-71.3,GBP,-65762.57,POS,London,GB,1045,user_001,,
488afe42-b52b-4311-8645-38c2c77cc43a,2026-10-30,2026-11-02,Local Market,5499,Groceries,Specialty,-18.86,GBP,-65781.43,POS,London,GB,4488,user_001,,
529bf6ec-600f-4a6f-8f51-3d139929217f,2026-10-30,2026-11-02,Shell,5541,Transport,Fuel,-81.99,GBP,-65863.42,POS,London,GB,9074,user_001,,
70310905-3664-4549-afd5-1c9128549250,2026-10-30,2026-10-30,Sainsbury's,5411,Groceries,Supermarket,-54.8,GBP,-65918.22,POS,London,GB,1045,user_001,,
57085f02-8cc8-4a54-951b-77f69a5d6713,2026-10-31,2026-11-02,Pret A Manger,5814,Food & Drink,Eating Out,-8.85,GBP,-65927.07,POS,London,GB,1045,user_001,,
773d53f0-083d-4f93-a1f8-6f58dc07e37f,2026-10-31,2026-11-02,Local Market,5499,Groceries,Specialty,-20.13,GBP,-65947.2,POS,London,GB,2219,user_001,,
817d107f-f282-4b81-8d81-5f1292b777a3,2026-11-01,2026-11-02,Waitrose,5411,Groceries,Supermarket,-79.62,GBP,-66026.82,POS,London,GB,4488,user_001,,
8de06a5c-233f-42ef-8e6a-1fbc4b3a110a,2026-11-01,2026-11-02,Uber UK,4121,Transport,Ride Hailing,-21.71,GBP,-66048.53,E-Com,London,GB,2219,user_002,,
b919c4a5-3d4c-4849-894c-13f4cfba324f,2026-11-01,2026-11-02,Shell,5541,Transport,Fuel,-55.42,GBP,-66103.95,POS,London,GB,1045,user_001,,
2bfdfc95-9c88-4aee-bd1f-cb06f3d9625f,2026-11-02,2026-11-03,Crown Estates Lettings,6513,Housing,Rent,-1567.1,GBP,-67671.05,POS,London,GB,2219,user_001,rec_19f70fbcce,
5a9591fa-2daa-4ac7-b2c5-dba68d238b24,2026-11-02,2026-11-04,Sainsbury's,5411,Groceries,Supermarket,-45.39,GBP,-67716.44,POS,London,GB,9074,user_001,,
5eb3bf6b-37e2-480c-af53-c94094c75c6f,2026-11-02,2026-11-03,Amazon UK,5942,Shopping,Online Retail,-22.79,GBP,-67739.23,E-Com,London,GB,9074,user_002,,
94fd3253-1931-4406-8b33-3c11b7fccdb1,2026-11-02,2026-11-03,Local Market,5499,Groceries,Specialty,-11.5,GBP,-67750.73,POS,London,GB,9074,user_001,,
76bac266-9ac9-4258-bae1-2a680673a7a2,2026-11-03,2026-11-03,Transport for London,4111,Transport,Transit,-9.16,GBP,-67759.89,POS,London,GB,2219,user_002,,
f8865010-c685-49fc-8156-bc9c922d849c,2026-11-03,2026-11-03,Pret A Manger,5814,Food & Drink,Eating Out,-10.34,GBP,-67770.23,POS,London,GB,2219,user_001,,
05eb5cc8-9b11-41a1-a592-0c9afdb1b111,2026-11-04,2026-11-05,Sainsbury's,5411,Groceries,Supermarket,-53.45,GBP,-67823.68,POS,London,GB,2219,user_001,,
43061c77-fd3b-4bad-935e-df644b3d2e93,2026-11-04,2026-11-05,Apple.com/bill,5734,Shopping,Electronics,-56.19,GBP,-67879.87,E-Com,Cupertino,US,1045,user_002,,
3fe902f4-bc43-46e2-8e53-dcc790e46aaa,2026-11-06,2026-11-09,Transport for London,4111,Transport,Transit,-10.12,GBP,-67889.99,POS,London,GB,9074,user_002,,
47442fdc-de2b-4ab7-ad88-69ec90f10997,2026-11-06,2026-11-06,Amazon UK,5942,Shopping,Online Retail,-117.86,GBP,-68007.85,E-Com,London,GB,1045,user_001,,
4bbd3879-e7b8-4579-be3b-32881d8e6def,2026-11-06,2026-11-06,Transport for London,4111,Transport,Transit,-6.66,GBP,-68014.51,POS,London,GB,4488,user_001,,
ddb17eb3-1e19-4762-86d5-70f69cd2da0a,2026-11-06,2026-11-09,Local Market,5499,Groceries,Specialty,-21.21,GBP,-68035.72,POS,London,GB,4488,user_001,,
469853f9-69eb-4403-827f-97413727fb15,2026-11-07,2026-11-09,Shell,5541,Transport,Fuel,-94.33,GBP,-68130.05,POS,London,GB,2219,user_001,,
846b1dd1-a50a-46c7-abd8-1af11a7ab722,2026-11-07,2026-11-09,Waitrose,5411,Groceries,Supermarket,-71.81,GBP,-68201.86,POS,London,GB,1045,user_002,,
9612db75-8c73-4ea9-a0ee-1304c7cffaeb,2026-11-07,2026-11-09,Transport for London,4111,Transport,Transit,-5.75,GBP,-68207.61,POS,London,GB,2219,user_001,,
9ea36542-297f-4bc9-8024-123052cfb382,2026-11-07,2026-11-09,Amazon UK,5942,Shopping,Online Retail,-41.54,GBP,-68249.15,E-Com,London,GB,2219,user_001,,
f62701bc-f6c2-41fc-a8bc-d55178cae15f,2026-11-07,2026-11-09,Amazon UK,5942,Shopping,Online Retail,-42.09,GBP,-68291.24,E-Com,London,GB,1045,user_001,,
0d2083e8-5c7e-4b7a-a961-72b61010c231,2026-11-08,2026-11-10,Amazon UK,5942,Shopping,Online Retail,-78.55,GBP,-68369.79,E-Com,London,GB,4488,user_001,,
940bb797-311e-44a5-9134-7c600bc0095b,2026-11-08,2026-11-09,Sainsbury's,5411,Groceries,Supermarket,-52.0,GBP,-68421.79,POS,London,GB,4488,user_001,,
c2b2af52-1729-469c-b48f-462e8420e627,2026-11-08,2026-11-09,Deliveroo,5812,Food & Drink,Delivery,-26.26,GBP,-68448.05,E-Com,London,GB,2219,user_001,,
e553f7be-3489-4017-815f-c4d9e7cf02eb,2026-11-08,2026-11-09,Shell,5541,Transport,Fuel,-75.52,GBP,-68523.57,POS,London,GB,2219,user_001,,
6193f81a-2d45-4f48-bea6-fce570bb2eb3,2026-11-09,2026-11-11,Octopus Energy,4900,Utilities,Electricity,-137.29,GBP,-68660.86,Direct Debit,London,GB,9074,user_001,rec_141a4a0666,
d304ebf4-ddc0-461a-ac8c-4affe3d9b668,2026-11-09,2026-11-09,Airline Refund,4511,Travel,Refund,51.99,GBP,-68608.87,Credit,London,GB,1045,user_001,,Refund for Waitrose
fbc83102-02a1-4f0f-8964-a0a18248aec6,2026-11-09,2026-11-10,Amazon UK,5942,Shopping,Online Retail,-26.15,GBP,-68635.02,E-Com,London,GB,1045,user_001,,
8750e966-fa85-4eee-8f74-dfffa918b1a7,2026-11-10,2026-11-12,Sainsbury's,5411,Groceries,Supermarket,-21.29,GBP,-68656.31,POS,London,GB,1045,user_002,,
9ea69708-328e-4ef6-8680-804f8cb56b87,2026-11-10,2026-11-10,Deliveroo,5812,Food & Drink,Delivery,-22.33,GBP,-68678.64,E-Com,London,GB,9074,user_001,,
14cce734-6ed5-4a54-a883-45c36951d3f6,2026-11-11,2026-11-12,Airbnb,7011,Travel,Accommodation,-169.7,EUR,-68848.34,E-Com,Dublin,IE,9074,user_001,,Holiday booking
1b71fd01-ceb4-4edb-8b42-5d585bea100c,2026-11-11,2026-11-12,Thames Water,4900,Utilities,Water,-43.94,GBP,-68892.28,Direct Debit,Reading,GB,4488,user_001,rec_3a34d62842,
e42c9e49-b722-473a-9968-bbab17b077d9,2026-11-11,2026-11-11,Tesco,5411,Groceries,Supermarket,-29.96,GBP,-68922.24,POS,London,GB,1045,user_001,,
bfa9e93d-7bee-4326-8bc4-b6229d468e45,2026-11-12,2026-11-16,Apple.com/bill,5734,Shopping,Electronics,-23.8,USD,-68946.04,E-Com,Cupertino,US,4488,user_001,,FX purchase 29.0 USD @ rate 1.22
e586700f-5803-4ff2-a300-1eab6aaec852,2026-11-12,2026-11-16,Local Market,5499,Groceries,Specialty,-9.56,GBP,-68955.6,POS,London,GB,9074,user_001,,
63316e81-db5e-429e-976d-81017e5476fb,2026-11-13,2026-11-16,City Council Tax,9399,Utilities,Council Tax,-170.03,GBP,-69125.63,Direct Debit,London,GB,4488,user_001,rec_f531495db5,
be8ce5a1-2db7-4725-b517-bedd9e320c86,2026-11-13,2026-11-13,Deliveroo,5812,Food & Drink,Delivery,-32.0,GBP,-69157.63,E-Com,London,GB,1045,user_001,,
c3d5432b-ecfc-460f-bc2e-9b6b0dc74398,2026-11-13,2026-11-16,Tesco,5411,Groceries,Supermarket,-43.96,GBP,-69201.59,POS,London,GB,2219,user_001,,
76d8f227-3161-4dab-83c1-e8f6901dee4f,2026-11-14,2026-11-16,Deliveroo,5812,Food & Drink,Delivery,-25.6,GBP,-69227.19,E-Com,London,GB,4488,user_001,,
97066e19-a36a-44d0-a44d-a9fedf57db46,2026-11-14,2026-11-16,Uber UK,4121,Transport,Ride Hailing,-20.49,GBP,-69247.68,E-Com,London,GB,4488,user_001,,
acbcc655-d865-4ae2-9adf-ac8ebd4e8e12,2026-11-14,2026-11-16,Pret A Manger,5814,Food & Drink,Eating Out,-11.45,GBP,-69259.13,POS,London,GB,4488,user_001,,
c6e219cc-f5bc-455f-b804-4dc2ad67ac2c,2026-11-14,2026-11-16,Pret A Manger,5814,Food & Drink,Eating Out,-7.73,GBP,-69266.86,POS,London,GB,1045,user_001,,
431f3057-2027-467c-a409-54e914dc68b4,2026-11-15,2026-11-17,Local Market,5499,Groceries,Specialty,-10.89,GBP,-69277.75,POS,London,GB,9074,user_001,,
eea1374c-20c1-40d7-aff6-11b4d9547893,2026-11-15,2026-11-17,Local Market,5499,Groceries,Specialty,-14.8,GBP,-69292.55,POS,London,GB,2219,user_002,,
fc19dbba-98bf-4ceb-9848-e9b21546246e,2026-11-15,2026-11-16,Apple.com/bill,5734,Shopping,Electronics,-110.67,GBP,-69403.22,E-Com,Cupertino,US,2219,user_001,,
827908f9-bbdf-4e03-ad01-ea4b36138bb3,2026-11-16,2026-11-16,Waitrose,5411,Groceries,Supermarket,-81.65,GBP,-69484.87,POS,London,GB,1045,user_001,,
c33dc694-dc80-4773-a81f-10b5cc89a3eb,2026-11-16,2026-11-17,O2 UK,4814,Bills,Mobile,-53.95,GBP,-69538.82,Direct Debit,Slough,GB,4488,user_001,rec_95042d8101,
da7c6e84-0a44-4ef0-8dad-b3e00fc033ce,2026-11-16,2026-11-16,Uber UK,4121,Transport,Ride Hailing,-19.32,GBP,-69558.14,E-Com,London,GB,2219,user_002,,
3d216383-3c86-415d-9656-ecab0f9c847d,2026-11-17,2026-11-18,Tesco,5411,Groceries,Supermarket,-77.2,GBP,-69635.34,POS,London,GB,2219,user_001,,
6870f32e-7716-4830-a0e5-e3200934402e,2026-11-17,2026-11-19,GymBox,7997,Wellness,Gym,-58.98,GBP,-69694.32,Direct Debit,London,GB,4488,user_002,rec_19771e79cd,
822f05bd-3131-4909-873a-62d10bb97d09,2026-11-17,2026-11-18,Transport for London,4111,Transport,Transit,-4.32,GBP,-69698.64,POS,London,GB,4488,user_002,,
c8d0910b-21d8-4390-b4a9-5b3c84e5fd48,2026-11-17,2026-11-18,Sainsbury's,5411,Groceries,Supermarket,-18.05,GBP,-69716.69,POS,London,GB,1045,user_001,,
1d91bb30-3fc3-449b-a5de-23e480d4d506,2026-11-18,2026-11-20,Sainsbury's,5411,Groceries,Supermarket,-25.43,GBP,-69742.12,POS,London,GB,4488,user_001,,
e6cd11d7-283e-439d-9c06-126ff61cd2cc,2026-11-18,2026-11-20,Sainsbury's,5411,Groceries,Supermarket,-19.52,GBP,-69761.64,POS,London,GB,2219,user_001,,
f70571e8-ca3b-4a7d-b5ae-fd1189e843f6,2026-11-18,2026-11-19,Uber UK,4121,Transport,Ride Hailing,-19.68,GBP,-69781.32,E-Com,London,GB,1045,user_002,,
016c0e93-3f69-4f0a-9336-4b8793fe27d5,2026-11-19,2026-11-20,Spotify,5735,Entertainment,Subscriptions,-8.69,GBP,-69790.01,E-Com,Stockholm,SE,1045,user_001,rec_4c746d2c3b,
cfd5c50a-02de-4d71-ae16-f1b936b8ac10,2026-11-19,2026-11-19,Waitrose,5411,Groceries,Supermarket,-89.97,GBP,-69879.98,POS,London,GB,2219,user_001,,
e4bedbcb-2779-4266-9437-b48d78886f63,2026-11-19,2026-11-23,Uber UK,4121,Transport,Ride Hailing,-9.78,GBP,-69889.76,E-Com,London,GB,4488,user_002,,
431aafbb-8beb-4476-b9f4-c96fe3310dbd,2026-11-21,2026-11-23,Apple.com/bill,5734,Shopping,Electronics,-46.09,USD,-69935.85,E-Com,Cupertino,US,4488,user_001,,FX purchase 59.15 USD @ rate 1.28
b556b8aa-4271-4520-a225-e83d7a64f960,2026-11-21,2026-11-23,Amazon UK,5942,Shopping,Online Retail,-90.0,GBP,-70025.85,E-Com,London,GB,4488,user_001,,
de0f216e-b3cf-4b2f-8c5e-88d76e8bc9e7,2026-11-21,2026-11-23,Uber UK,4121,Transport,Ride Hailing,-15.6,GBP,-70041.45,E-Com,London,GB,4488,user_001,,
ee2ccb21-ed00-42b2-8c7b-3b265d25a517,2026-11-21,2026-11-23,Deliveroo,5812,Food & Drink,Delivery,-31.12,GBP,-70072.57,E-Com,London,GB,9074,user_002,,
21f10975-0b9a-43e3-ad82-e431d5e7e8d1,2026-11-22,2026-11-23,Apple.com/bill,5734,Shopping,Electronics,-116.26,USD,-70188.83,E-Com,Cupertino,US,2219,user_001,,FX purchase 145.07 USD @ rate 1.25
a4473bb0-ed4c-43d8-82bf-88041342fc20,2026-11-22,2026-11-23,Sainsbury's,5411,Groceries,Supermarket,-63.11,GBP,-70251.94,POS,London,GB,9074,user_001,,
cc0ef005-85f8-4af4-9ad8-4a35596ece07,2026-11-22,2026-11-23,Uber UK,4121,Transport,Ride Hailing,-27.68,GBP,-70279.62,E-Com,London,GB,2219,user_001,,
183e6dff-57d9-4126-b592-3b2a1400f184,2026-11-23,2026-11-23,Netflix,7841,Entertainment,Subscriptions,-10.15,GBP,-70289.77,E-Com,Los Gatos,US,9074,user_001,rec_1bfe33738d,
48ff560d-609a-4469-9662-fd80b9519d4d,2026-11-23,2026-11-23,Waitrose,5411,Groceries,Supermarket,-30.09,GBP,-70319.86,POS,London,GB,2219,user_001,,
278c2ff5-3631-4eab-951a-5c5f5f460f1d,2026-11-24,2026-11-26,Sainsbury's,5411,Groceries,Supermarket,-14.44,GBP,-70334.3,POS,London,GB,4488,user_002,,
6de1b3b4-69c3-4c3c-b4c4-b358fd5be8f0,2026-11-24,2026-11-24,Tesco,5411,Groceries,Supermarket,-56.29,GBP,-70390.59,POS,London,GB,2219,user_001,,
0289f013-6423-4c92-89ef-91c4641dbf92,2026-11-25,2026-11-26,Sainsbury's,5411,Groceries,Supermarket,-67.83,GBP,-70458.42,POS,London,GB,2219,user_001,,
08177b68-2dda-48c0-ada9-98b58b84eb8d,2026-11-25,2026-11-25,T212 Capital,6011,Income,Salary,3209.87,GBP,-67248.55,Credit,London,GB,4488,user_001,rec_2ff8f778d0,
20e36a65-3fd8-497f-ba07-a3ef0c3e8970,2026-11-25,2026-11-25,Waitrose,5411,Groceries,Supermarket,-44.94,GBP,-67293.49,POS,London,GB,1045,user_001,,
e3e6904e-a3bb-42ca-82b1-cd115ba29f8f,2026-11-27,2026-11-30,Amazon UK,5942,Shopping,Online Retail,-24.49,GBP,-67317.98,E-Com,London,GB,2219,user_001,,
ea55194f-243c-414f-a976-51e1552c0676,2026-11-27,2026-11-30,Tesco,5411,Groceries,Supermarket,-34.01,GBP,-67351.99,POS,London,GB,9074,user_001,,
1b6a5e92-f0e3-4686-b00f-168ac96c1881,2026-11-28,2026-11-30,Sainsbury's,5411,Groceries,Supermarket,-33.75,GBP,-67385.74,POS,London,GB,1045,user_001,,
2817cb74-ad54-4a12-8081-638aea643b64,2026-11-28,2026-11-30,Transport for London,4111,Transport,Transit,-10.38,GBP,-67396.12,POS,London,GB,1045,user_001,,
8ba6fd98-ab32-41ec-b852-3e6062f96f0d,2026-11-28,2026-11-30,Waitrose,5411,Groceries,Supermarket,-42.91,GBP,-67439.03,POS,London,GB,1045,user_001,,
992840c6-e931-4586-8b80-c2d2ed66e967,2026-11-28,2026-11-30,Uber UK,4121,Transport,Ride Hailing,-33.94,GBP,-67472.97,E-Com,London,GB,1045,user_001,,
bc4e569b-ac39-4b2b-a138-96857cc0b5ff,2026-11-28,2026-11-30,HM Revenue & Customs,9311,Income,Tax Refund,72.46,GBP,-67400.51,Credit,London,GB,2219,user_001,,Refund for Waitrose
d4234561-c846-40ca-b67f-7e113a78bb7c,2026-11-28,2026-11-30,Sainsbury's,5411,Groceries,Supermarket,-46.2,GBP,-67446.71,POS,London,GB,1045,user_002,,
bd0cdd19-5302-485f-9abe-ce2cbf664fab,2026-11-29,2026-11-30,Airline Refund,4511,Travel,Refund,29.82,GBP,-67416.89,Credit,London,GB,4488,user_002,,Refund for Deliveroo
bf1fca9f-a5ae-4c95-a442-cebccec1cae9,2026-11-29,2026-11-30,Apple.com/bill,5734,Shopping,Electronics,-50.6,GBP,-67467.49,E-Com,Cupertino,US,2219,user_002,,
da03a206-3b37-44ac-92a3-5ae6d3835c67,2026-11-29,2026-11-30,Uber UK,4121,Transport,Ride Hailing,-33.06,GBP,-67500.55,E-Com,London,GB,4488,user_002,,
f0613be8-18e0-4c25-92aa-2f46601b6016,2026-11-29,2026-12-01,Amazon UK,5942,Shopping,Online Retail,-111.02,GBP,-67611.57,E-Com,London,GB,9074,user_001,,
0696737d-2571-4dc5-9690-16e779f29c14,2026-11-30,2026-12-02,Apple.com/bill,5734,Shopping,Electronics,-55.13,GBP,-67666.7,E-Com,Cupertino,US,1045,user_001,,
08abd6b9-acb2-479f-b3ce-acfd91752574,2026-12-01,2026-12-03,Deliveroo,5812,Food & Drink,Delivery,-12.06,GBP,-67678.76,E-Com,London,GB,1045,user_001,,
23f5f2ba-8874-4c7c-9159-bff09f23acd6,2026-12-01,2026-12-01,Local Market,5499,Groceries,Specialty,-20.94,GBP,-67699.7,POS,London,GB,1045,user_001,,
4c774fdf-9538-484f-bbc5-2066faaf0c5f,2026-12-01,2026-12-02,Crown Estates Lettings,6513,Housing,Rent,-1495.48,GBP,-69195.18,POS,London,GB,1045,user_001,rec_19f70fbcce,
5ee75aba-61db-4ebb-8fd7-2d68357193e5,2026-12-01,2026-12-01,Deliveroo,5812,Food & Drink,Delivery,-14.29,GBP,-69209.47,E-Com,London,GB,4488,user_001,,
f37a1dc2-fae2-46ee-a02c-5125f13810b4,2026-12-01,2026-12-02,Pret A Manger,5814,Food & Drink,Eating Out,-9.25,GBP,-69218.72,POS,London,GB,9074,user_001,,
aeab7982-55ae-4ff6-951d-804df4db90bc,2026-12-02,2026-12-04,Pret A Manger,5814,Food & Drink,Eating Out,-10.8,GBP,-69229.52,POS,London,GB,9074,user_001,,
7c01651d-4869-47f7-923a-06130cbd1a16,2026-12-04,2026-12-07,ATM Withdrawal,6011,Cash,ATM,-80.02,GBP,-69309.54,ATM,London,GB,9074,user_001,,
dd3186fb-a0cd-4a0f-a40f-e73effe22cfe,2026-12-04,2026-12-07,Apple.com/bill,5734,Shopping,Electronics,-10.37,GBP,-69319.91,E-Com,Cupertino,US,4488,user_001,,
33a9fc1f-4cfc-41f8-bf49-7d6fb069b285,2026-12-05,2026-12-07,Sainsbury's,5411,Groceries,Supermarket,-57.61,GBP,-69377.52,POS,London,GB,4488,user_001,,
6959baac-64f2-4bc6-bdc0-40f745705e5d,2026-12-05,2026-12-07,Airline Refund,4511,Travel,Refund,12.21,GBP,-69365.31,Credit,London,GB,4488,user_002,,Refund for Uber UK
70933870-c017-4f43-aabe-cb49e78d052a,2026-12-05,2026-12-07,Waitrose,5411,Groceries,Supermarket,-82.08,GBP,-69447.39,POS,London,GB,2219,user_001,,
76379264-eb8c-4071-ad91-449f35a43fbc,2026-12-05,2026-12-07,Airline Refund,4511,Travel,Refund,14.14,GBP,-69433.25,Credit,London,GB,9074,user_001,,Refund for Sainsbury's
d34b1d97-4d04-4dac-9b07-3a184fcfa564,2026-12-05,2026-12-07,Waitrose,5411,Groceries,Supermarket,-23.95,GBP,-69457.2,POS,London,GB,1045,user_002,,
0765ba1b-e798-4032-b2a6-95335c4ab61f,2026-12-06,2026-12-08,Tesco,5411,Groceries,Supermarket,-77.41,GBP,-69534.61,POS,London,GB,1045,user_001,,
168653ea-1128-4216-bf85-b7347a3ea7a3,2026-12-06,2026-12-07,Amazon UK,5942,Shopping,Online Retail,-88.84,GBP,-69623.45,E-Com,London,GB,9074,user_001,,
3f5c57a9-79e1-4dc4-8cd5-f1c56d53b51e,2026-12-06,2026-12-07,Transport for London,4111,Transport,Transit,-10.93,GBP,-69634.38,POS,London,GB,4488,user_001,,
d18e2275-ae34-4791-851e-389f25ed2f92,2026-12-06,2026-12-08,Amazon UK,5942,Shopping,Online Retail,-117.97,GBP,-69752.35,E-Com,London,GB,2219,user_002,,
40286fcd-3de9-45dd-8245-290ecf4eb44d,2026-12-07,2026-12-09,Apple.com/bill,5734,Shopping,Electronics,-190.71,USD,-69943.06,E-Com,Cupertino,US,2219,user_001,,FX purchase 237.87 USD @ rate 1.25
aa57302a-91a1-491a-821b-b31f6afb05b1,2026-12-07,2026-12-09,Octopus Energy,4900,Utilities,Electricity,-121.94,GBP,-70065.0,Direct Debit,London,GB,1045,user_001,rec_141a4a0666,
2dcb4e8a-5343-4217-b17d-1de9a1ead006,2026-12-08,2026-12-10,Uber UK,4121,Transport,Ride Hailing,-23.86,GBP,-70088.86,E-Com,London,GB,4488,user_002,,
6537b5d1-0961-42bb-8f7b-e4dfcd46f983,2026-12-08,2026-12-08,Local Market,5499,Groceries,Specialty,-19.72,GBP,-70108.58,POS,London,GB,4488,user_001,,
cd14ec02-1ab8-488e-b14c-2d4e5571dd3b,2026-12-08,2026-12-10,Local Market,5499,Groceries,Specialty,-18.38,GBP,-70126.96,POS,London,GB,9074,user_001,,
1cdd7302-2bf9-4c44-95b4-9d497264e947,2026-12-11,2026-12-11,Thames Water,4900,Utilities,Water,-38.59,GBP,-70165.55,Direct Debit,Reading,GB,4488,user_002,rec_954d02400c,
248e3185-f1e9-4d41-9384-6effaf113bc5,2026-12-11,2026-12-14,Amazon UK,5942,Shopping,Online Retail,-103.33,GBP,-70268.88,E-Com,London,GB,1045,user_002,,
88cbfa5f-139a-4374-82fd-9fc6b4e4e79d,2026-12-11,2026-12-14,Deliveroo,5812,Food & Drink,Delivery,-16.08,GBP,-70284.96,E-Com,London,GB,9074,user_001,,
0e79f02a-8791-4f0a-9482-56e18820c574,2026-12-12,2026-12-14,Pret A Manger,5814,Food & Drink,Eating Out,-9.08,GBP,-70294.04,POS,London,GB,2219,user_001,,
359f22fe-885c-4b55-b0e5-89f3687b8793,2026-12-12,2026-12-14,Sainsbury's,5411,Groceries,Supermarket,-41.11,GBP,-70335.15,POS,London,GB,9074,user_001,,
7971ab74-f432-4a1d-a54f-f57acda64bb1,2026-12-12,2026-12-14,Pret A Manger,5814,Food & Drink,Eating Out,-10.33,GBP,-70345.48,POS,London,GB,4488,user_001,,
c2b1482a-1fa4-451c-b143-d3b6330f87ae,2026-12-12,2026-12-14,Amazon UK,5942,Shopping,Online Retail,-21.94,GBP,-70367.42,E-Com,London,GB,1045,user_001,,
fe9b9c04-c143-422a-b29a-0e9fa89378cc,2026-12-12,2026-12-14,Waitrose,5411,Groceries,Supermarket,-81.43,GBP,-70448.85,POS,London,GB,4488,user_001,,
18cc96af-772f-4316-aea0-3c3d970d8742,2026-12-13,2026-12-14,Apple.com/bill,5734,Shopping,Electronics,-57.27,USD,-70506.12,E-Com,Cupertino,US,4488,user_001,,FX purchase 72.06 USD @ rate 1.26
f11b163b-b43b-47d9-8ced-e33fd781ec15,2026-12-13,2026-12-14,Tesco,5411,Groceries,Supermarket,-60.06,GBP,-70566.18,POS,London,GB,9074,user_001,,
0b248a38-2ebc-4fb6-95fa-258fd55685b9,2026-12-14,2026-12-16,City Council Tax,9399,Utilities,Council Tax,-167.19,GBP,-70733.37,Direct Debit,London,GB,1045,user_001,rec_f531495db5,
dac3eee8-332f-4b1f-be5b-dfdf40e31af8,2026-12-14,2026-12-14,Local Market,5499,Groceries,Specialty,-10.47,GBP,-70743.84,POS,London,GB,9074,user_001,,
3cc58f66-497b-440d-a05e-692f92ce83be,2026-12-15,2026-12-17,O2 UK,4814,Bills,Mobile,-54.07,GBP,-70797.91,Direct Debit,Slough,GB,2219,user_001,rec_95042d8101,
41f50871-9d50-4cbd-aac1-708726596e8f,2026-12-15,2026-12-17,Transport for London,4111,Transport,Transit,-6.3,GBP,-70804.21,POS,London,GB,4488,user_001,,
4be3d0e0-c140-4706-9d19-23942081c244,2026-12-15,2026-12-17,Uber UK,4121,Transport,Ride Hailing,-17.95,GBP,-70822.16,E-Com,London,GB,9074,user_001,,
65221286-0bc9-4801-a93c-60c493787609,2026-12-15,2026-12-15,Tesco,5411,Groceries,Supermarket,-54.8,GBP,-70876.96,POS,London,GB,1045,user_002,,
f31c2dae-2968-4bc3-8a22-8f4bdb068870,2026-12-15,2026-12-17,Deliveroo,5812,Food & Drink,Delivery,-16.82,GBP,-70893.78,E-Com,London,GB,2219,user_001,,
4caee835-1d03-4f67-b82d-f72684907abf,2026-12-16,2026-12-16,HM Revenue & Customs,9311,Income,Tax Refund,14.2,GBP,-70879.58,Credit,London,GB,4488,user_001,,Refund for Amazon UK
5570733b-b553-4d9e-a48d-a6215ac18b79,2026-12-16,2026-12-17,Transport for London,4111,Transport,Transit,-9.28,GBP,-70888.86,POS,London,GB,9074,user_001,,
69022d64-9efb-46d2-9ef8-83032418bf98,2026-12-16,2026-12-16,Shell,5541,Transport,Fuel,-41.54,GBP,-70930.4,POS,London,GB,9074,user_001,,
aede5299-19bc-4fd2-a68c-acdabbc5f471,2026-12-16,2026-12-18,Waitrose,5411,Groceries,Supermarket,-79.43,GBP,-71009.83,POS,London,GB,1045,user_001,,
2e072eab-ae1e-4b75-a54c-6c0ab688396f,2026-12-17,2026-12-17,GymBox,7997,Wellness,Gym,-59.02,GBP,-71068.85,Direct Debit,London,GB,2219,user_001,rec_3906953fd2,
770d7675-da1f-47ab-8c14-131a4a05bbac,2026-12-17,2026-12-18,Deliveroo,5812,Food & Drink,Delivery,-26.18,GBP,-71095.03,E-Com,London,GB,2219,user_002,,
884f75b2-c22d-4a01-94a2-e7226a01ff76,2026-12-17,2026-12-21,Deliveroo,5812,Food & Drink,Delivery,-16.58,GBP,-71111.61,E-Com,London,GB,4488,user_001,,
8c4639de-4b69-478f-bbc1-2631c021ff91,2026-12-17,2026-12-18,Sainsbury's,5411,Groceries,Supermarket,-64.87,GBP,-71176.48,POS,London,GB,9074,user_001,,
dc964f6d-12a1-490b-b190-39c92942c83c,2026-12-17,2026-12-18,Pret A Manger,5814,Food & Drink,Eating Out,-10.43,GBP,-71186.91,POS,London,GB,1045,user_002,,
f4b5bab1-a707-45e1-aed9-005f3c69babe,2026-12-17,2026-12-18,Apple.com/bill,5734,Shopping,Electronics,-168.62,USD,-71355.53,E-Com,Cupertino,US,1045,user_001,,FX purchase 200.63 USD @ rate 1.19
52bfd760-620b-4b5e-8dab-c2779d499c33,2026-12-18,2026-12-21,Deliveroo,5812,Food & Drink,Delivery,-31.09,GBP,-71386.62,E-Com,London,GB,2219,user_001,,
f69e3e38-5a45-4d5e-ab41-c9537f29bf4b,2026-12-18,2026-12-21,Transport for London,4111,Transport,Transit,-8.37,GBP,-71394.99,POS,London,GB,9074,user_001,,
f9e168ea-39fd-4537-b064-e89a3c4f6f8b,2026-12-18,2026-12-21,Shell,5541,Transport,Fuel,-72.63,GBP,-71467.62,POS,London,GB,4488,user_001,,
2157b21e-ae84-4c5c-a2b5-bc6abe185f0b,2026-12-19,2026-12-21,Local Market,5499,Groceries,Specialty,-12.23,GBP,-71479.85,POS,London,GB,2219,user_001,,
53e08335-753f-49f4-88b4-8794e9b008d0,2026-12-19,2026-12-21,Pret A Manger,5814,Food & Drink,Eating Out,-11.36,GBP,-71491.21,POS,London,GB,2219,user_001,,
5f3d4e95-6be3-4510-9d59-85d84dac3d84,2026-12-19,2026-12-21,Deliveroo,5812,Food & Drink,Delivery,-14.52,GBP,-71505.73,E-Com,London,GB,9074,user_002,,
634722fb-afb6-4f58-84af-98c0ac919d20,2026-12-19,2026-12-21,Apple.com/bill,5734,Shopping,Electronics,-37.29,GBP,-71543.02,E-Com,Cupertino,US,2219,user_002,,
e5142939-7796-4b7e-9499-f0ded9fdf11e,2026-12-19,2026-12-21,Pret A Manger,5814,Food & Drink,Eating Out,-9.74,GBP,-71552.76,POS,London,GB,1045,user_001,,
274792f3-0b0b-427e-aa6c-e42dc394c41f,2026-12-20,2026-12-21,Apple.com/bill,5734,Shopping,Electronics,-45.79,GBP,-71598.55,E-Com,Cupertino,US,2219,user_001,,
16409777-d726-42fd-af4d-3cb8afbc710f,2026-12-21,2026-12-22,Spotify,5735,Entertainment,Subscriptions,-9.1,GBP,-71607.65,E-Com,Stockholm,SE,1045,user_001,rec_4c746d2c3b,
4a17d8df-4a96-4257-8f3e-f712169e3b7b,2026-12-21,2026-12-23,Netflix,7841,Entertainment,Subscriptions,-13.4,GBP,-71621.05,E-Com,Los Gatos,US,4488,user_001,rec_1bfe33738d,
cbb109d9-494f-49fc-9863-6d6d683e2dd5,2026-12-21,2026-12-22,Apple.com/bill,5734,Shopping,Electronics,-9.21,USD,-71630.26,E-Com,Cupertino,US,2219,user_001,,FX purchase 12.0 USD @ rate 1.30
f8572b4d-0a11-48cb-985b-570a1b877bfb,2026-12-21,2026-12-23,Sainsbury's,5411,Groceries,Supermarket,-69.97,GBP,-71700.23,POS,London,GB,9074,user_001,,
b9a3703c-60fd-4b85-a0e0-9a980026fed6,2026-12-22,2026-12-23,Shell,5541,Transport,Fuel,-62.95,GBP,-71763.18,POS,London,GB,1045,user_001,,
7cc5b119-f94c-4e41-96aa-9d2a1dffab56,2026-12-23,2026-12-23,Pret A Manger,5814,Food & Drink,Eating Out,-11.29,GBP,-71774.47,POS,London,GB,9074,user_001,,
8abb51cb-0110-430f-b406-ad9990897822,2026-12-23,2026-12-23,Uber UK,4121,Transport,Ride Hailing,-13.23,GBP,-71787.7,E-Com,London,GB,1045,user_001,,
14c0921f-781a-4179-a15e-180f5fe79301,2026-12-24,2026-12-28,Pret A Manger,5814,Food & Drink,Eating Out,-6.98,GBP,-71794.68,POS,London,GB,9074,user_001,,
66784164-8a29-4367-8af0-f084b978a64d,2026-12-24,2026-12-28,Pret A Manger,5814,Food & Drink,Eating Out,-10.01,GBP,-71804.69,POS,London,GB,1045,user_002,,
b6f85d1a-2359-40e4-b548-3d73fd700c31,2026-12-24,2026-12-25,Local Market,5499,Groceries,Specialty,-15.74,GBP,-71820.43,POS,London,GB,1045,user_001,,
57a3cf8f-898e-4123-a0ab-5dc4aa308000,2026-12-25,2026-12-25,HM Revenue & Customs,9311,Income,Tax Refund,6.75,GBP,-71813.68,Credit,London,GB,9074,user_001,,Refund for Deliveroo
5f7af52d-f9d8-4f9b-86c1-972f05a52419,2026-12-25,2026-12-25,T212 Capital,6011,Income,Salary,3166.36,GBP,-68647.32,Credit,London,GB,9074,user_001,rec_2ff8f778d0,
fbb97353-f461-4369-988c-4c15486126da,2026-12-25,2026-12-28,Shell,5541,Transport,Fuel,-90.06,GBP,-68737.38,POS,London,GB,2219,user_001,,
0eda0614-ad05-438e-bd19-e61f9b8ca5e8,2026-12-26,2026-12-28,Pret A Manger,5814,Food & Drink,Eating Out,-11.74,GBP,-68749.12,POS,London,GB,9074,user_002,,
1b923ad7-4ee3-413b-8ad7-7e67db05564c,2026-12-26,2026-12-28,Waitrose,5411,Groceries,Supermarket,-74.45,GBP,-68823.57,POS,London,GB,2219,user_001,,
95bc44a7-02f2-4067-8e58-6d500b87876d,2026-12-26,2026-12-28,Tesco,5411,Groceries,Supermarket,-39.23,GBP,-68862.8,POS,London,GB,2219,user_002,,
1d5474aa-ba74-43b6-a029-4fc2d03d9d0c,2026-12-27,2026-12-28,Deliveroo,5812,Food & Drink,Delivery,-20.91,GBP,-68883.71,E-Com,London,GB,4488,user_001,,
679e1e01-70b9-44ca-a9f2-e0bf8fefda55,2026-12-27,2026-12-29,Tesco,5411,Groceries,Supermarket,-52.67,GBP,-68936.38,POS,London,GB,9074,user_001,,
bf444c87-f3c4-40f2-90bc-ca2a46e29dcd,2026-12-27,2026-12-28,Waitrose,5411,Groceries,Supermarket,-55.72,GBP,-68992.1,POS,London,GB,4488,user_002,,
38dba196-3be3-4f31-8f11-25324794987d,2026-12-28,2026-12-30,Waitrose,5411,Groceries,Supermarket,-53.77,GBP,-69045.87,POS,London,GB,9074,user_001,,
4c63ae47-7f42-402a-86db-5870c712a7f9,2026-12-28,2026-12-29,Amazon UK,5942,Shopping,Online Retail,-21.69,GBP,-69067.56,E-Com,London,GB,1045,user_001,,
76583a19-3d19-4582-b9be-1cf803312c50,2026-12-28,2026-12-29,Local Market,5499,Groceries,Specialty,-19.47,GBP,-69087.03,POS,London,GB,2219,user_001,,
836287ed-6482-43f8-9946-d353268d9b87,2026-12-28,2026-12-30,Uber UK,4121,Transport,Ride Hailing,-19.23,GBP,-69106.26,E-Com,London,GB,1045,user_001,,
ce86f7fe-796b-436d-8fab-5f374c267794,2026-12-28,2026-12-29,Local Market,5499,Groceries,Specialty,-9.64,GBP,-69115.9,POS,London,GB,1045,user_001,,
3f525b05-89dd-4fac-a1e6-3f4ecc11483c,2026-12-29,2026-12-31,Waitrose,5411,Groceries,Supermarket,-41.14,GBP,-69157.04,POS,London,GB,2219,user_002,,
4f027823-dc27-43a2-980f-4d559b31538c,2026-12-29,2026-12-30,Apple.com/bill,5734,Shopping,Electronics,-146.47,USD,-69303.51,E-Com,Cupertino,US,2219,user_001,,FX purchase 187.91 USD @ rate 1.28
6660579e-9cbf-427a-b0ad-82ab4826aa43,2026-12-29,2026-12-29,Tesco,5411,Groceries,Supermarket,-50.55,GBP,-69354.06,POS,London,GB,4488,user_001,,
93994845-3ad0-49be-9295-2fa43b442933,2026-12-29,2026-12-31,Sainsbury's,5411,Groceries,Supermarket,-17.43,GBP,-69371.49,POS,London,GB,1045,user_001,,
9b139d8f-9ec1-4b81-832b-9cf67751f734,2026-12-31,2027-01-04,Transport for London,4111,Transport,Transit,-9.4,GBP,-69380.89,POS,London,GB,2219,user_001,,
b20ff940-f377-4cea-9c70-5928f3db1422,2026-12-31,2026-12-31,Amazon UK,5942,Shopping,Online Retail,-114.45,GBP,-69495.34,E-Com,London,GB,1045,user_001,,
e354aed0-d496-4098-b312-16821f2f8774,2026-12-31,2026-12-31,Tesco,5411,Groceries,Supermarket,-62.48,GBP,-69557.82,POS,London,GB,1045,user_001,,
1cb63036-6279-4201-bbce-eb45af560722,2027-01-01,2027-01-04,Crown Estates Lettings,6513,Housing,Rent,-1454.12,GBP,-71011.94,POS,London,GB,2219,user_001,rec_19f70fbcce,
ec2038c2-ed6b-48ac-855c-466c901bb0a1,2027-01-01,2027-01-01,Transport for London,4111,Transport,Transit,-4.25,GBP,-71016.19,POS,London,GB,4488,user_001,,
1a6b94ea-a385-4816-a2b4-39288d985624,2027-01-02,2027-01-04,Transport for London,4111,Transport,Transit,-4.01,GBP,-71020.2,POS,London,GB,2219,user_002,,
332224a0-bcff-4043-b8f1-697911684046,2027-01-02,2027-01-04,Pret A Manger,5814,Food & Drink,Eating Out,-11.95,GBP,-71032.15,POS,London,GB,1045,user_001,,
44b8c55b-4fd6-407b-8bd5-303204fabe74,2027-01-02,2027-01-04,Local Market,5499,Groceries,Specialty,-14.82,GBP,-71046.97,POS,London,GB,4488,user_002,,
9abb30ba-d91d-41ea-afd8-af4409c14a4b,2027-01-02,2027-01-04,Local Market,5499,Groceries,Specialty,-21.41,GBP,-71068.38,POS,London,GB,1045,user_001,,
b1c71dc7-672b-495c-beb7-93e9c02ca260,2027-01-02,2027-01-04,Waitrose,5411,Groceries,Supermarket,-20.61,GBP,-71088.99,POS,London,GB,4488,user_002,,
f9a6a307-bf88-4e84-a61a-86df0f2d90e3,2027-01-03,2027-01-04,Local Market,5499,Groceries,Specialty,-12.68,GBP,-71101.67,POS,London,GB,2219,user_001,,
748b42b4-71c9-47d4-87a9-6b9177b76a4b,2027-01-06,2027-01-07,Waitrose,5411,Groceries,Supermarket,-33.95,GBP,-71135.62,POS,London,GB,1045,user_001,,
b84b3c0c-3baa-414c-846d-b200800fe20e,2027-01-06,2027-01-08,Uber UK,4121,Transport,Ride Hailing,-34.17,GBP,-71169.79,E-Com,London,GB,2219,user_001,,
e8e94bef-7219-4fe9-8806-06ffc32d03d0,2027-01-06,2027-01-07,Apple.com/bill,5734,Shopping,Electronics,-139.33,USD,-71309.12,E-Com,Cupertino,US,2219,user_001,,FX purchase 171.52 USD @ rate 1.23
108ada13-3afd-438a-b8b9-b6d95f49eaf9,2027-01-07,2027-01-11,Waitrose,5411,Groceries,Supermarket,-39.7,GBP,-71348.82,POS,London,GB,2219,user_001,,
68d8fddd-d717-4722-96b1-2be706ada623,2027-01-07,2027-01-11,Octopus Energy,4900,Utilities,Electricity,-121.77,GBP,-71470.59,Direct Debit,London,GB,4488,user_001,rec_141a4a0666,
bb7fd512-3326-44b6-aced-149cf044296e,2027-01-07,2027-01-11,Tesco,5411,Groceries,Supermarket,-45.12,GBP,-71515.71,POS,London,GB,1045,user_001,,
4d0d0654-fc93-4c65-8de0-0fe495a1f5cd,2027-01-09,2027-01-11,Local Market,5499,Groceries,Specialty,-19.76,GBP,-71535.47,POS,London,GB,2219,user_001,,
b4489d1e-0350-4df0-bc3b-df1f97f359cb,2027-01-09,2027-01-11,Apple.com/bill,5734,Shopping,Electronics,-88.28,USD,-71623.75,E-Com,Cupertino,US,4488,user_001,,FX purchase 112.56 USD @ rate 1.28
c8e3b121-6440-495a-ad44-59555184760f,2027-01-09,2027-01-11,Apple.com/bill,5734,Shopping,Electronics,-203.92,USD,-71827.67,E-Com,Cupertino,US,1045,user_001,,FX purchase 256.32 USD @ rate 1.26
26a651d0-98fa-47eb-9182-ea6d14ca523e,2027-01-10,2027-01-11,Deliveroo,5812,Food & Drink,Delivery,-20.97,GBP,-71848.64,E-Com,London,GB,9074,user_002,,
5210f433-0e99-4c1c-bacd-72175fc847ce,2027-01-10,2027-01-12,Tesco,5411,Groceries,Supermarket,-79.3,GBP,-71927.94,POS,London,GB,1045,user_001,,
5600d339-e76b-4e97-9eaf-844954c3830f,2027-01-10,2027-01-11,Waitrose,5411,Groceries,Supermarket,-75.46,GBP,-72003.4,POS,London,GB,9074,user_001,,
73599adf-91ca-482e-8195-9b5344ee3e47,2027-01-10,2027-01-12,Amazon UK,5942,Shopping,Online Retail,-47.23,GBP,-72050.63,E-Com,London,GB,4488,user_001,,
8f3996e1-2228-40d5-bd00-badcab3ca97e,2027-01-10,2027-01-11,HM Revenue & Customs,9311,Income,Tax Refund,6.93,GBP,-72043.7,Credit,London,GB,4488,user_001,,Refund for Spotify
84ae0a4e-59ef-4c33-a5ae-97e10c5ca196,2027-01-11,2027-01-12,Sainsbury's,5411,Groceries,Supermarket,-59.49,GBP,-72103.19,POS,London,GB,9074,user_001,,
c2867bf7-6e17-4b98-9179-961f3250e521,2027-01-11,2027-01-12,Thames Water,4900,Utilities,Water,-33.98,GBP,-72137.17,Direct Debit,Reading,GB,9074,user_001,rec_3a34d62842,
014c4bdd-657e-4766-9a49-5f5c31652c53,2027-01-12,2027-01-12,Local Market,5499,Groceries,Specialty,-19.58,GBP,-72156.75,POS,London,GB,9074,user_001,,
1d97f5eb-5cd7-43d2-92e6-7229f387bcda,2027-01-12,2027-01-12,Sainsbury's,5411,Groceries,Supermarket,-67.51,GBP,-72224.26,POS,London,GB,1045,user_001,,
24eea6cc-3c1c-4925-8893-179076df193f,2027-01-13,2027-01-15,City Council Tax,9399,Utilities,Council Tax,-172.98,GBP,-72397.24,Direct Debit,London,GB,9074,user_001,rec_f531495db5,
df37113f-1df8-45d3-91b9-22447f0a3002,2027-01-13,2027-01-13,ATM Withdrawal,6011,Cash,ATM,-99.05,GBP,-72496.29,ATM,London,GB,4488,user_001,,
0e27831a-cadc-44ec-ac5b-2fc3ead0f3af,2027-01-14,2027-01-14,Uber UK,4121,Transport,Ride Hailing,-25.28,GBP,-72521.57,E-Com,London,GB,4488,user_001,,
2f14612f-fc05-474d-951f-c4dfb8bb15a4,2027-01-14,2027-01-14,Pret A Manger,5814,Food & Drink,Eating Out,-6.16,GBP,-72527.73,POS,London,GB,1045,user_001,,
8d14179b-1733-402c-b175-f41d566fec72,2027-01-14,2027-01-18,Apple.com/bill,5734,Shopping,Electronics,-192.7,GBP,-72720.43,E-Com,Cupertino,US,9074,user_001,,
72d51911-f145-4ab6-82ed-c568cdf374c4,2027-01-15,2027-01-18,Amazon UK,5942,Shopping,Online Retail,-109.92,GBP,-72830.35,E-Com,London,GB,4488,user_001,,
8e57f8e0-18ec-472e-99bb-fb25413c9fa0,2027-01-15,2027-01-18,O2 UK,4814,Bills,Mobile,-51.16,GBP,-72881.51,Direct Debit,Slough,GB,2219,user_002,rec_d2dce4c42f,
91243f1e-dc95-44fd-9178-4ccbb329da67,2027-01-15,2027-01-18,Uber UK,4121,Transport,Ride Hailing,-15.95,GBP,-72897.46,E-Com,London,GB,1045,user_001,,
d17dd1d9-f555-4a49-8dac-eb78c4c61526,2027-01-15,2027-01-18,Deliveroo,5812,Food & Drink,Delivery,-29.11,GBP,-72926.57,E-Com,London,GB,9074,user_001,,
29f2d8f4-3781-4faa-84ef-edc86789dd16,2027-01-16,2027-01-18,Shell,5541,Transport,Fuel,-39.81,GBP,-72966.38,POS,London,GB,9074,user_001,,
7ae33f87-4427-43a1-b9aa-6ec07d7ec3fe,2027-01-16,2027-01-18,Uber UK,4121,Transport,Ride Hailing,-13.3,GBP,-72979.68,E-Com,London,GB,1045,user_001,,
bc749072-79ff-40c9-8bc5-3a64a0c5e2b3,2027-01-16,2027-01-18,Deliveroo,5812,Food & Drink,Delivery,-21.73,GBP,-73001.41,E-Com,London,GB,4488,user_001,,
f72dd69a-39a3-477b-806e-ff363d2bca28,2027-01-16,2027-01-18,Sainsbury's,5411,Groceries,Supermarket,-37.43,GBP,-73038.84,POS,London,GB,9074,user_001,,
0032ed7c-82f7-4d93-b7c0-b2b627a514fd,2027-01-17,2027-01-19,Transport for London,4111,Transport,Transit,-6.33,GBP,-73045.17,POS,London,GB,2219,user_001,,
778c80cf-a07a-4fd4-b33c-dd406cb2bf20,2027-01-17,2027-01-18,Deliveroo,5812,Food & Drink,Delivery,-17.51,GBP,-73062.68,E-Com,London,GB,1045,user_001,,
5fc4a1a5-5349-48e3-ac91-e1945b030d43,2027-01-18,2027-01-18,Pret A Manger,5814,Food & Drink,Eating Out,-9.35,GBP,-73072.03,POS,London,GB,2219,user_002,,
99d27554-d630-46e8-919c-32d900c09c5c,2027-01-18,2027-01-19,GymBox,7997,Wellness,Gym,-64.81,GBP,-73136.84,Direct Debit,London,GB,9074,user_001,rec_3906953fd2,
b66b3c88-0679-42f4-a492-e568aca36754,2027-01-19,2027-01-21,Spotify,5735,Entertainment,Subscriptions,-9.59,EUR,-73146.43,E-Com,Stockholm,SE,2219,user_001,rec_4c746d2c3b,FX purchase 11.47 EUR @ rate 1.20
b07b7151-2dff-455a-8c5a-bd8b5e7b2e90,2027-01-20,2027-01-21,Tesco,5411,Groceries,Supermarket,-60.97,GBP,-73207.4,POS,London,GB,9074,user_001,,
e587161c-7557-4376-9881-358c67f760e9,2027-01-20,2027-01-20,Uber UK,4121,Transport,Ride Hailing,-28.04,GBP,-73235.44,E-Com,London,GB,1045,user_002,,
8d8c616a-2199-4162-9c7d-ebf2419c6da3,2027-01-21,2027-01-25,Netflix,7841,Entertainment,Subscriptions,-15.08,USD,-73250.52,E-Com,Los Gatos,US,4488,user_001,rec_1bfe33738d,FX purchase 18.13 USD @ rate 1.20
3c3e0f21-a261-4571-b7cb-0825b21c3611,2027-01-22,2027-01-25,Uber UK,4121,Transport,Ride Hailing,-9.5,GBP,-73260.02,E-Com,London,GB,1045,user_001,,
da4c546e-148a-4ce0-988d-ee4a86a396e4,2027-01-22,2027-01-25,Shell,5541,Transport,Fuel,-53.2,GBP,-73313.22,POS,London,GB,2219,user_002,,
1ab25d81-cad4-42d0-8c15-d6714d381ec7,2027-01-23,2027-01-25,Uber UK,4121,Transport,Ride Hailing,-22.03,GBP,-73335.25,E-Com,London,GB,9074,user_001,,
496243b5-d5f9-4fb0-b1df-7ae18af55406,2027-01-23,2027-01-25,Waitrose,5411,Groceries,Supermarket,-31.27,GBP,-73366.52,POS,London,GB,9074,user_002,,
5e196860-9b4d-407f-905c-67046908c86f,2027-01-23,2027-01-25,Transport for London,4111,Transport,Transit,-11.93,GBP,-73378.45,POS,London,GB,2219,user_001,,
90e320b1-0fff-456f-a087-ae2823950ffb,2027-01-23,2027-01-25,Transport for London,4111,Transport,Transit,-6.64,GBP,-73385.09,POS,London,GB,9074,user_001,,
9888d221-badf-47da-ac17-79a0b4a843ae,2027-01-23,2027-01-25,ATM Withdrawal,6011,Cash,ATM,-84.52,GBP,-73469.61,ATM,London,GB,1045,user_001,,
f4c7b4d0-8832-432a-95ff-38d8f7b147b3,2027-01-23,2027-01-25,Sainsbury's,5411,Groceries,Supermarket,-44.09,GBP,-73513.7,POS,London,GB,1045,user_001,,
08c38b00-20b0-42fb-ac62-ddaea8050a63,2027-01-24,2027-01-25,Uber UK,4121,Transport,Ride Hailing,-35.75,GBP,-73549.45,E-Com,London,GB,2219,user_001,,
3867730e-2802-45c6-9ded-63a4d59e8697,2027-01-24,2027-01-25,Amazon UK,5942,Shopping,Online Retail,-15.87,GBP,-73565.32,E-Com,London,GB,9074,user_001,,
6ee98ae0-2029-44f2-8e3a-49056a0e294d,2027-01-24,2027-01-25,Shell,5541,Transport,Fuel,-73.0,GBP,-73638.32,POS,London,GB,2219,user_001,,
ae71f004-b54e-477a-9e97-0fa73d36dace,2027-01-24,2027-01-25,Tesco,5411,Groceries,Supermarket,-81.8,GBP,-73720.12,POS,London,GB,2219,user_002,,
b917ce8b-ac07-4b30-980d-699d9d82462c,2027-01-24,2027-01-25,Shell,5541,Transport,Fuel,-68.17,GBP,-73788.29,POS,London,GB,2219,user_001,,
c304b5c1-b603-4a83-8116-ca95870352f9,2027-01-24,2027-01-25,Pret A Manger,5814,Food & Drink,Eating Out,-6.26,GBP,-73794.55,POS,London,GB,1045,user_001,,
e7e2ebde-4eda-4e62-afb4-8d6f2a54c729,2027-01-24,2027-01-25,Amazon UK,5942,Shopping,Online Retail,-30.86,GBP,-73825.41,E-Com,London,GB,9074,user_001,,
e8938725-ccc0-4e47-870c-eb3a0cfe5d4f,2027-01-24,2027-01-25,HM Revenue & Customs,9311,Income,Tax Refund,21.34,GBP,-73804.07,Credit,London,GB,2219,user_001,,Refund for Uber UK
edc88e55-042a-481d-8a94-f899188ac545,2027-01-24,2027-01-25,Apple.com/bill,5734,Shopping,Electronics,-6.11,GBP,-73810.18,E-Com,Cupertino,US,9074,user_002,,
147be1f0-1741-4e44-a710-c5c3101bc5d4,2027-01-25,2027-01-25,T212 Capital,6011,Income,Salary,3228.02,GBP,-70582.16,Credit,London,GB,1045,user_001,rec_2ff8f778d0,
1d25a951-a10a-4473-bd2c-1842f4ce882e,2027-01-25,2027-01-26,Pret A Manger,5814,Food & Drink,Eating Out,-11.83,GBP,-70593.99,POS,London,GB,1045,user_001,,
1e335ab6-a906-455e-901a-9415dc4da7d6,2027-01-25,2027-01-26,Shell,5541,Transport,Fuel,-82.0,GBP,-70675.99,POS,London,GB,2219,user_001,,
6b0fc58a-d55a-4413-b12a-951c979b646f,2027-01-25,2027-01-26,Shell,5541,Transport,Fuel,-66.49,GBP,-70742.48,POS,London,GB,9074,user_001,,
e4e9fcb2-bbf4-4843-b965-749a0bf58551,2027-01-25,2027-01-27,Pret A Manger,5814,Food & Drink,Eating Out,-9.7,GBP,-70752.18,POS,London,GB,2219,user_001,,
afc59111-c3ba-4cfe-92b8-087c3d9e8861,2027-01-26,2027-01-27,Waitrose,5411,Groceries,Supermarket,-58.99,GBP,-70811.17,POS,London,GB,2219,user_001,,
65b4d41f-35aa-4b45-ac3a-7de2d4693468,2027-01-27,2027-01-28,Pret A Manger,5814,Food & Drink,Eating Out,-8.09,GBP,-70819.26,POS,London,GB,4488,user_001,,
aa23819a-7b79-4326-8ea2-dd27b8f04b99,2027-01-27,2027-01-27,Pret A Manger,5814,Food & Drink,Eating Out,-8.56,GBP,-70827.82,POS,London,GB,9074,user_002,,
eb646af8-a4df-4f0f-a3f5-a2ee92353e4c,2027-01-27,2027-01-27,Waitrose,5411,Groceries,Supermarket,-85.57,GBP,-70913.39,POS,London,GB,1045,user_001,,
7e1dde5b-c262-4230-bbad-5154ecc0b23a,2027-01-28,2027-01-29,Uber UK,4121,Transport,Ride Hailing,-23.65,GBP,-70937.04,E-Com,London,GB,1045,user_002,,
4fd358d6-af14-4e33-88c6-e96f8b2c7b89,2027-01-29,2027-02-01,Uber UK,4121,Transport,Ride Hailing,-15.82,GBP,-70952.86,E-Com,London,GB,2219,user_001,,
b04fa1ed-c7cd-4b2a-9c86-8a607033fac5,2027-01-29,2027-02-01,Waitrose,5411,Groceries,Supermarket,-65.24,GBP,-71018.1,POS,London,GB,1045,user_002,,
42a400d7-b399-4b31-b4f9-f5b0fdba1e7a,2027-01-30,2027-02-01,Local Market,5499,Groceries,Specialty,-21.54,GBP,-71039.64,POS,London,GB,1045,user_001,,
4f64f53a-90c7-48ca-8660-0bc4c3893933,2027-01-30,2027-02-01,Sainsbury's,5411,Groceries,Supermarket,-18.48,GBP,-71058.12,POS,London,GB,9074,user_001,,
60afcb72-1ea7-441e-9855-17034687a6bf,2027-01-30,2027-02-01,Pret A Manger,5814,Food & Drink,Eating Out,-6.45,GBP,-71064.57,POS,London,GB,9074,user_001,,
b2e88965-9fe7-48d2-92df-747fdb30f04d,2027-01-30,2027-02-01,Local Market,5499,Groceries,Specialty,-9.24,GBP,-71073.81,POS,London,GB,2219,user_002,,
e2f7f151-4cbe-47a3-bd63-fe9791f99cec,2027-01-30,2027-02-01,Pret A Manger,5814,Food & Drink,Eating Out,-10.85,GBP,-71084.66,POS,London,GB,9074,user_001,,
f1d7a2d5-9bc5-43eb-a612-727051b610f0,2027-01-30,2027-02-01,Shell,5541,Transport,Fuel,-41.51,GBP,-71126.17,POS,London,GB,4488,user_001,,
91811c84-24d6-4172-99eb-dc15424dd04b,2027-01-31,2027-02-01,Uber UK,4121,Transport,Ride Hailing,-15.7,GBP,-71141.87,E-Com,London,GB,1045,user_002,,
bc1a5e2e-21c5-4bea-a541-6659764b0e09,2027-01-31,2027-02-01,Shell,5541,Transport,Fuel,-89.87,GBP,-71231.74,POS,London,GB,1045,user_002,,
c4181233-a9c8-490b-81c7-5a24212f705e,2027-01-31,2027-02-02,Apple.com/bill,5734,Shopping,Electronics,-45.66,USD,-71277.4,E-Com,Cupertino,US,4488,user_002,,FX purchase 57.27 USD @ rate 1.25
d7403b65-5243-448c-97e1-fb97f2e6ec23,2027-01-31,2027-02-01,Local Market,5499,Groceries,Specialty,-9.77,GBP,-71287.17,POS,London,GB,9074,user_002,,
c1d9e2d9-e545-47b3-bc6d-b6cdb8ddc82f,2027-02-01,2027-02-01,Tesco,5411,Groceries,Supermarket,-71.63,GBP,-71358.8,POS,London,GB,9074,user_001,,
d381f3ee-5f7a-4744-8eb5-ef5d9d3fe560,2027-02-01,2027-02-03,Uber UK,4121,Transport,Ride Hailing,-23.42,GBP,-71382.22,E-Com,London,GB,2219,user_001,,
e5cc8379-dcf8-48a2-8021-03b95f96f92f,2027-02-01,2027-02-02,Crown Estates Lettings,6513,Housing,Rent,-1508.73,GBP,-72890.95,POS,London,GB,9074,user_001,rec_19f70fbcce,
4a75bb62-48cc-4019-aad5-b78465b9e01e,2027-02-02,2027-02-04,Amazon UK,5942,Shopping,Online Retail,-39.26,GBP,-72930.21,E-Com,London,GB,4488,user_001,,
7dfddc07-f642-4c04-921d-7a8d5173e674,2027-02-03,2027-02-05,Amazon UK,5942,Shopping,Online Retail,-77.13,GBP,-73007.34,E-Com,London,GB,1045,user_001,,
d422adfc-cebd-4783-b33a-da3b8cfdafaf,2027-02-03,2027-02-04,Deliveroo,5812,Food & Drink,Delivery,-21.83,GBP,-73029.17,E-Com,London,GB,4488,user_001,,
e4ef3f76-c5d9-4e5a-9c15-4887bfb70abb,2027-02-03,2027-02-03,Local Market,5499,Groceries,Specialty,-15.65,GBP,-73044.82,POS,London,GB,9074,user_002,,
24019ed2-b1d8-4583-a518-6ff2046931bb,2027-02-05,2027-02-05,Tesco,5411,Groceries,Supermarket,-71.24,GBP,-73116.06,POS,London,GB,4488,user_001,,
c0c8b5f1-2a9a-490a-ba42-893d77203a9e,2027-02-05,2027-02-05,Amazon UK,5942,Shopping,Online Retail,-84.27,GBP,-73200.33,E-Com,London,GB,2219,user_002,,
2dd90634-c57e-463d-b43a-fe859222847c,2027-02-06,2027-02-08,Apple.com/bill,5734,Shopping,Electronics,-81.72,GBP,-73282.05,E-Com,Cupertino,US,4488,user_001,,
36524133-0085-43b7-a060-bab2dc85bf03,2027-02-06,2027-02-08,Transport for London,4111,Transport,Transit,-11.71,GBP,-73293.76,POS,London,GB,1045,user_001,,
5dace369-a3c4-4d0b-a78a-4892c564c11e,2027-02-06,2027-02-08,Local Market,5499,Groceries,Specialty,-17.43,GBP,-73311.19,POS,London,GB,9074,user_001,,
75f81a75-6b72-4933-ae29-82be865d9cd6,2027-02-06,2027-02-08,Tesco,5411,Groceries,Supermarket,-84.27,GBP,-73395.46,POS,London,GB,4488,user_001,,
998a52a6-72a1-4798-a6ba-387e8f645ac0,2027-02-06,2027-02-08,Shell,5541,Transport,Fuel,-60.09,GBP,-73455.55,POS,London,GB,1045,user_001,,
0e132866-b1f2-4953-8d9f-e09cecb5389e,2027-02-07,2027-02-08,Pret A Manger,5814,Food & Drink,Eating Out,-11.71,GBP,-73467.26,POS,London,GB,4488,user_001,,
22c3235a-2511-4f6c-95b7-b38bdd1f1163,2027-02-07,2027-02-08,Transport for London,4111,Transport,Transit,-3.95,GBP,-73471.21,POS,London,GB,4488,user_001,,
22f99762-68d0-4aa7-bc46-80af62291072,2027-02-07,2027-02-08,Waitrose,5411,Groceries,Supermarket,-66.62,GBP,-73537.83,POS,London,GB,4488,user_001,,
2c81e393-72ac-4df1-9192-ac4d9a7f1091,2027-02-07,2027-02-08,Local Market,5499,Groceries,Specialty,-19.23,GBP,-73557.06,POS,London,GB,4488,user_001,,
a95a09d4-400b-4ddf-9756-2d16f31ab7f2,2027-02-07,2027-02-09,Uber UK,4121,Transport,Ride Hailing,-16.94,GBP,-73574.0,E-Com,London,GB,1045,user_001,,
bc94d9d9-51cc-459e-bc64-968bdcac3287,2027-02-07,2027-02-09,Deliveroo,5812,Food & Drink,Delivery,-19.8,GBP,-73593.8,E-Com,London,GB,9074,user_001,,
d1aa4a12-9142-465e-8121-af6cb119d39b,2027-02-07,2027-02-08,Sainsbury's,5411,Groceries,Supermarket,-14.9,GBP,-73608.7,POS,London,GB,2219,user_001,,
4d644247-ebad-42d6-9975-bfa437b8170b,2027-02-08,2027-02-09,Waitrose,5411,Groceries,Supermarket,-47.04,GBP,-73655.74,POS,London,GB,2219,user_002,,
6d5e62ae-c9a4-49ce-8bc8-5d640875d5d6,2027-02-08,2027-02-08,Local Market,5499,Groceries,Specialty,-19.86,GBP,-73675.6,POS,London,GB,2219,user_001,,
941d0637-dc9e-4a17-af5e-97321e8b68a8,2027-02-08,2027-02-08,Tesco,5411,Groceries,Supermarket,-23.4,GBP,-73699.0,POS,London,GB,2219,user_001,,
a0443426-2fef-4d4e-8838-52090ce7f367,2027-02-08,2027-02-10,Shell,5541,Transport,Fuel,-78.27,GBP,-73777.27,POS,London,GB,1045,user_002,,
e2b3f020-10a3-4c7f-9bcb-69d432884d5a,2027-02-08,2027-02-08,Octopus Energy,4900,Utilities,Electricity,-124.94,GBP,-73902.21,Direct Debit,London,GB,2219,user_001,rec_141a4a0666,
4d182125-9e15-4baf-906e-c92b3a5d562d,2027-02-09,2027-02-09,Transport for London,4111,Transport,Transit,-7.91,GBP,-73910.12,POS,London,GB,9074,user_001,,
74f81bee-4d49-4d6a-894b-7555d6a9908b,2027-02-09,2027-02-11,Waitrose,5411,Groceries,Supermarket,-81.74,GBP,-73991.86,POS,London,GB,9074,user_001,,
aca600a5-0099-47de-98d1-f221e6622f35,2027-02-09,2027-02-11,Pret A Manger,5814,Food & Drink,Eating Out,-9.28,GBP,-74001.14,POS,London,GB,1045,user_001,,
7e8a60ba-0b0e-4020-b86e-682c408760f6,2027-02-11,2027-02-15,Thames Water,4900,Utilities,Water,-42.83,GBP,-74043.97,Direct Debit,Reading,GB,9074,user_002,rec_954d02400c,
d4a6c507-bae7-4ef5-b940-7ac663725c76,2027-02-11,2027-02-12,Tesco,5411,Groceries,Supermarket,-48.9,GBP,-74092.87,POS,London,GB,2219,user_001,,
4d4564c3-7500-4919-ba14-51b2da4506c0,2027-02-12,2027-02-15,Tesco,5411,Groceries,Supermarket,-18.59,GBP,-74111.46,POS,London,GB,1045,user_002,,
6bdadd10-f894-43cf-a386-50a58c0145ff,2027-02-12,2027-02-15,Local Market,5499,Groceries,Specialty,-17.49,GBP,-74128.95,POS,London,GB,9074,user_001,,
b25e2d2c-6943-4537-b9f8-01fcb47ac777,2027-02-12,2027-02-12,Amazon UK,5942,Shopping,Online Retail,-79.39,GBP,-74208.34,E-Com,London,GB,1045,user_002,,
db0963e6-78e3-4745-9c8b-1df1d28963fd,2027-02-13,2027-02-15,Pret A Manger,5814,Food & Drink,Eating Out,-7.38,GBP,-74215.72,POS,London,GB,9074,user_001,,
51169bc3-e2b4-4d4d-aaa9-5e1fdda99d44,2027-02-14,2027-02-15,Apple.com/bill,5734,Shopping,Electronics,-140.05,GBP,-74355.77,E-Com,Cupertino,US,1045,user_002,,
761abf89-4a9d-483c-b32d-f320ddf9d2b4,2027-02-14,2027-02-15,Tesco,5411,Groceries,Supermarket,-63.35,GBP,-74419.12,POS,London,GB,9074,user_001,,
7b46c4f5-9ec6-46a5-8e07-f4de3c978dcb,2027-02-14,2027-02-15,Apple.com/bill,5734,Shopping,Electronics,-121.57,GBP,-74540.69,E-Com,Cupertino,US,2219,user_001,,
42a1934d-fa03-4dc4-a82e-9f55418b6d90,2027-02-15,2027-02-17,Sainsbury's,5411,Groceries,Supermarket,-51.98,GBP,-74592.67,POS,London,GB,9074,user_001,,
b58d5fff-36bc-4936-ac25-443e86138809,2027-02-15,2027-02-17,O2 UK,4814,Bills,Mobile,-51.73,GBP,-74644.4,Direct Debit,Slough,GB,2219,user_001,rec_95042d8101,
d35fce14-5125-4581-86cd-7a4b7a3d28c9,2027-02-15,2027-02-15,Apple.com/bill,5734,Shopping,Electronics,-189.28,GBP,-74833.68,E-Com,Cupertino,US,1045,user_001,,
e0317903-87ad-4fec-96f3-08c37771f06f,2027-02-15,2027-02-15,City Council Tax,9399,Utilities,Council Tax,-166.7,GBP,-75000.38,Direct Debit,London,GB,9074,user_002,rec_6feaa5d43f,
477bf2f7-22d8-462f-b680-7e70cf2d9737,2027-02-16,2027-02-17,Pret A Manger,5814,Food & Drink,Eating Out,-8.42,GBP,-75008.8,POS,London,GB,2219,user_001,,
0f7562dd-4c10-4d2f-b257-c0cffdd4c103,2027-02-17,2027-02-19,Transport for London,4111,Transport,Transit,-11.56,GBP,-75020.36,POS,London,GB,9074,user_001,,
105dea8e-6dcb-4fc5-abbe-a8c7c6cb014f,2027-02-17,2027-02-19,GymBox,7997,Wellness,Gym,-49.65,GBP,-75070.01,Direct Debit,London,GB,1045,user_001,rec_3906953fd2,
55d8e592-97e9-4d60-89fc-3b48f05f054d,2027-02-17,2027-02-19,Waitrose,5411,Groceries,Supermarket,-45.1,GBP,-75115.11,POS,London,GB,9074,user_002,,
a9b65126-6ee9-47a5-a2a9-43b56b27d677,2027-02-17,2027-02-18,Transport for London,4111,Transport,Transit,-3.87,GBP,-75118.98,POS,London,GB,2219,user_001,,
b7cb7aa8-2181-4177-a3c7-dc9d7abad013,2027-02-19,2027-02-22,Shell,5541,Transport,Fuel,-89.48,GBP,-75208.46,POS,London,GB,1045,user_001,,
be965388-3a52-4531-aef0-cf0f609ccdb5,2027-02-19,2027-02-22,Spotify,5735,Entertainment,Subscriptions,-8.08,GBP,-75216.54,E-Com,Stockholm,SE,1045,user_002,rec_34b6e9e33f,
3326da5e-5370-420c-ae9a-75094c975178,2027-02-20,2027-02-22,Apple.com/bill,5734,Shopping,Electronics,-24.46,USD,-75241.0,E-Com,Cupertino,US,2219,user_001,,FX purchase 29.29 USD @ rate 1.20
593189bf-04fa-4e64-a7c7-e6de46bcef0c,2027-02-20,2027-02-22,Shell,5541,Transport,Fuel,-79.46,GBP,-75320.46,POS,London,GB,2219,user_001,,
89b8667a-3ac2-411a-9aed-54e94170f25e,2027-02-20,2027-02-22,Local Market,5499,Groceries,Specialty,-21.54,GBP,-75342.0,POS,London,GB,4488,user_001,,
2ac9ee5a-9bd6-4f04-9353-29a3297f445d,2027-02-21,2027-02-23,Local Market,5499,Groceries,Specialty,-14.2,GBP,-75356.2,POS,London,GB,4488,user_001,,
8b426869-ffd4-460f-bdde-804d4970fac2,2027-02-21,2027-02-22,Amazon UK,5942,Shopping,Online Retail,-72.92,GBP,-75429.12,E-Com,London,GB,1045,user_001,,
b73143ba-5cb5-4755-a8ac-bf079adf5376,2027-02-21,2027-02-22,HM Revenue & Customs,9311,Income,Tax Refund,134.57,GBP,-75294.55,Credit,London,GB,4488,user_002,,Refund for Apple.com/bill
c8737b1d-6b59-4d1f-84a8-6751b97766dd,2027-02-21,2027-02-22,Waitrose,5411,Groceries,Supermarket,-78.29,GBP,-75372.84,POS,London,GB,2219,user_001,,
647b3bf8-4453-4549-bf82-9c0cffdb0e11,2027-02-22,2027-02-24,Sainsbury's,5411,Groceries,Supermarket,-23.53,GBP,-75396.37,POS,London,GB,2219,user_001,,
bf1cd031-60ea-48e1-a38a-cfe6398a4bea,2027-02-22,2027-02-22,Netflix,7841,Entertainment,Subscriptions,-14.4,GBP,-75410.77,E-Com,Los Gatos,US,2219,user_001,rec_1bfe33738d,
dfeade77-b39c-402d-85e5-83001fd3a921,2027-02-22,2027-02-24,Apple.com/bill,5734,Shopping,Electronics,-118.12,GBP,-75528.89,E-Com,Cupertino,US,2219,user_001,,
0b5043c8-44c4-4cad-981f-a0a6c4211183,2027-02-23,2027-02-23,Pret A Manger,5814,Food & Drink,Eating Out,-8.13,GBP,-75537.02,POS,London,GB,2219,user_001,,
5f69b783-d134-4097-abc6-5e94b17f85c3,2027-02-24,2027-02-24,Transport for London,4111,Transport,Transit,-9.12,GBP,-75546.14,POS,London,GB,9074,user_001,,
1d6c0ef4-8a86-4be6-b180-dbe174c6abd6,2027-02-25,2027-02-25,T212 Capital,6011,Income,Salary,3038.63,GBP,-72507.51,Credit,London,GB,9074,user_001,rec_2ff8f778d0,
332b0ffd-c283-4de7-b93c-7d78eef3096d,2027-02-25,2027-03-01,Amazon UK,5942,Shopping,Online Retail,-94.68,GBP,-72602.19,E-Com,London,GB,1045,user_001,,
cf13fb9b-8c38-4a13-ac96-5d192ffd5215,2027-02-25,2027-02-25,Apple.com/bill,5734,Shopping,Electronics,-122.02,USD,-72724.21,E-Com,Cupertino,US,9074,user_001,,FX purchase 148.91 USD @ rate 1.22
029d6c6c-c32e-4e41-b0cd-703ea61bac34,2027-02-26,2027-02-26,Uber UK,4121,Transport,Ride Hailing,-26.56,GBP,-72750.77,E-Com,London,GB,9074,user_001,,
1c13f90e-6d5e-4777-840f-fd71d36dedd5,2027-02-26,2027-03-01,Sainsbury's,5411,Groceries,Supermarket,-49.44,GBP,-72800.21,POS,London,GB,2219,user_002,,
1e5b542a-2cab-4bdc-9e2e-9c579bdb321e,2027-02-26,2027-03-01,Apple.com/bill,5734,Shopping,Electronics,-39.61,GBP,-72839.82,E-Com,Cupertino,US,1045,user_001,,
781decf9-0712-421e-90a3-179fc200f410,2027-02-26,2027-02-26,Transport for London,4111,Transport,Transit,-11.89,GBP,-72851.71,POS,London,GB,9074,user_001,,
9173c606-3b05-4a0a-8071-2ce8be3eee63,2027-02-26,2027-03-01,Pret A Manger,5814,Food & Drink,Eating Out,-8.88,GBP,-72860.59,POS,London,GB,2219,user_001,,
e914108e-5a65-4e16-894d-11c89bfa944e,2027-02-26,2027-03-01,Local Market,5499,Groceries,Specialty,-16.63,GBP,-72877.22,POS,London,GB,1045,user_001,,
0e1fc002-9511-468f-85ef-2dc5966538b5,2027-02-27,2027-03-01,Apple.com/bill,5734,Shopping,Electronics,-22.31,GBP,-72899.53,E-Com,Cupertino,US,9074,user_001,,
65bacc15-6d73-43ec-9fa3-7bbf15cd4258,2027-02-27,2027-03-01,Local Market,5499,Groceries,Specialty,-15.99,GBP,-72915.52,POS,London,GB,4488,user_002,,
a879a636-936a-4091-b1f7-81ef7bd33f62,2027-02-27,2027-03-01,Tesco,5411,Groceries,Supermarket,-38.64,GBP,-72954.16,POS,London,GB,2219,user_001,,
ebd41008-c395-4830-a98f-55cef4fdc3f7,2027-02-27,2027-03-01,Deliveroo,5812,Food & Drink,Delivery,-22.13,GBP,-72976.29,E-Com,London,GB,1045,user_001,,
62b6ca1d-3995-418a-ae3f-87e1cd144f87,2027-02-28,2027-03-01,Pret A Manger,5814,Food & Drink,Eating Out,-8.86,GBP,-72985.15,POS,London,GB,2219,user_001,,
6a6a321a-f622-418c-abb5-c6f5b98e033a,2027-02-28,2027-03-01,Waitrose,5411,Groceries,Supermarket,-39.49,GBP,-73024.64,POS,London,GB,1045,user_001,,
72b03fa7-a8b5-4964-a011-50c0a22dbeca,2027-02-28,2027-03-01,Amazon UK,5942,Shopping,Online Retail,-103.43,GBP,-73128.07,E-Com,London,GB,9074,user_002,,
9dd8646e-a0b1-4ef5-b68c-f59b33cfc06e,2027-02-28,2027-03-02,Apple.com/bill,5734,Shopping,Electronics,-50.24,GBP,-73178.31,E-Com,Cupertino,US,1045,user_001,,
b8d4b020-8aec-4e1a-80cc-74f3f518e4de,2027-02-28,2027-03-01,Transport for London,4111,Transport,Transit,-8.67,GBP,-73186.98,POS,London,GB,1045,user_001,,
e3a248bd-2ff5-43d5-8a74-c737af70efde,2027-02-28,2027-03-01,Sainsbury's,5411,Groceries,Supermarket,-39.14,GBP,-73226.12,POS,London,GB,2219,user_001,,
f24c0f1c-5c38-4ea4-9da2-e20c780b828a,2027-02-28,2027-03-02,Shell,5541,Transport,Fuel,-86.59,GBP,-73312.71,POS,London,GB,1045,user_001,,
943d6723-ead0-42bc-9b63-306e80056fab,2027-03-01,2027-03-02,Crown Estates Lettings,6513,Housing,Rent,-1642.03,GBP,-74954.74,POS,London,GB,4488,user_002,rec_fc2ae06846,
21e1f6fa-535f-4e27-a208-51447df650c7,2027-03-02,2027-03-03,Transport for London,4111,Transport,Transit,-10.52,GBP,-74965.26,POS,London,GB,9074,user_002,,
28637137-b350-458a-add1-69f82cdb781c,2027-03-02,2027-03-02,Waitrose,5411,Groceries,Supermarket,-60.09,GBP,-75025.35,POS,London,GB,4488,user_002,,
43ba7437-d574-4ac7-857e-aaf44b823d50,2027-03-02,2027-03-02,Amazon UK,5942,Shopping,Online Retail,-35.15,GBP,-75060.5,E-Com,London,GB,4488,user_001,,
f09442c4-004e-4569-97eb-b197c5953a60,2027-03-02,2027-03-03,Sainsbury's,5411,Groceries,Supermarket,-56.73,GBP,-75117.23,POS,London,GB,2219,user_001,,
3223919a-f34b-4fe5-ae64-1a1254770945,2027-03-04,2027-03-04,Sainsbury's,5411,Groceries,Supermarket,-42.47,GBP,-75159.7,POS,London,GB,1045,user_001,,
e16cb967-a2c2-4419-84db-4728b0166ba9,2027-03-04,2027-03-05,Local Market,5499,Groceries,Specialty,-11.12,GBP,-75170.82,POS,London,GB,9074,user_001,,
c4b4f41d-67b8-4a11-9c29-dac8a2af248b,2027-03-05,2027-03-05,Uber UK,4121,Transport,Ride Hailing,-25.35,GBP,-75196.17,E-Com,London,GB,4488,user_001,,
3dd2ae16-4814-4128-a9b2-be6369635000,2027-03-06,2027-03-08,Shell,5541,Transport,Fuel,-32.46,GBP,-75228.63,POS,London,GB,1045,user_001,,
557b7a14-befd-40d2-b84e-2e69580c2c55,2027-03-06,2027-03-08,Airline Refund,4511,Travel,Refund,110.91,GBP,-75117.72,Credit,London,GB,2219,user_001,,Refund for Apple.com/bill
5e299673-84e4-4fac-8376-ea1cb56f4314,2027-03-06,2027-03-08,Waitrose,5411,Groceries,Supermarket,-33.17,GBP,-75150.89,POS,London,GB,4488,user_001,,
430dd958-b5fc-499a-8e0b-428eb02c29f8,2027-03-07,2027-03-08,Local Market,5499,Groceries,Specialty,-8.08,GBP,-75158.97,POS,London,GB,2219,user_001,,
b15b5a40-78cb-47a7-a374-a25733f67f3e,2027-03-07,2027-03-08,Amazon UK,5942,Shopping,Online Retail,-119.63,GBP,-75278.6,E-Com,London,GB,4488,user_001,,
dc64e4e5-8012-4aa5-9844-66960b9d8bd0,2027-03-08,2027-03-08,Octopus Energy,4900,Utilities,Electricity,-136.41,GBP,-75415.01,Direct Debit,London,GB,9074,user_002,rec_09c3f12b18,
28af1592-139b-4440-a0e2-d1b185bdcf22,2027-03-09,2027-03-11,Local Market,5499,Groceries,Specialty,-10.28,GBP,-75425.29,POS,London,GB,4488,user_002,,
782ca836-ae1e-4942-927e-0bee8e1c4b06,2027-03-09,2027-03-10,Transport for London,4111,Transport,Transit,-6.25,GBP,-75431.54,POS,London,GB,2219,user_001,,
988619b5-bceb-4109-9a40-78a590db4514,2027-03-09,2027-03-11,Amazon UK,5942,Shopping,Online Retail,-24.12,GBP,-75455.66,E-Com,London,GB,4488,user_001,,
20f0b698-1502-4274-bb7d-de39b3e7cd12,2027-03-10,2027-03-12,Apple.com/bill,5734,Shopping,Electronics,-174.09,USD,-75629.75,E-Com,Cupertino,US,9074,user_001,,FX purchase 220.29 USD @ rate 1.27
3b8971c3-dc9d-4dfe-b993-01d07f3e2a15,2027-03-10,2027-03-11,Pret A Manger,5814,Food & Drink,Eating Out,-10.17,GBP,-75639.92,POS,London,GB,9074,user_001,,
29414502-4d36-464f-8966-55ae9dc0789e,2027-03-11,2027-03-15,Pret A Manger,5814,Food & Drink,Eating Out,-7.33,GBP,-75647.25,POS,London,GB,4488,user_001,,
2a847a7d-0cf7-4d2c-b84b-0f75baa23944,2027-03-11,2027-03-12,ATM Withdrawal,6011,Cash,ATM,-106.83,GBP,-75754.08,ATM,London,GB,2219,user_002,,
3b824435-0da9-47b7-80d9-e337227efafb,2027-03-11,2027-03-15,Waitrose,5411,Groceries,Supermarket,-42.79,GBP,-75796.87,POS,London,GB,2219,user_002,,
8463fcfa-297e-4422-b381-8f5576394f98,2027-03-11,2027-03-15,Thames Water,4900,Utilities,Water,-43.31,GBP,-75840.18,Direct Debit,Reading,GB,1045,user_001,rec_3a34d62842,
f46b6832-8061-410d-90d8-7877b8596db2,2027-03-11,2027-03-12,Shell,5541,Transport,Fuel,-34.71,GBP,-75874.89,POS,London,GB,1045,user_001,,
94519278-0519-4ae8-a56b-2a4b55c78d56,2027-03-12,2027-03-12,Tesco,5411,Groceries,Supermarket,-74.75,GBP,-75949.64,POS,London,GB,1045,user_002,,
f833b7e2-ee33-41ff-b3d1-74ec4e8a1cf6,2027-03-12,2027-03-15,Local Market,5499,Groceries,Specialty,-12.03,GBP,-75961.67,POS,London,GB,9074,user_001,,
0ff14796-24f5-4426-b32a-620a5e6f5e2a,2027-03-13,2027-03-15,Waitrose,5411,Groceries,Supermarket,-38.41,GBP,-76000.08,POS,London,GB,1045,user_001,,
56d76a28-1bb4-4e99-8eac-ccfba224a374,2027-03-13,2027-03-15,Amazon UK,5942,Shopping,Online Retail,-94.6,GBP,-76094.68,E-Com,London,GB,2219,user_001,,
57eff160-2df1-4590-ac20-a1b15235857c,2027-03-13,2027-03-15,Shell,5541,Transport,Fuel,-32.7,GBP,-76127.38,POS,London,GB,2219,user_001,,
6895f010-2811-4c1c-895a-7707306d8490,2027-03-13,2027-03-15,Apple.com/bill,5734,Shopping,Electronics,-122.03,USD,-76249.41,E-Com,Cupertino,US,4488,user_001,,FX purchase 146.26 USD @ rate 1.20
d2505ccf-01c0-4d11-9162-39f3c0c860ae,2027-03-13,2027-03-15,Sainsbury's,5411,Groceries,Supermarket,-29.62,GBP,-76279.03,POS,London,GB,1045,user_001,,
165d010d-22a0-4e06-9249-ea33b7303580,2027-03-14,2027-03-15,Pret A Manger,5814,Food & Drink,Eating Out,-8.34,GBP,-76287.37,POS,London,GB,4488,user_001,,
586efb04-dfe0-40ca-9dcb-9871fcfce8c5,2027-03-14,2027-03-15,Deliveroo,5812,Food & Drink,Delivery,-24.22,GBP,-76311.59,E-Com,London,GB,4488,user_001,,
adac1014-4e47-4206-8d26-d766871e6729,2027-03-14,2027-03-16,Pret A Manger,5814,Food & Drink,Eating Out,-8.59,GBP,-76320.18,POS,London,GB,4488,user_001,,
0fab630b-6956-4f92-8cfb-1c7a919aa031,2027-03-15,2027-03-17,Shell,5541,Transport,Fuel,-40.4,GBP,-76360.58,POS,London,GB,4488,user_002,,
1e2941bf-e526-4cc6-a224-e2159eb9fbd4,2027-03-15,2027-03-15,O2 UK,4814,Bills,Mobile,-41.35,GBP,-76401.93,Direct Debit,Slough,GB,9074,user_001,rec_95042d8101,
3486beae-14e0-418c-9ab5-ec4b24e89688,2027-03-15,2027-03-16,Uber UK,4121,Transport,Ride Hailing,-26.55,GBP,-76428.48,E-Com,London,GB,1045,user_001,,
9aec2561-58fd-4588-9d55-fc97654a2645,2027-03-15,2027-03-15,City Council Tax,9399,Utilities,Council Tax,-160.95,GBP,-76589.43,Direct Debit,London,GB,9074,user_001,rec_f531495db5,
82be4cc7-0bc0-46d1-bc5c-a589a0efabeb,2027-03-16,2027-03-17,Local Market,5499,Groceries,Specialty,-13.28,GBP,-76602.71,POS,London,GB,2219,user_001,,
3b7959c1-673c-4e30-b5ac-5effe815331a,2027-03-17,2027-03-18,Shell,5541,Transport,Fuel,-86.05,GBP,-76688.76,POS,London,GB,2219,user_001,,
af3b3fda-2c8f-4643-b7c3-d5bea39012be,2027-03-17,2027-03-19,Transport for London,4111,Transport,Transit,-11.43,GBP,-76700.19,POS,London,GB,1045,user_001,,
b75e0380-3f45-4116-ab1e-90bcb79b4721,2027-03-17,2027-03-19,GymBox,7997,Wellness,Gym,-61.68,GBP,-76761.87,Direct Debit,London,GB,9074,user_001,rec_3906953fd2,
d420a903-5b9e-4e49-95b6-2c002dc8676d,2027-03-17,2027-03-19,ATM Withdrawal,6011,Cash,ATM,-60.9,GBP,-76822.77,ATM,London,GB,2219,user_001,,
2e698da0-301f-4fb8-9477-927bea7b3523,2027-03-19,2027-03-19,Tesco,5411,Groceries,Supermarket,-40.49,GBP,-76863.26,POS,London,GB,9074,user_001,,
8371a10f-b5f9-4a7d-930a-b3fe47e60b12,2027-03-19,2027-03-22,Spotify,5735,Entertainment,Subscriptions,-9.95,GBP,-76873.21,E-Com,Stockholm,SE,2219,user_001,rec_4c746d2c3b,
bb8446f8-e30d-46c4-8849-b5d231519c48,2027-03-19,2027-03-22,Amazon UK,5942,Shopping,Online Retail,-57.24,GBP,-76930.45,E-Com,London,GB,4488,user_001,,
dedb85a1-cea1-42fb-83f0-987de0bf8124,2027-03-19,2027-03-22,Deliveroo,5812,Food & Drink,Delivery,-12.12,GBP,-76942.57,E-Com,London,GB,2219,user_001,,
28af9ce4-2a0b-4747-a47e-e60de7935ddf,2027-03-20,2027-03-22,Pret A Manger,5814,Food & Drink,Eating Out,-7.95,GBP,-76950.52,POS,London,GB,4488,user_001,,
c7d3338a-5b25-4fa4-bece-9ca4a8dbe509,2027-03-20,2027-03-22,Local Market,5499,Groceries,Specialty,-8.52,GBP,-76959.04,POS,London,GB,9074,user_001,,
f23a87c0-5f20-4264-9062-c9aa3208cbf7,2027-03-20,2027-03-22,Pret A Manger,5814,Food & Drink,Eating Out,-7.6,GBP,-76966.64,POS,London,GB,9074,user_001,,
329189cd-fb2d-4198-b28c-4dc561502ead,2027-03-21,2027-03-22,Pret A Manger,5814,Food & Drink,Eating Out,-10.97,GBP,-76977.61,POS,London,GB,2219,user_001,,
6ea93dc2-271b-406e-8eb2-f9f20d76bce4,2027-03-21,2027-03-22,Pret A Manger,5814,Food & Drink,Eating Out,-9.49,GBP,-76987.1,POS,London,GB,9074,user_001,,
bb019b43-2076-402a-8936-8fae3385c4e8,2027-03-21,2027-03-22,Pret A Manger,5814,Food & Drink,Eating Out,-11.2,GBP,-76998.3,POS,London,GB,4488,user_001,,
ff71697d-4903-43b3-9b19-3772a430d8f2,2027-03-21,2027-03-23,Waitrose,5411,Groceries,Supermarket,-60.23,GBP,-77058.53,POS,London,GB,2219,user_001,,
500a21c7-5dc8-42ed-8b82-efdb7d44f8f8,2027-03-22,2027-03-23,Deliveroo,5812,Food & Drink,Delivery,-17.8,GBP,-77076.33,E-Com,London,GB,2219,user_002,,
5d733131-f7b0-4d2e-8632-7c759f73aa79,2027-03-22,2027-03-22,HM Revenue & Customs,9311,Income,Tax Refund,39.37,GBP,-77036.96,Credit,London,GB,9074,user_001,,Refund for O2 UK
8621b9a3-8499-4752-8804-00efaeb5e159,2027-03-22,2027-03-23,Netflix,7841,Entertainment,Subscriptions,-11.31,USD,-77048.27,E-Com,Los Gatos,US,2219,user_001,rec_1bfe33738d,FX purchase 14.02 USD @ rate 1.24
c52f6f6b-c324-4c1f-9849-50d78266b907,2027-03-22,2027-03-23,Deliveroo,5812,Food & Drink,Delivery,-20.32,GBP,-77068.59,E-Com,London,GB,4488,user_001,,
0f600378-9de1-4d11-b1ea-a7cbaaeaa02c,2027-03-23,2027-03-23,Waitrose,5411,Groceries,Supermarket,-87.77,GBP,-77156.36,POS,London,GB,9074,user_002,,
43e6187c-6946-4f0a-9d68-423999f103eb,2027-03-23,2027-03-25,Waitrose,5411,Groceries,Supermarket,-66.16,GBP,-77222.52,POS,London,GB,1045,user_001,,
5ba889aa-a367-4fc1-bb9a-250a98e790de,2027-03-24,2027-03-24,Amazon UK,5942,Shopping,Online Retail,-88.48,GBP,-77311.0,E-Com,London,GB,1045,user_001,,
702347ec-a179-4664-8b1f-f8b97cc2d9c6,2027-03-24,2027-03-24,Local Market,5499,Groceries,Specialty,-13.09,GBP,-77324.09,POS,London,GB,9074,user_001,,
7641bb7b-90e8-4ef7-922b-ffdfd82878dc,2027-03-24,2027-03-26,ATM Withdrawal,6011,Cash,ATM,-96.57,GBP,-77420.66,ATM,London,GB,1045,user_001,,
95e9bf20-404c-4a51-8431-4f1532f0524c,2027-03-24,2027-03-24,ATM Withdrawal,6011,Cash,ATM,-105.35,GBP,-77526.01,ATM,London,GB,9074,user_001,,
e004cfc7-ff22-41eb-b395-35daae7ff62d,2027-03-24,2027-03-26,Local Market,5499,Groceries,Specialty,-10.4,GBP,-77536.41,POS,London,GB,9074,user_001,,
0978ef74-3e5a-4b8c-a1ff-4af943ca31f9,2027-03-25,2027-03-26,Deliveroo,5812,Food & Drink,Delivery,-31.62,GBP,-77568.03,E-Com,London,GB,1045,user_001,,
9b6f7c4e-4e16-4c00-9960-ba617989712e,2027-03-25,2027-03-25,T212 Capital,6011,Income,Salary,3076.82,GBP,-74491.21,Credit,London,GB,4488,user_002,rec_c649d24d0f,
f7addc3c-47df-4c7e-b4a4-b2adb05b62e9,2027-03-25,2027-03-25,Tesco,5411,Groceries,Supermarket,-64.82,GBP,-74556.03,POS,London,GB,4488,user_001,,
2f8f10ea-d39d-480a-855b-9c6f9a419b05,2027-03-26,2027-03-26,Apple.com/bill,5734,Shopping,Electronics,-149.09,GBP,-74705.12,E-Com,Cupertino,US,9074,user_001,,
5c0e7f01-f743-4f0b-b775-1c000831fe31,2027-03-26,2027-03-29,Uber UK,4121,Transport,Ride Hailing,-19.9,GBP,-74725.02,E-Com,London,GB,2219,user_001,,
6ae8c824-9cb2-48bc-afec-45c6f31c5756,2027-03-26,2027-03-29,Apple.com/bill,5734,Shopping,Electronics,-201.83,USD,-74926.85,E-Com,Cupertino,US,9074,user_001,,FX purchase 263.19 USD @ rate 1.30
75fcbf14-4fc0-41de-a21c-5bd90f83c2e1,2027-03-26,2027-03-26,Tesco,5411,Groceries,Supermarket,-27.34,GBP,-74954.19,POS,London,GB,4488,user_001,,
2dac609d-2747-4a7e-b01c-cb2cd88cbcc5,2027-03-27,2027-03-29,Waitrose,5411,Groceries,Supermarket,-73.82,GBP,-75028.01,POS,London,GB,2219,user_001,,
7077968f-80de-47cb-9b4c-2e4cfcbfbf85,2027-03-27,2027-03-29,Amazon UK,5942,Shopping,Online Retail,-59.18,GBP,-75087.19,E-Com,London,GB,2219,user_001,,
93108c41-6644-4b0e-9a73-7a857e8475f4,2027-03-27,2027-03-29,Waitrose,5411,Groceries,Supermarket,-24.31,GBP,-75111.5,POS,London,GB,2219,user_001,,
9b750b8b-9fd6-4fdc-8152-1f67df76915b,2027-03-27,2027-03-29,Tesco,5411,Groceries,Supermarket,-48.66,GBP,-75160.16,POS,London,GB,4488,user_001,,
d83785b7-3c8d-498b-9243-7408d4f7935d,2027-03-27,2027-03-29,Airline Refund,4511,Travel,Refund,32.43,GBP,-75127.73,Credit,London,GB,9074,user_001,,Refund for Shell
7057653e-6787-4523-9e99-dab8b94d891c,2027-03-28,2027-03-30,Tesco,5411,Groceries,Supermarket,-26.74,GBP,-75154.47,POS,London,GB,9074,user_001,,
8718d01b-e5be-4d26-8835-f7df4631acb7,2027-03-28,2027-03-30,Sainsbury's,5411,Groceries,Supermarket,-31.09,GBP,-75185.56,POS,London,GB,4488,user_001,,
72301fc1-7bc7-4f2c-bd02-6f6da61be6ec,2027-03-29,2027-03-29,Waitrose,5411,Groceries,Supermarket,-48.21,GBP,-75233.77,POS,London,GB,1045,user_001,,
94a0f9a9-4592-48a3-bcfe-311beb581b25,2027-03-29,2027-03-31,Sainsbury's,5411,Groceries,Supermarket,-21.87,GBP,-75255.64,POS,London,GB,4488,user_001,,
9f705a90-a72f-43c9-9229-e04f9e3854c3,2027-03-29,2027-03-29,Deliveroo,5812,Food & Drink,Delivery,-20.53,GBP,-75276.17,E-Com,London,GB,2219,user_001,,
d00a8478-e2a6-407d-bce0-4ad9c2d5c366,2027-03-29,2027-03-29,Deliveroo,5812,Food & Drink,Delivery,-18.47,GBP,-75294.64,E-Com,London,GB,1045,user_001,,
231ad4c1-beb3-44e6-ae5b-ce6ca54c595f,2027-03-30,2027-04-01,Tesco,5411,Groceries,Supermarket,-70.28,GBP,-75364.92,POS,London,GB,4488,user_001,,
fce7449a-744d-4e75-8956-ef09d6c037fc,2027-03-30,2027-03-31,Local Market,5499,Groceries,Specialty,-11.45,GBP,-75376.37,POS,London,GB,9074,user_002,,
9c4e4ddb-5e0d-4cf6-9c21-bb7dab0167b0,2027-04-01,2027-04-02,Crown Estates Lettings,6513,Housing,Rent,-1505.88,GBP,-76882.25,POS,London,GB,1045,user_001,rec_19f70fbcce,
dcf21387-2d4e-4221-8863-7c3419239ddc,2027-04-01,2027-04-01,Shell,5541,Transport,Fuel,-94.27,GBP,-76976.52,POS,London,GB,1045,user_001,,
09ede65c-284d-43e6-a5f5-3c4e2f6851e8,2027-04-02,2027-04-02,Amazon UK,5942,Shopping,Online Retail,-31.87,GBP,-77008.39,E-Com,London,GB,1045,user_002,,
26499a65-5e85-4768-a0cc-20cd8f7f4f90,2027-04-02,2027-04-05,Apple.com/bill,5734,Shopping,Electronics,-33.59,USD,-77041.98,E-Com,Cupertino,US,9074,user_001,,FX purchase 40.62 USD @ rate 1.21
85b08706-a0a9-4814-98e3-dfb055c71ae2,2027-04-02,2027-04-02,Transport for London,4111,Transport,Transit,-8.04,GBP,-77050.02,POS,London,GB,4488,user_001,,
ed14c811-308c-4a3c-a0d9-01ca04f807ea,2027-04-02,2027-04-05,Tesco,5411,Groceries,Supermarket,-64.15,GBP,-77114.17,POS,London,GB,1045,user_001,,
1358b22b-8825-4f71-a07c-54da92a475ae,2027-04-03,2027-04-05,Shell,5541,Transport,Fuel,-72.01,GBP,-77186.18,POS,London,GB,9074,user_001,,
36cc2f25-4bf5-48aa-9d9a-d5c2c47a0ad2,2027-04-03,2027-04-05,Amazon UK,5942,Shopping,Online Retail,-19.17,GBP,-77205.35,E-Com,London,GB,1045,user_001,,
717e7316-5d8c-492c-99ef-aa3cd2f05a6f,2027-04-03,2027-04-05,Waitrose,5411,Groceries,Supermarket,-77.46,GBP,-77282.81,POS,London,GB,2219,user_001,,
7d149785-8eb6-4091-9364-be3b476cc665,2027-04-03,2027-04-05,Deliveroo,5812,Food & Drink,Delivery,-24.73,GBP,-77307.54,E-Com,London,GB,9074,user_002,,
8be27f89-70e0-409d-a273-8935dfe18456,2027-04-03,2027-04-05,Deliveroo,5812,Food & Drink,Delivery,-17.34,GBP,-77324.88,E-Com,London,GB,9074,user_001,,
afe9da9d-5522-41b6-aaf7-5f890768c495,2027-04-03,2027-04-05,Tesco,5411,Groceries,Supermarket,-77.58,GBP,-77402.46,POS,London,GB,9074,user_001,,
b7a328bb-11f6-4b61-a4b3-dc3fcea44c51,2027-04-03,2027-04-05,Waitrose,5411,Groceries,Supermarket,-43.19,GBP,-77445.65,POS,London,GB,1045,user_001,,
cbaa28db-0693-4919-b48c-6a63127e4792,2027-04-03,2027-04-05,Transport for London,4111,Transport,Transit,-10.12,GBP,-77455.77,POS,London,GB,4488,user_001,,
6ccced4f-1b2f-47e8-98ee-a574c96527ac,2027-04-04,2027-04-05,Tesco,5411,Groceries,Supermarket,-67.67,GBP,-77523.44,POS,London,GB,1045,user_001,,
75fdc418-be6f-447b-887a-455c3fe55b6d,2027-04-04,2027-04-05,Shell,5541,Transport,Fuel,-79.08,GBP,-77602.52,POS,London,GB,9074,user_001,,
db3e0805-1094-4263-87ca-4582f1471b1d,2027-04-04,2027-04-05,Shell,5541,Transport,Fuel,-30.44,GBP,-77632.96,POS,London,GB,2219,user_001,,
0ba1cc40-36c3-4145-aa08-2875ca4b92b1,2027-04-05,2027-04-07,Tesco,5411,Groceries,Supermarket,-19.85,GBP,-77652.81,POS,London,GB,4488,user_001,,
ef735f2c-3377-487b-822c-817daa1754da,2027-04-05,2027-04-06,Shell,5541,Transport,Fuel,-57.89,GBP,-77710.7,POS,London,GB,2219,user_001,,
18497370-d10e-49ea-ab5b-ab7ab2d93b0a,2027-04-06,2027-04-08,Tesco,5411,Groceries,Supermarket,-81.35,GBP,-77792.05,POS,London,GB,1045,user_001,,
6c09fb02-7ddc-4b17-a993-c7fbdab89a94,2027-04-06,2027-04-08,British Airways,4511,Travel,Flights,-517.77,GBP,-78309.82,E-Com,London,GB,2219,user_001,,Holiday booking
b22074fb-b3b8-4737-adac-2bf3775be711,2027-04-06,2027-04-07,Local Market,5499,Groceries,Specialty,-8.13,GBP,-78317.95,POS,London,GB,2219,user_001,,
23a2e4c0-99a0-4768-be51-3d5b29126061,2027-04-07,2027-04-09,Shell,5541,Transport,Fuel,-59.27,GBP,-78377.22,POS,London,GB,1045,user_001,,
46c1c59e-03f4-4589-a3ac-fbfc86fae12a,2027-04-07,2027-04-09,ATM Withdrawal,6011,Cash,ATM,-90.22,GBP,-78467.44,ATM,London,GB,4488,user_001,,
627347c1-0df3-4091-948b-b07e1e7a98a2,2027-04-07,2027-04-07,Local Market,5499,Groceries,Specialty,-11.96,GBP,-78479.4,POS,London,GB,9074,user_001,,
c3d014b7-f296-4ca3-bf0a-c943e693ae94,2027-04-07,2027-04-07,Octopus Energy,4900,Utilities,Electricity,-135.48,GBP,-78614.88,Direct Debit,London,GB,9074,user_001,rec_141a4a0666,
3f3c8921-322d-47c5-92eb-f1ebda2b7487,2027-04-08,2027-04-09,Pret A Manger,5814,Food & Drink,Eating Out,-9.33,GBP,-78624.21,POS,London,GB,9074,user_001,,
82f3422b-920d-4402-b817-c71787d9177d,2027-04-08,2027-04-09,Pret A Manger,5814,Food & Drink,Eating Out,-7.92,GBP,-78632.13,POS,London,GB,1045,user_001,,
d78bf5b2-a2f8-4edf-bca8-440dbd3b5ef0,2027-04-08,2027-04-08,Amazon UK,5942,Shopping,Online Retail,-40.65,GBP,-78672.78,E-Com,London,GB,2219,user_002,,
1acea1f7-24b3-454c-8bb8-08abedc225b9,2027-04-09,2027-04-12,Uber UK,4121,Transport,Ride Hailing,-19.01,GBP,-78691.79,E-Com,London,GB,9074,user_002,,
16df6267-273e-4551-9765-dc70b87e2183,2027-04-10,2027-04-12,Local Market,5499,Groceries,Specialty,-12.58,GBP,-78704.37,POS,London,GB,4488,user_001,,
6431e858-ff8b-4fc5-981d-79f8ba09312f,2027-04-10,2027-04-12,Deliveroo,5812,Food & Drink,Delivery,-28.09,GBP,-78732.46,E-Com,London,GB,4488,user_001,,
a71c5f98-7621-427d-9229-148e7fdec514,2027-04-10,2027-04-12,Transport for London,4111,Transport,Transit,-9.79,GBP,-78742.25,POS,London,GB,4488,user_002,,
e9767b19-60b7-41af-b862-de8c8a0abeeb,2027-04-10,2027-04-12,Local Market,5499,Groceries,Specialty,-16.83,GBP,-78759.08,POS,London,GB,2219,user_001,,
0592c1f8-8245-4b9b-9f61-b5b3292f7cee,2027-04-11,2027-04-12,Amazon UK,5942,Shopping,Online Retail,-27.18,GBP,-78786.26,E-Com,London,GB,9074,user_001,,
245ce3ce-5954-4f97-8745-13a48b7c9e5c,2027-04-11,2027-04-13,Apple.com/bill,5734,Shopping,Electronics,-163.96,GBP,-78950.22,E-Com,Cupertino,US,2219,user_001,,
aecd2cc0-1697-444e-bdee-139c3b673d40,2027-04-11,2027-04-12,Uber UK,4121,Transport,Ride Hailing,-8.37,GBP,-78958.59,E-Com,London,GB,4488,user_001,,
255d8b3d-67b4-4e82-a630-471f729937e4,2027-04-12,2027-04-13,Transport for London,4111,Transport,Transit,-6.34,GBP,-78964.93,POS,London,GB,4488,user_001,,
c1eb34aa-0abb-48a4-8f69-225413cfbcc6,2027-04-12,2027-04-12,Apple.com/bill,5734,Shopping,Electronics,-84.81,USD,-79049.74,E-Com,Cupertino,US,4488,user_002,,FX purchase 104.73 USD @ rate 1.23
ca01064d-81e0-4387-a30b-f2dcc0941a8d,2027-04-12,2027-04-13,Thames Water,4900,Utilities,Water,-34.33,GBP,-79084.07,Direct Debit,Reading,GB,9074,user_001,rec_3a34d62842,
fa56a089-c3a1-4747-a723-81665cdf758e,2027-04-12,2027-04-12,Airline Refund,4511,Travel,Refund,27.11,GBP,-79056.96,Credit,London,GB,1045,user_001,,Refund for Tesco
76f74698-0302-4264-a8d9-3da170fc5336,2027-04-13,2027-04-13,Local Market,5499,Groceries,Specialty,-10.91,GBP,-79067.87,POS,London,GB,4488,user_001,,
852a59c8-d37b-4614-bcac-eccbded88609,2027-04-13,2027-04-15,City Council Tax,9399,Utilities,Council Tax,-181.82,GBP,-79249.69,Direct Debit,London,GB,4488,user_001,rec_f531495db5,
efd12371-ed85-4bf0-b127-6209b2fddc49,2027-04-13,2027-04-13,Shell,5541,Transport,Fuel,-83.5,GBP,-79333.19,POS,London,GB,9074,user_001,,
f872a25c-7ad5-4987-aeeb-d4836d05745a,2027-04-14,2027-04-16,Pret A Manger,5814,Food & Drink,Eating Out,-7.85,GBP,-79341.04,POS,London,GB,2219,user_002,,
07c3b056-72f9-42dd-a775-a28f83849223,2027-04-15,2027-04-15,Tesco,5411,Groceries,Supermarket,-53.57,GBP,-79394.61,POS,London,GB,4488,user_002,,
3d69833c-984b-4e76-bede-a25cf8453374,2027-04-15,2027-04-16,Tesco,5411,Groceries,Supermarket,-43.49,GBP,-79438.1,POS,London,GB,4488,user_001,,
bdb902e0-9790-4dbf-89b5-af057383271f,2027-04-15,2027-04-16,O2 UK,4814,Bills,Mobile,-36.9,GBP,-79475.0,Direct Debit,Slough,GB,1045,user_001,rec_95042d8101,
f12f1caf-d3fb-4213-84c6-3cf8cc2ce343,2027-04-15,2027-04-19,Tesco,5411,Groceries,Supermarket,-19.03,GBP,-79494.03,POS,London,GB,1045,user_001,,
0c595785-49d2-4fca-ac46-e8ddab8f1726,2027-04-16,2027-04-19,Transport for London,4111,Transport,Transit,-6.86,GBP,-79500.89,POS,London,GB,1045,user_001,,
c7f47138-51c3-4e31-ac73-10c0c698fa97,2027-04-16,2027-04-16,Deliveroo,5812,Food & Drink,Delivery,-26.87,GBP,-79527.76,E-Com,London,GB,1045,user_001,,
d4a1a670-7a9b-4508-b87c-8330db67289d,2027-04-16,2027-04-19,Amazon UK,5942,Shopping,Online Retail,-107.96,GBP,-79635.72,E-Com,London,GB,1045,user_001,,
0b8af6c9-72cf-4677-ad1f-e592ac025766,2027-04-17,2027-04-19,Transport for London,4111,Transport,Transit,-3.67,GBP,-79639.39,POS,London,GB,2219,user_001,,
12db5b3c-c83b-4364-b732-53313c52d8ac,2027-04-17,2027-04-19,Deliveroo,5812,Food & Drink,Delivery,-24.56,GBP,-79663.95,E-Com,London,GB,2219,user_001,,
39b93692-5e62-4687-9445-5435410d8c0d,2027-04-17,2027-04-19,Tesco,5411,Groceries,Supermarket,-43.53,GBP,-79707.48,POS,London,GB,4488,user_001,,
3bc5a842-7aa6-40a3-91dd-1bd21fd93a9c,2027-04-17,2027-04-19,Amazon UK,5942,Shopping,Online Retail,-99.38,GBP,-79806.86,E-Com,London,GB,9074,user_001,,
ab8fc9de-d4e6-4576-9da7-1329b445a226,2027-04-17,2027-04-19,Apple.com/bill,5734,Shopping,Electronics,-136.72,GBP,-79943.58,E-Com,Cupertino,US,9074,user_002,,
bafe95a6-1d8e-40b2-af7f-5608f9eac0aa,2027-04-17,2027-04-19,Sainsbury's,5411,Groceries,Supermarket,-59.86,GBP,-80003.44,POS,London,GB,2219,user_001,,
c5602c22-1483-4360-a6df-b2ac28a35b8e,2027-04-17,2027-04-19,Sainsbury's,5411,Groceries,Supermarket,-58.72,GBP,-80062.16,POS,London,GB,4488,user_001,,
ddd36184-bc33-42af-8000-642416d79aae,2027-04-17,2027-04-19,Apple.com/bill,5734,Shopping,Electronics,-131.36,GBP,-80193.52,E-Com,Cupertino,US,4488,user_001,,
066301e6-a3a0-47aa-b8b3-d87e0eb381fe,2027-04-18,2027-04-20,Uber UK,4121,Transport,Ride Hailing,-26.66,GBP,-80220.18,E-Com,London,GB,1045,user_001,,
404f881c-75b4-4036-b11c-da39f724cdd0,2027-04-18,2027-04-20,Sainsbury's,5411,Groceries,Supermarket,-55.56,GBP,-80275.74,POS,London,GB,2219,user_002,,
2b33edc6-66e4-4888-a3a5-0fad3252709f,2027-04-19,2027-04-21,GymBox,7997,Wellness,Gym,-61.55,GBP,-80337.29,Direct Debit,London,GB,4488,user_002,rec_19771e79cd,
4100aec1-3b05-4c02-b5a0-3425f25b8166,2027-04-19,2027-04-20,Local Market,5499,Groceries,Specialty,-9.96,GBP,-80347.25,POS,London,GB,2219,user_001,,
de06bc6f-bbcf-4390-bc4e-aa99e894bea5,2027-04-19,2027-04-20,Spotify,5735,Entertainment,Subscriptions,-8.51,GBP,-80355.76,E-Com,Stockholm,SE,2219,user_001,rec_4c746d2c3b,
524de0be-9428-4fa7-9a1d-c0e628dca9d1,2027-04-20,2027-04-21,Amazon UK,5942,Shopping,Online Retail,-119.41,GBP,-80475.17,E-Com,London,GB,9074,user_002,,
7e6cb97d-be27-4312-86e9-58b7989542ed,2027-04-20,2027-04-20,Deliveroo,5812,Food & Drink,Delivery,-20.44,GBP,-80495.61,E-Com,London,GB,4488,user_001,,
0278c9c1-5227-414f-94c0-0dfbac003d44,2027-04-21,2027-04-22,Apple.com/bill,5734,Shopping,Electronics,-71.38,USD,-80566.99,E-Com,Cupertino,US,2219,user_001,,FX purchase 89.48 USD @ rate 1.25
83bfdf44-201f-4ec0-b272-3e1ef9da605e,2027-04-21,2027-04-23,Netflix,7841,Entertainment,Subscriptions,-15.99,USD,-80582.98,E-Com,Los Gatos,US,1045,user_001,rec_1bfe33738d,FX purchase 19.62 USD @ rate 1.23
891c7887-deda-444f-80f1-259004591a3e,2027-04-21,2027-04-23,Sainsbury's,5411,Groceries,Supermarket,-44.8,GBP,-80627.78,POS,London,GB,2219,user_001,,
ad47bfe6-c40f-4635-8132-de251e8d3ad8,2027-04-21,2027-04-22,Tesco,5411,Groceries,Supermarket,-71.6,GBP,-80699.38,POS,London,GB,9074,user_002,,
69c5973c-8bed-406b-95a5-2bcdf4bf930b,2027-04-22,2027-04-26,Apple.com/bill,5734,Shopping,Electronics,-184.99,USD,-80884.37,E-Com,Cupertino,US,4488,user_001,,FX purchase 222.45 USD @ rate 1.20
df5745a0-ecbe-4066-b491-4d084e5ee367,2027-04-22,2027-04-22,Sainsbury's,5411,Groceries,Supermarket,-25.62,GBP,-80909.99,POS,London,GB,2219,user_001,,
18f06c8c-c568-4da2-87b0-8d7f9c4898e6,2027-04-23,2027-04-23,Sainsbury's,5411,Groceries,Supermarket,-40.57,GBP,-80950.56,POS,London,GB,2219,user_001,,
318ff9c8-e5e7-4eb4-aa3b-f4ea82744fa7,2027-04-23,2027-04-26,Local Market,5499,Groceries,Specialty,-12.95,GBP,-80963.51,POS,London,GB,4488,user_001,,
6e28c789-745e-4d70-a61e-a689a0af330f,2027-04-23,2027-04-23,T212 Capital,6011,Income,Salary,3190.53,GBP,-77772.98,Credit,London,GB,9074,user_001,rec_2ff8f778d0,
841f730a-c5ee-48cf-ad66-37b510b517ca,2027-04-23,2027-04-26,Apple.com/bill,5734,Shopping,Electronics,-209.75,GBP,-77982.73,E-Com,Cupertino,US,9074,user_001,,
9e6ffd7c-d289-4386-998a-347656e859c5,2027-04-23,2027-04-26,Waitrose,5411,Groceries,Supermarket,-29.98,GBP,-78012.71,POS,London,GB,9074,user_001,,
4fa3392a-b991-4d5f-aafb-95a1f2e50109,2027-04-24,2027-04-26,HM Revenue & Customs,9311,Income,Tax Refund,125.93,GBP,-77886.78,Credit,London,GB,1045,user_002,,Refund for Apple.com/bill
e71fb556-db57-46b3-9631-1f6c4aaece89,2027-04-24,2027-04-26,Uber UK,4121,Transport,Ride Hailing,-18.23,GBP,-77905.01,E-Com,London,GB,4488,user_001,,
f253afff-51ee-40f3-9cd4-a09a7870bf65,2027-04-24,2027-04-26,Local Market,5499,Groceries,Specialty,-21.1,GBP,-77926.11,POS,London,GB,4488,user_001,,
1d975793-60cc-4635-b741-236d0ad9017c,2027-04-25,2027-04-27,Shell,5541,Transport,Fuel,-82.74,GBP,-78008.85,POS,London,GB,2219,user_001,,
5cd49b6b-2ece-4334-b7c1-807cbfec1e2f,2027-04-25,2027-04-27,Tesco,5411,Groceries,Supermarket,-55.19,GBP,-78064.04,POS,London,GB,2219,user_002,,
76dc921f-000b-4167-b95f-34e3fd80da8d,2027-04-25,2027-04-26,Shell,5541,Transport,Fuel,-57.32,GBP,-78121.36,POS,London,GB,1045,user_001,,
f67dfa06-1a76-4d3e-9629-b9fa2e88ac54,2027-04-25,2027-04-26,Waitrose,5411,Groceries,Supermarket,-46.2,GBP,-78167.56,POS,London,GB,4488,user_001,,
0726da3e-cc5e-48d5-a090-50952e6550bd,2027-04-26,2027-04-27,Apple.com/bill,5734,Shopping,Electronics,-128.75,USD,-78296.31,E-Com,Cupertino,US,9074,user_001,,FX purchase 159.21 USD @ rate 1.24
48d43393-82fe-4156-ba47-2daf1614b941,2027-04-26,2027-04-27,Local Market,5499,Groceries,Specialty,-8.88,GBP,-78305.19,POS,London,GB,1045,user_001,,
6ddca30a-16ca-445b-b119-5860f5ab29a1,2027-04-26,2027-04-27,Amazon UK,5942,Shopping,Online Retail,-37.88,GBP,-78343.07,E-Com,London,GB,9074,user_001,,
c16db778-b671-4b41-9c17-12a4275d80e4,2027-04-26,2027-04-26,Waitrose,5411,Groceries,Supermarket,-57.23,GBP,-78400.3,POS,London,GB,9074,user_001,,
0d3fda1f-30b2-418b-b741-11f32ee9f018,2027-04-27,2027-04-28,Deliveroo,5812,Food & Drink,Delivery,-12.45,GBP,-78412.75,E-Com,London,GB,4488,user_001,,
7229c739-2327-4f27-a3ee-19448d5196fb,2027-04-27,2027-04-28,Deliveroo,5812,Food & Drink,Delivery,-14.55,GBP,-78427.3,E-Com,London,GB,1045,user_001,,
8a7e91c2-71bd-4705-9e71-86a90c98096c,2027-04-27,2027-04-27,HM Revenue & Customs,9311,Income,Tax Refund,34.48,GBP,-78392.82,Credit,London,GB,2219,user_002,,Refund for Tesco
8dac2ba1-c1ec-4475-98f0-aa590623b3cf,2027-04-27,2027-04-28,Amazon UK,5942,Shopping,Online Retail,-95.94,GBP,-78488.76,E-Com,London,GB,4488,user_001,,
e340d898-1f9b-401f-bd28-50d0d6424c83,2027-04-27,2027-04-27,Apple.com/bill,5734,Shopping,Electronics,-115.25,GBP,-78604.01,E-Com,Cupertino,US,9074,user_001,,
130b79d6-7647-4b5a-989f-f5d20965c8da,2027-04-28,2027-04-28,Amazon UK,5942,Shopping,Online Retail,-84.65,GBP,-78688.66,E-Com,London,GB,1045,user_001,,
d0be536f-2629-4b88-ae9b-5945ff018780,2027-04-29,2027-05-03,Deliveroo,5812,Food & Drink,Delivery,-19.78,GBP,-78708.44,E-Com,London,GB,4488,user_001,,
3aef928b-351b-4043-9273-f7b87f7da142,2027-04-30,2027-04-30,Pret A Manger,5814,Food & Drink,Eating Out,-7.2,GBP,-78715.64,POS,London,GB,1045,user_001,,
97efd1bb-96dd-4c52-a479-567821d5522d,2027-04-30,2027-04-30,Airline Refund,4511,Travel,Refund,46.71,GBP,-78668.93,Credit,London,GB,2219,user_001,,Refund for Shell
999cc46f-e719-4172-84f1-77da033e3587,2027-04-30,2027-05-03,Local Market,5499,Groceries,Specialty,-7.76,GBP,-78676.69,POS,London,GB,1045,user_001,,
0576422e-8183-43fc-8b3e-22eec50cb38a,2027-05-01,2027-05-03,Uber UK,4121,Transport,Ride Hailing,-15.32,GBP,-78692.01,E-Com,London,GB,4488,user_001,,
36803595-7c52-48a8-ad23-c9a9b38af088,2027-05-01,2027-05-03,Sainsbury's,5411,Groceries,Supermarket,-23.32,GBP,-78715.33,POS,London,GB,2219,user_001,,
509140a6-c1eb-4b65-813a-bd66d3903b31,2027-05-01,2027-05-03,Tesco,5411,Groceries,Supermarket,-77.5,GBP,-78792.83,POS,London,GB,1045,user_001,,
a753ff94-9864-4028-a043-285a476abe21,2027-05-01,2027-05-03,Sainsbury's,5411,Groceries,Supermarket,-22.21,GBP,-78815.04,POS,London,GB,2219,user_002,,
d9356bbf-aa35-4187-9ac3-93967375dd60,2027-05-01,2027-05-03,ATM Withdrawal,6011,Cash,ATM,-89.09,GBP,-78904.13,ATM,London,GB,4488,user_001,,
21446085-3337-4b2b-bbea-c23128351dcc,2027-05-02,2027-05-04,Waitrose,5411,Groceries,Supermarket,-82.65,GBP,-78986.78,POS,London,GB,1045,user_001,,
243b8722-22af-4ae7-af66-5b004a483fd0,2027-05-02,2027-05-04,Tesco,5411,Groceries,Supermarket,-68.38,GBP,-79055.16,POS,London,GB,1045,user_001,,
fba1d74e-fdf3-4921-a50d-4d8028a0fcf5,2027-05-02,2027-05-04,Deliveroo,5812,Food & Drink,Delivery,-21.54,GBP,-79076.7,E-Com,London,GB,2219,user_002,,
a88191e3-ba32-4eb3-83aa-92056fa223f9,2027-05-03,2027-05-03,Crown Estates Lettings,6513,Housing,Rent,-1530.82,GBP,-80607.52,POS,London,GB,2219,user_001,rec_19f70fbcce,
c478d7b6-59ed-4aa7-84d0-7b2ec3378cbf,2027-05-03,2027-05-03,Shell,5541,Transport,Fuel,-84.17,GBP,-80691.69,POS,London,GB,1045,user_001,,
6d9c9bd2-9592-4ee4-86b0-743e3e45438d,2027-05-04,2027-05-06,Apple.com/bill,5734,Shopping,Electronics,-41.31,GBP,-80733.0,E-Com,Cupertino,US,4488,user_001,,
e6954bd9-6597-4b56-b8ed-d64f8618bc7e,2027-05-04,2027-05-06,Amazon UK,5942,Shopping,Online Retail,-93.66,GBP,-80826.66,E-Com,London,GB,9074,user_001,,
4d81c54b-6ef4-487b-a3f3-081b5f8b6c53,2027-05-05,2027-05-06,Amazon UK,5942,Shopping,Online Retail,-97.06,GBP,-80923.72,E-Com,London,GB,1045,user_001,,
7f7ff8d1-de73-4111-8254-8b161a0e8c3b,2027-05-05,2027-05-07,Sainsbury's,5411,Groceries,Supermarket,-45.83,GBP,-80969.55,POS,London,GB,9074,user_001,,
0372aa79-23eb-4137-a067-ae37ce89daa1,2027-05-06,2027-05-06,Local Market,5499,Groceries,Specialty,-6.79,GBP,-80976.34,POS,London,GB,4488,user_001,,
e7580f8f-392e-4793-bce8-9343487d8a7a,2027-05-06,2027-05-06,Amazon UK,5942,Shopping,Online Retail,-109.19,GBP,-81085.53,E-Com,London,GB,1045,user_001,,
57d74a91-ccad-4573-9807-c1f446a8ec00,2027-05-07,2027-05-10,Octopus Energy,4900,Utilities,Electricity,-140.44,GBP,-81225.97,Direct Debit,London,GB,1045,user_001,rec_141a4a0666,
9da6b8bf-7f25-486f-959b-d447e2840318,2027-05-07,2027-05-10,Shell,5541,Transport,Fuel,-74.25,GBP,-81300.22,POS,London,GB,2219,user_001,,
34b5d37a-a2b3-40bb-afb8-bf284dbc48b1,2027-05-08,2027-05-10,Transport for London,4111,Transport,Transit,-10.73,GBP,-81310.95,POS,London,GB,4488,user_001,,
49b7974d-b211-45ab-acf5-40ee4171303b,2027-05-08,2027-05-10,Tesco,5411,Groceries,Supermarket,-84.27,GBP,-81395.22,POS,London,GB,2219,user_001,,
fe539390-a03e-4dc7-876e-3bc2285b74c4,2027-05-08,2027-05-10,Tesco,5411,Groceries,Supermarket,-79.33,GBP,-81474.55,POS,London,GB,2219,user_002,,
8a1fd038-8148-4491-8ed4-5d9130bcd96d,2027-05-09,2027-05-11,Deliveroo,5812,Food & Drink,Delivery,-22.35,GBP,-81496.9,E-Com,London,GB,1045,user_001,,
8b40f949-9e1d-4e9c-8faf-5e72a79b400f,2027-05-09,2027-05-10,Apple.com/bill,5734,Shopping,Electronics,-99.77,GBP,-81596.67,E-Com,Cupertino,US,1045,user_001,,
da2d83a7-f87f-46f0-83ed-f5f02210d8f9,2027-05-09,2027-05-10,Local Market,5499,Groceries,Specialty,-7.52,GBP,-81604.19,POS,London,GB,1045,user_001,,
959d8d55-4071-4678-844d-b5638e4d673f,2027-05-10,2027-05-11,Pret A Manger,5814,Food & Drink,Eating Out,-10.38,GBP,-81614.57,POS,London,GB,2219,user_001,,
c1594c83-0843-4808-a450-16115ea7277a,2027-05-10,2027-05-12,Uber UK,4121,Transport,Ride Hailing,-34.41,GBP,-81648.98,E-Com,London,GB,1045,user_001,,
f72cf4c2-b555-49ed-8bc5-7dc98ebfc106,2027-05-10,2027-05-10,Amazon UK,5942,Shopping,Online Retail,-50.12,GBP,-81699.1,E-Com,London,GB,1045,user_001,,
38cfb092-f0ba-4a10-bdf8-33ab76a217a2,2027-05-11,2027-05-12,Thames Water,4900,Utilities,Water,-43.72,GBP,-81742.82,Direct Debit,Reading,GB,1045,user_001,rec_3a34d62842,
008884fc-fe0e-410a-8f4b-29674a56b38f,2027-05-12,2027-05-13,Apple.com/bill,5734,Shopping,Electronics,-146.02,GBP,-81888.84,E-Com,Cupertino,US,9074,user_001,,
af3183b4-36ce-4976-848d-bf744046b571,2027-05-12,2027-05-12,Pret A Manger,5814,Food & Drink,Eating Out,-10.14,GBP,-81898.98,POS,London,GB,4488,user_001,,
fc186e06-6e55-4d0d-9f78-997bbc80de8e,2027-05-13,2027-05-13,City Council Tax,9399,Utilities,Council Tax,-184.16,GBP,-82083.14,Direct Debit,London,GB,9074,user_002,rec_6feaa5d43f,
800fd628-1dc2-47b5-8714-6ab70b103d01,2027-05-14,2027-05-17,Local Market,5499,Groceries,Specialty,-7.35,GBP,-82090.49,POS,London,GB,1045,user_002,,
a9125f09-15c1-4659-bffc-d06bf4e8bcc5,2027-05-14,2027-05-17,Tesco,5411,Groceries,Supermarket,-29.21,GBP,-82119.7,POS,London,GB,1045,user_001,,
1935c1cd-567c-49ff-9806-9ec9a30c0fd3,2027-05-15,2027-05-17,Local Market,5499,Groceries,Specialty,-12.41,GBP,-82132.11,POS,London,GB,1045,user_001,,
70f83956-7c40-4ae1-827a-7d0f67be980c,2027-05-15,2027-05-17,Pret A Manger,5814,Food & Drink,Eating Out,-8.32,GBP,-82140.43,POS,London,GB,2219,user_001,,
0adb42d8-af1b-4768-858e-e822774864dc,2027-05-16,2027-05-17,Local Market,5499,Groceries,Specialty,-19.66,GBP,-82160.09,POS,London,GB,1045,user_001,,
f504f1cd-45ee-4574-ab10-45c796438eba,2027-05-16,2027-05-17,Amazon UK,5942,Shopping,Online Retail,-20.92,GBP,-82181.01,E-Com,London,GB,9074,user_002,,
207df2f3-abe9-430c-93c7-c5e66b06691e,2027-05-17,2027-05-19,GymBox,7997,Wellness,Gym,-58.37,GBP,-82239.38,Direct Debit,London,GB,4488,user_001,rec_3906953fd2,
66df9d2d-70de-47b0-8af2-5ac4df18d5f5,2027-05-17,2027-05-19,Pret A Manger,5814,Food & Drink,Eating Out,-11.16,GBP,-82250.54,POS,London,GB,9074,user_002,,
ad0fe4ef-1d01-446e-a44f-e812f4beb3e4,2027-05-17,2027-05-18,Amazon UK,5942,Shopping,Online Retail,-52.93,GBP,-82303.47,E-Com,London,GB,1045,user_002,,
b2344e52-4e63-4732-a6a9-ee1191103e1c,2027-05-17,2027-05-19,O2 UK,4814,Bills,Mobile,-42.05,GBP,-82345.52,Direct Debit,Slough,GB,1045,user_001,rec_95042d8101,
1910e783-1728-440d-86ff-63e4ff4e18cf,2027-05-18,2027-05-18,Amazon UK,5942,Shopping,Online Retail,-9.5,GBP,-82355.02,E-Com,London,GB,9074,user_002,,
711d2a36-a441-478e-b258-0d95643067ed,2027-05-18,2027-05-18,Waitrose,5411,Groceries,Supermarket,-62.75,GBP,-82417.77,POS,London,GB,4488,user_001,,
a5030118-5b34-48a1-ab65-7b46445f70ce,2027-05-18,2027-05-18,Amazon UK,5942,Shopping,Online Retail,-64.33,GBP,-82482.1,E-Com,London,GB,9074,user_002,,
6c84b4f9-8925-46ab-ab57-f197a697f3a2,2027-05-19,2027-05-21,Spotify,5735,Entertainment,Subscriptions,-8.99,EUR,-82491.09,E-Com,Stockholm,SE,4488,user_002,rec_34b6e9e33f,FX purchase 10.21 EUR @ rate 1.14
a534773a-6736-4241-899f-eeec61e4e4af,2027-05-19,2027-05-20,Amazon UK,5942,Shopping,Online Retail,-74.91,GBP,-82566.0,E-Com,London,GB,2219,user_002,,
e191a458-e1ff-444f-8869-803acc3bec8f,2027-05-19,2027-05-20,Transport for London,4111,Transport,Transit,-11.28,GBP,-82577.28,POS,London,GB,2219,user_002,,
f5d045ec-69f0-435c-8598-5b84658ebec6,2027-05-19,2027-05-19,Local Market,5499,Groceries,Specialty,-21.69,GBP,-82598.97,POS,London,GB,4488,user_001,,
93ed6417-8d45-45f0-baa4-0d5fabc85d6a,2027-05-20,2027-05-21,Pret A Manger,5814,Food & Drink,Eating Out,-11.77,GBP,-82610.74,POS,London,GB,1045,user_002,,
648a1988-f53d-4da4-84ee-85f3c0c507ac,2027-05-21,2027-05-24,Shell,5541,Transport,Fuel,-61.12,GBP,-82671.86,POS,London,GB,2219,user_001,,
93807d60-1e73-45f6-81ae-2001a4482626,2027-05-21,2027-05-21,Netflix,7841,Entertainment,Subscriptions,-14.46,GBP,-82686.32,E-Com,Los Gatos,US,2219,user_001,rec_1bfe33738d,
dc32072f-003c-465a-8881-115f79167396,2027-05-21,2027-05-21,HM Revenue & Customs,9311,Income,Tax Refund,9.11,GBP,-82677.21,Credit,London,GB,2219,user_001,,Refund for Transport for London
33e2c7cb-9cac-4e57-ae12-f2d1422a1440,2027-05-22,2027-05-24,Amazon UK,5942,Shopping,Online Retail,-84.44,GBP,-82761.65,E-Com,London,GB,1045,user_002,,
7b1f107d-c878-418d-ab93-69f2ee5e661a,2027-05-22,2027-05-24,Shell,5541,Transport,Fuel,-36.66,GBP,-82798.31,POS,London,GB,4488,user_001,,
1dbbf071-6dc3-4ad8-ad1a-9894357117b3,2027-05-23,2027-05-24,Amazon UK,5942,Shopping,Online Retail,-31.83,GBP,-82830.14,E-Com,London,GB,9074,user_001,,
3191b7cc-93a5-4fef-b3a9-60857f1e99f9,2027-05-23,2027-05-24,Uber UK,4121,Transport,Ride Hailing,-10.04,GBP,-82840.18,E-Com,London,GB,1045,user_001,,
77494f43-759a-4379-93fb-407750a71dd9,2027-05-23,2027-05-24,Amazon UK,5942,Shopping,Online Retail,-14.23,GBP,-82854.41,E-Com,London,GB,4488,user_001,,
85988640-79fb-47a1-bdcf-7251ce4baaaf,2027-05-23,2027-05-24,Shell,5541,Transport,Fuel,-52.39,GBP,-82906.8,POS,London,GB,4488,user_001,,
c6fd24f7-9979-4b18-8001-1df504248765,2027-05-23,2027-05-24,Shell,5541,Transport,Fuel,-58.43,GBP,-82965.23,POS,London,GB,9074,user_001,,
de147406-2050-4ed5-b24b-2afb79956b98,2027-05-23,2027-05-25,Waitrose,5411,Groceries,Supermarket,-34.64,GBP,-82999.87,POS,London,GB,9074,user_001,,
e8e20f03-e987-4b9a-998b-7d35da27efa0,2027-05-23,2027-05-24,Transport for London,4111,Transport,Transit,-4.24,GBP,-83004.11,POS,London,GB,9074,user_002,,
20eb0101-647b-4897-87ce-bd25a03b470b,2027-05-24,2027-05-25,Sainsbury's,5411,Groceries,Supermarket,-20.17,GBP,-83024.28,POS,London,GB,1045,user_001,,
9b20c0ee-9d25-4d5e-90c7-3f6daf8b8bee,2027-05-24,2027-05-25,Tesco,5411,Groceries,Supermarket,-61.28,GBP,-83085.56,POS,London,GB,4488,user_001,,
b1bc205d-1f83-4e14-9933-417066c8942c,2027-05-24,2027-05-26,Shell,5541,Transport,Fuel,-36.03,GBP,-83121.59,POS,London,GB,9074,user_001,,
07627fcc-9588-481a-8baf-c27a186d6fd2,2027-05-25,2027-05-27,Sainsbury's,5411,Groceries,Supermarket,-59.75,GBP,-83181.34,POS,London,GB,4488,user_001,,
103b7533-40df-499f-bdd3-b33857748ab1,2027-05-25,2027-05-25,T212 Capital,6011,Income,Salary,3343.41,GBP,-79837.93,Credit,London,GB,4488,user_001,rec_2ff8f778d0,
3bb6166c-7f71-42c9-9239-a21a66c97c91,2027-05-26,2027-05-28,Apple.com/bill,5734,Shopping,Electronics,-202.94,USD,-80040.87,E-Com,Cupertino,US,4488,user_001,,FX purchase 247.0 USD @ rate 1.22
b033f6d1-a1a3-4232-bcdf-a3d00c1ceb80,2027-05-26,2027-05-28,Tesco,5411,Groceries,Supermarket,-62.53,GBP,-80103.4,POS,London,GB,9074,user_002,,
ff6e8b6a-c7e2-4bea-a43f-b536206a277e,2027-05-27,2027-05-31,Deliveroo,5812,Food & Drink,Delivery,-12.58,GBP,-80115.98,E-Com,London,GB,9074,user_001,,
4d1fb541-76fe-4fc2-b4ad-ba491e3b720e,2027-05-28,2027-05-31,Deliveroo,5812,Food & Drink,Delivery,-33.39,GBP,-80149.37,E-Com,London,GB,9074,user_001,,
44c9f0e2-0e12-4df5-871a-1ec1d8eac8c8,2027-05-29,2027-05-31,Local Market,5499,Groceries,Specialty,-6.45,GBP,-80155.82,POS,London,GB,4488,user_001,,
b0cc09f6-7dae-428a-af52-b58b89a4255f,2027-05-29,2027-05-31,Deliveroo,5812,Food & Drink,Delivery,-32.55,GBP,-80188.37,E-Com,London,GB,1045,user_001,,
baeb262e-a9c3-469f-80ec-04d5a8cfff65,2027-05-29,2027-05-31,Waitrose,5411,Groceries,Supermarket,-47.09,GBP,-80235.46,POS,London,GB,2219,user_001,,
d7ec49aa-631c-497a-8b98-6abbfed65f11,2027-05-29,2027-05-31,Transport for London,4111,Transport,Transit,-10.0,GBP,-80245.46,POS,London,GB,1045,user_001,,
0767a8ff-b1e4-425f-ae3f-efee841f00d2,2027-05-30,2027-05-31,Sainsbury's,5411,Groceries,Supermarket,-19.76,GBP,-80265.22,POS,London,GB,4488,user_001,,
3cc4a35a-5aaf-452c-bd45-2d77d78bb352,2027-05-30,2027-05-31,Local Market,5499,Groceries,Specialty,-14.23,GBP,-80279.45,POS,London,GB,4488,user_001,,
a50b9aee-ed99-4b69-9cc9-1faff6050559,2027-05-30,2027-06-01,Shell,5541,Transport,Fuel,-52.63,GBP,-80332.08,POS,London,GB,4488,user_001,,
b154720a-dcd0-42c7-b455-d8748ddba6fb,2027-05-30,2027-05-31,Tesco,5411,Groceries,Supermarket,-54.87,GBP,-80386.95,POS,London,GB,4488,user_001,,
bb9710cc-7d83-497f-b04a-343a31cf3459,2027-05-30,2027-05-31,HM Revenue & Customs,9311,Income,Tax Refund,95.45,GBP,-80291.5,Credit,London,GB,4488,user_002,,Refund for City Council Tax
e60570b9-8d28-41a5-8218-9b9e94d4733b,2027-05-30,2027-05-31,Pret A Manger,5814,Food & Drink,Eating Out,-11.88,GBP,-80303.38,POS,London,GB,2219,user_001,,
9c7ac365-dc91-45c8-8b92-568cf9354171,2027-06-01,2027-06-02,Tesco,5411,Groceries,Supermarket,-70.26,GBP,-80373.64,POS,London,GB,2219,user_001,,
baeb5bdd-93c1-4ed8-9338-8af86e79c138,2027-06-01,2027-06-01,Crown Estates Lettings,6513,Housing,Rent,-1466.46,GBP,-81840.1,POS,London,GB,9074,user_001,rec_19f70fbcce,
1bc8d0e2-735e-43f3-9079-6e71f8673b8b,2027-06-02,2027-06-02,Waitrose,5411,Groceries,Supermarket,-67.99,GBP,-81908.09,POS,London,GB,2219,user_001,,
247c9d3f-c0a0-4aef-945b-d3aa76747ade,2027-06-05,2027-06-07,Waitrose,5411,Groceries,Supermarket,-49.16,GBP,-81957.25,POS,London,GB,9074,user_001,,
52fa9862-44d0-4a5a-8f52-5e982db8acaa,2027-06-05,2027-06-07,Tesco,5411,Groceries,Supermarket,-44.74,GBP,-82001.99,POS,London,GB,4488,user_001,,
78b9c67e-8039-4441-a9c3-5317baabad87,2027-06-05,2027-06-07,Transport for London,4111,Transport,Transit,-9.88,GBP,-82011.87,POS,London,GB,1045,user_001,,
7fa72aaf-b620-47ab-bef2-26a131dab6b8,2027-06-05,2027-06-07,Local Market,5499,Groceries,Specialty,-14.39,GBP,-82026.26,POS,London,GB,4488,user_002,,
93bbd711-5a58-4172-a8b0-8197502b3318,2027-06-05,2027-06-07,Amazon UK,5942,Shopping,Online Retail,-59.09,GBP,-82085.35,E-Com,London,GB,4488,user_002,,
b1aea999-987b-4033-b148-83d79c10dfe1,2027-06-05,2027-06-07,Local Market,5499,Groceries,Specialty,-9.54,GBP,-82094.89,POS,London,GB,2219,user_001,,
de75160a-f8b2-42fb-85d0-13e55dff0385,2027-06-05,2027-06-07,Local Market,5499,Groceries,Specialty,-11.11,GBP,-82106.0,POS,London,GB,1045,user_001,,
0d3708a4-334f-472b-a923-2d6ac4898e43,2027-06-06,2027-06-07,Pret A Manger,5814,Food & Drink,Eating Out,-7.44,GBP,-82113.44,POS,London,GB,1045,user_001,,
20db0299-c5dc-4d0b-870c-47e2ce6c144f,2027-06-06,2027-06-08,Waitrose,5411,Groceries,Supermarket,-83.64,GBP,-82197.08,POS,London,GB,4488,user_002,,
554dd5aa-7ae3-4efe-8c0a-e9123c3c820e,2027-06-06,2027-06-08,Amazon UK,5942,Shopping,Online Retail,-54.26,GBP,-82251.34,E-Com,London,GB,9074,user_001,,
bad8c568-865f-4ae3-b857-063414f44e2d,2027-06-06,2027-06-07,Uber UK,4121,Transport,Ride Hailing,-34.32,GBP,-82285.66,E-Com,London,GB,2219,user_001,,
b631127f-2825-4e37-8ce9-ccb1bc9b6725,2027-06-07,2027-06-09,Octopus Energy,4900,Utilities,Electricity,-113.75,GBP,-82399.41,Direct Debit,London,GB,4488,user_002,rec_09c3f12b18,
cf5d3552-3eb6-4a72-93d1-143fa798fa21,2027-06-08,2027-06-09,Sainsbury's,5411,Groceries,Supermarket,-66.09,GBP,-82465.5,POS,London,GB,1045,user_001,,
023cc307-1411-4f85-a0b0-667b1fb28ee4,2027-06-09,2027-06-09,Airline Refund,4511,Travel,Refund,54.93,GBP,-82410.57,Credit,London,GB,4488,user_002,,Refund for Tesco
1e382b40-71d7-4e24-8c4e-ed564582a2ef,2027-06-10,2027-06-11,Tesco,5411,Groceries,Supermarket,-54.67,GBP,-82465.24,POS,London,GB,9074,user_002,,
d2ceaa70-50da-418d-888e-b850afb79a6b,2027-06-10,2027-06-11,Pret A Manger,5814,Food & Drink,Eating Out,-7.93,GBP,-82473.17,POS,London,GB,2219,user_001,,
caea1f5c-3e9a-4f74-bd4a-365a0bb9b762,2027-06-11,2027-06-11,Thames Water,4900,Utilities,Water,-38.45,GBP,-82511.62,Direct Debit,Reading,GB,9074,user_001,rec_3a34d62842,
08362559-0934-4d0b-ba77-6780ea823b97,2027-06-12,2027-06-14,Amazon UK,5942,Shopping,Online Retail,-75.43,GBP,-82587.05,E-Com,London,GB,1045,user_001,,
2ae30af0-e81a-48b7-9f86-7317c8b24af1,2027-06-12,2027-06-14,Sainsbury's,5411,Groceries,Supermarket,-51.47,GBP,-82638.52,POS,London,GB,9074,user_002,,
4f21f223-899b-4bc7-9a4e-9bb43c8064b7,2027-06-12,2027-06-14,Uber UK,4121,Transport,Ride Hailing,-27.59,GBP,-82666.11,E-Com,London,GB,1045,user_001,,
5b6b1543-6029-408f-9570-d246af05b032,2027-06-12,2027-06-14,Sainsbury's,5411,Groceries,Supermarket,-19.12,GBP,-82685.23,POS,London,GB,1045,user_001,,
aa2f328c-afbc-415f-a7a6-d140b3956546,2027-06-12,2027-06-14,Amazon UK,5942,Shopping,Online Retail,-85.95,GBP,-82771.18,E-Com,London,GB,1045,user_001,,
cb6b6561-b93d-497f-ba1e-3845a9a9a727,2027-06-12,2027-06-14,Deliveroo,5812,Food & Drink,Delivery,-28.25,GBP,-82799.43,E-Com,London,GB,2219,user_001,,
4cb4145e-a5e1-4b93-bc41-6461cf80b010,2027-06-13,2027-06-15,Local Market,5499,Groceries,Specialty,-15.63,GBP,-82815.06,POS,London,GB,9074,user_001,,
aa326900-1083-47d1-ba31-fc444447ec93,2027-06-13,2027-06-15,Local Market,5499,Groceries,Specialty,-21.31,GBP,-82836.37,POS,London,GB,9074,user_001,,
70babce8-d5ba-4f45-bde6-2c94d84147ce,2027-06-14,2027-06-16,Local Market,5499,Groceries,Specialty,-10.57,GBP,-82846.94,POS,London,GB,4488,user_001,,
8684acd9-5318-4085-87ff-58a9ccb0eeab,2027-06-14,2027-06-14,City Council Tax,9399,Utilities,Council Tax,-156.02,GBP,-83002.96,Direct Debit,London,GB,4488,user_001,rec_f531495db5,
ea04ec64-98b3-458a-bc00-e554a7f8972e,2027-06-14,2027-06-15,ATM Withdrawal,6011,Cash,ATM,-70.69,GBP,-83073.65,ATM,London,GB,4488,user_001,,
0720dcaa-70a0-4e80-804f-2b2764de7757,2027-06-15,2027-06-17,O2 UK,4814,Bills,Mobile,-37.97,GBP,-83111.62,Direct Debit,Slough,GB,9074,user_001,rec_95042d8101,
1dd08872-0ec7-4540-80b3-b328b3f56c88,2027-06-15,2027-06-17,Transport for London,4111,Transport,Transit,-11.38,GBP,-83123.0,POS,London,GB,9074,user_001,,
2517eae9-37d1-492f-8fcc-92490d01052f,2027-06-15,2027-06-17,Local Market,5499,Groceries,Specialty,-16.23,GBP,-83139.23,POS,London,GB,4488,user_001,,
bc6e4385-ddee-4daa-b3c1-2950d0508cfe,2027-06-15,2027-06-16,Local Market,5499,Groceries,Specialty,-21.14,GBP,-83160.37,POS,London,GB,1045,user_002,,
f109ac43-b67d-4b5c-bd68-c210bb44d5b0,2027-06-15,2027-06-16,Uber UK,4121,Transport,Ride Hailing,-33.12,GBP,-83193.49,E-Com,London,GB,4488,user_001,,
9ed67e91-c84b-461c-a04d-0a4845067fe4,2027-06-16,2027-06-16,Apple.com/bill,5734,Shopping,Electronics,-3.12,GBP,-83196.61,E-Com,Cupertino,US,2219,user_001,,
ae7f655b-4da4-45df-b95e-e145e70eb8d0,2027-06-16,2027-06-17,Apple.com/bill,5734,Shopping,Electronics,-170.4,USD,-83367.01,E-Com,Cupertino,US,9074,user_001,,FX purchase 217.0 USD @ rate 1.27
5916ac3c-a2be-4abb-a6fd-19505dc3bbe9,2027-06-17,2027-06-18,GymBox,7997,Wellness,Gym,-48.39,GBP,-83415.4,Direct Debit,London,GB,2219,user_001,rec_3906953fd2,
bd10fcf2-39bc-4705-87fb-c078c95af5a1,2027-06-17,2027-06-17,Apple.com/bill,5734,Shopping,Electronics,-143.26,GBP,-83558.66,E-Com,Cupertino,US,9074,user_002,,
3ce59890-c6e5-40a9-abe1-8ba62bc1685c,2027-06-18,2027-06-21,Sainsbury's,5411,Groceries,Supermarket,-34.87,GBP,-83593.53,POS,London,GB,9074,user_001,,
a64627d0-d43a-48d8-9ee2-19eeb45636d4,2027-06-18,2027-06-21,Waitrose,5411,Groceries,Supermarket,-75.22,GBP,-83668.75,POS,London,GB,1045,user_001,,
c75be821-1ef1-493c-b1a6-64bfc5e38103,2027-06-18,2027-06-18,Sainsbury's,5411,Groceries,Supermarket,-15.82,GBP,-83684.57,POS,London,GB,1045,user_001,,
4f448c78-dcca-47d9-b567-a2448c039e51,2027-06-19,2027-06-21,Tesco,5411,Groceries,Supermarket,-62.53,GBP,-83747.1,POS,London,GB,4488,user_001,,
f2122e5b-c5bb-49a0-a781-4074754d4f19,2027-06-19,2027-06-21,Shell,5541,Transport,Fuel,-87.27,GBP,-83834.37,POS,London,GB,4488,user_001,,
20c9d73d-cb7a-4166-afba-ec1020c66330,2027-06-20,2027-06-21,Tesco,5411,Groceries,Supermarket,-73.9,GBP,-83908.27,POS,London,GB,9074,user_001,,
1392e58c-e672-4d2d-ab0e-03f5ba35c23d,2027-06-21,2027-06-21,Amazon UK,5942,Shopping,Online Retail,-71.87,GBP,-83980.14,E-Com,London,GB,1045,user_001,,
63c597fd-00b6-4bad-b563-b72bd5aee539,2027-06-21,2027-06-23,Pret A Manger,5814,Food & Drink,Eating Out,-9.51,GBP,-83989.65,POS,London,GB,1045,user_002,,
81abbd7f-7738-4040-924a-093165cfd794,2027-06-21,2027-06-23,Spotify,5735,Entertainment,Subscriptions,-8.04,GBP,-83997.69,E-Com,Stockholm,SE,4488,user_002,rec_34b6e9e33f,
85d13cb4-e851-4d1b-ac61-ea91644d1fdc,2027-06-21,2027-06-22,Pret A Manger,5814,Food & Drink,Eating Out,-9.78,GBP,-84007.47,POS,London,GB,2219,user_001,,
f3a965c5-5e48-4f17-b4f1-47115e27bf49,2027-06-21,2027-06-21,Netflix,7841,Entertainment,Subscriptions,-15.6,GBP,-84023.07,E-Com,Los Gatos,US,2219,user_001,rec_1bfe33738d,
b3d17409-df93-4abe-a50e-a3d3896769b7,2027-06-22,2027-06-23,Uber UK,4121,Transport,Ride Hailing,-29.53,GBP,-84052.6,E-Com,London,GB,1045,user_001,,
04bf0ce7-9fc8-4678-8f66-f2a622d92539,2027-06-23,2027-06-25,Transport for London,4111,Transport,Transit,-7.17,GBP,-84059.77,POS,London,GB,2219,user_001,,
6ec9ff0c-3fa0-4651-a3ef-29eb2945f478,2027-06-23,2027-06-25,Apple.com/bill,5734,Shopping,Electronics,-203.31,USD,-84263.08,E-Com,Cupertino,US,4488,user_001,,FX purchase 258.46 USD @ rate 1.27
06484386-bb22-4f1d-b4f9-64477e350235,2027-06-24,2027-06-25,Waitrose,5411,Groceries,Supermarket,-43.4,GBP,-84306.48,POS,London,GB,1045,user_002,,
3c164ad1-4bfe-4019-b72f-6189a8d12883,2027-06-25,2027-06-25,T212 Capital,6011,Income,Salary,3123.22,GBP,-81183.26,Credit,London,GB,2219,user_001,rec_2ff8f778d0,
8000cc54-bb96-4aae-8fe2-ea6222e66f4e,2027-06-25,2027-06-25,Apple.com/bill,5734,Shopping,Electronics,-197.73,GBP,-81380.99,E-Com,Cupertino,US,2219,user_001,,
36e6ae46-fe74-4dcb-b6ac-0ab6639cf6e8,2027-06-26,2027-06-28,Pret A Manger,5814,Food & Drink,Eating Out,-8.67,GBP,-81389.66,POS,London,GB,2219,user_001,,
39f7c6f6-22f5-4aa9-9cf7-5f3c92b713cb,2027-06-26,2027-06-28,Amazon UK,5942,Shopping,Online Retail,-78.17,GBP,-81467.83,E-Com,London,GB,4488,user_001,,
e4d2c84f-5bf3-4696-8632-803a64ac08d6,2027-06-26,2027-06-28,Sainsbury's,5411,Groceries,Supermarket,-52.11,GBP,-81519.94,POS,London,GB,4488,user_001,,
3b10ce5e-17c3-46bc-8072-fe0f349d3f1d,2027-06-27,2027-06-28,HM Revenue & Customs,9311,Income,Tax Refund,84.25,GBP,-81435.69,Credit,London,GB,2219,user_001,,Refund for Amazon UK
795f96e1-65c6-4188-b0f0-0a10335ca6e9,2027-06-27,2027-06-29,Pret A Manger,5814,Food & Drink,Eating Out,-8.8,GBP,-81444.49,POS,London,GB,4488,user_001,,
a0722814-8679-4133-a355-cde8d6c7c735,2027-06-27,2027-06-29,Transport for London,4111,Transport,Transit,-10.33,GBP,-81454.82,POS,London,GB,1045,user_001,,
a93cd05e-e32f-4130-8bf1-939bd93bb81a,2027-06-28,2027-06-30,Uber UK,4121,Transport,Ride Hailing,-9.61,GBP,-81464.43,E-Com,London,GB,9074,user_002,,
7c6d63ac-48ce-486d-b4c4-8e34809cc2e2,2027-06-30,2027-07-02,Waitrose,5411,Groceries,Supermarket,-89.75,GBP,-81554.18,POS,London,GB,1045,user_001,,
95be9d50-7da7-4fcf-9cfc-57109df5de6d,2027-06-30,2027-07-02,Pret A Manger,5814,Food & Drink,Eating Out,-10.16,GBP,-81564.34,POS,London,GB,9074,user_001,,
0e08963d-6de2-4fb1-b87c-3ffa8f3e43fd,2027-07-01,2027-07-02,Transport for London,4111,Transport,Transit,-6.71,GBP,-81571.05,POS,London,GB,2219,user_001,,
b4e60900-662f-43ae-a57c-471d04898036,2027-07-01,2027-07-02,Crown Estates Lettings,6513,Housing,Rent,-1631.44,GBP,-83202.49,POS,London,GB,1045,user_001,rec_19f70fbcce,
bd7f9b6c-56c8-46dc-9a9b-b8fb20f2188c,2027-07-01,2027-07-02,Pret A Manger,5814,Food & Drink,Eating Out,-9.51,GBP,-83212.0,POS,London,GB,2219,user_002,,
ea1a58f9-3943-4326-9274-08bc8f815e38,2027-07-01,2027-07-02,Transport for London,4111,Transport,Transit,-9.89,GBP,-83221.89,POS,London,GB,2219,user_001,,
35d07295-93d2-4812-8ebf-9186dd9b620f,2027-07-02,2027-07-02,Waitrose,5411,Groceries,Supermarket,-42.99,GBP,-83264.88,POS,London,GB,2219,user_001,,
6c1f3c86-a19b-4a01-b111-90a2876c011c,2027-07-02,2027-07-05,Tesco,5411,Groceries,Supermarket,-35.64,GBP,-83300.52,POS,London,GB,1045,user_001,,
40684020-2c35-4ce3-b3cd-927af32a00f7,2027-07-03,2027-07-05,Shell,5541,Transport,Fuel,-85.07,GBP,-83385.59,POS,London,GB,1045,user_001,,
9ed82cb7-c571-4b48-8b14-4fe9a34af657,2027-07-03,2027-07-05,Deliveroo,5812,Food & Drink,Delivery,-15.73,GBP,-83401.32,E-Com,London,GB,4488,user_001,,
d5d2cdbe-5100-4b66-8161-65e53bf26b24,2027-07-03,2027-07-05,Shell,5541,Transport,Fuel,-52.01,GBP,-83453.33,POS,London,GB,4488,user_001,,
f342fe81-9bdf-455f-9fc9-2de39faa609e,2027-07-03,2027-07-05,Tesco,5411,Groceries,Supermarket,-67.45,GBP,-83520.78,POS,London,GB,9074,user_001,,
c388f3db-cdd4-42bd-9ab2-d376abccb3e8,2027-07-04,2027-07-06,Transport for London,4111,Transport,Transit,-6.3,GBP,-83527.08,POS,London,GB,9074,user_001,,
dc54be20-9c73-4221-8e59-28f625952111,2027-07-05,2027-07-07,Deliveroo,5812,Food & Drink,Delivery,-31.42,GBP,-83558.5,E-Com,London,GB,9074,user_001,,
51d1d383-e1e8-4382-80db-7124451e7241,2027-07-06,2027-07-07,Uber UK,4121,Transport,Ride Hailing,-9.3,GBP,-83567.8,E-Com,London,GB,4488,user_001,,
6aee4a72-0f98-4ad1-b42e-fa6f71ac5885,2027-07-06,2027-07-08,Apple.com/bill,5734,Shopping,Electronics,-11.98,GBP,-83579.78,E-Com,Cupertino,US,9074,user_002,,
8ab742d6-46ba-4db5-92e8-54bc0522a8d9,2027-07-07,2027-07-09,Octopus Energy,4900,Utilities,Electricity,-114.11,GBP,-83693.89,Direct Debit,London,GB,4488,user_001,rec_141a4a0666,
8c4d8420-2de3-47b3-adc5-f80dd4f5861c,2027-07-07,2027-07-08,Waitrose,5411,Groceries,Supermarket,-29.73,GBP,-83723.62,POS,London,GB,2219,user_001,,
c4a55f99-5b81-425b-9b64-078692b17f4b,2027-07-07,2027-07-07,Tesco,5411,Groceries,Supermarket,-34.51,GBP,-83758.13,POS,London,GB,2219,user_001,,
defa0bb4-0bd6-4af9-a183-838fac2fd79c,2027-07-07,2027-07-07,Transport for London,4111,Transport,Transit,-9.83,GBP,-83767.96,POS,London,GB,2219,user_002,,
443f1bd5-718d-4861-8237-04f570fe6093,2027-07-09,2027-07-09,Tesco,5411,Groceries,Supermarket,-46.24,GBP,-83814.2,POS,London,GB,4488,user_001,,
88d5dc3a-87df-470b-b890-42cf63fcd7b5,2027-07-09,2027-07-09,Tesco,5411,Groceries,Supermarket,-37.28,GBP,-83851.48,POS,London,GB,2219,user_001,,
1c1d0155-641f-4b6e-bd4b-d56e0e5b4cb2,2027-07-10,2027-07-12,Sainsbury's,5411,Groceries,Supermarket,-61.35,GBP,-83912.83,POS,London,GB,9074,user_001,,
32b061c6-6701-4112-b3d8-b5c55ef2256b,2027-07-10,2027-07-12,Tesco,5411,Groceries,Supermarket,-47.37,GBP,-83960.2,POS,London,GB,4488,user_001,,
417d7e10-3602-46be-9cee-3a36517deef9,2027-07-10,2027-07-12,Uber UK,4121,Transport,Ride Hailing,-27.56,GBP,-83987.76,E-Com,London,GB,2219,user_002,,
6fa34830-ce0e-4f1d-86b3-32f511bf29e8,2027-07-10,2027-07-12,Pret A Manger,5814,Food & Drink,Eating Out,-7.02,GBP,-83994.78,POS,London,GB,9074,user_001,,
b1f7cce6-781c-4151-874b-fa2cb83a932e,2027-07-10,2027-07-12,Transport for London,4111,Transport,Transit,-7.14,GBP,-84001.92,POS,London,GB,4488,user_001,,
242a5a63-ae44-45f8-b2f2-eba3b50ac7f1,2027-07-11,2027-07-12,Transport for London,4111,Transport,Transit,-4.72,GBP,-84006.64,POS,London,GB,1045,user_001,,
83f5eb2a-7082-4ced-9906-8c8e1b2fc132,2027-07-11,2027-07-12,Sainsbury's,5411,Groceries,Supermarket,-17.06,GBP,-84023.7,POS,London,GB,2219,user_002,,
b451ce2e-08e1-4b13-8893-684051635ecf,2027-07-11,2027-07-12,Waitrose,5411,Groceries,Supermarket,-44.03,GBP,-84067.73,POS,London,GB,1045,user_001,,
e22c54a2-5837-4a64-8a65-e17c71f0a39b,2027-07-11,2027-07-12,Pret A Manger,5814,Food & Drink,Eating Out,-7.97,GBP,-84075.7,POS,London,GB,2219,user_002,,
3ee5290c-5dc7-4e81-b10b-29ee23f06039,2027-07-12,2027-07-14,Deliveroo,5812,Food & Drink,Delivery,-33.7,GBP,-84109.4,E-Com,London,GB,2219,user_002,,
664607a1-e719-4d34-a442-18cf8f99c2e2,2027-07-12,2027-07-13,Thames Water,4900,Utilities,Water,-32.82,GBP,-84142.22,Direct Debit,Reading,GB,4488,user_001,rec_3a34d62842,
b503a87d-03a3-444a-aa91-ba4519d721cc,2027-07-13,2027-07-13,City Council Tax,9399,Utilities,Council Tax,-163.44,GBP,-84305.66,Direct Debit,London,GB,9074,user_001,rec_f531495db5,
bd973b6e-ca15-414c-81a7-782b1032fa04,2027-07-13,2027-07-13,HM Revenue & Customs,9311,Income,Tax Refund,4.88,GBP,-84300.78,Credit,London,GB,4488,user_001,,Refund for Transport for London
8b077f6e-27fb-489e-a2c7-74d79ae0e756,2027-07-14,2027-07-15,Amazon UK,5942,Shopping,Online Retail,-75.61,GBP,-84376.39,E-Com,London,GB,1045,user_001,,
11f55d65-6347-4fe9-a799-f5675a7309a8,2027-07-15,2027-07-19,O2 UK,4814,Bills,Mobile,-36.9,GBP,-84413.29,Direct Debit,Slough,GB,4488,user_001,rec_95042d8101,
e1d70691-19b9-44c2-93e9-1f6487f80e6e,2027-07-15,2027-07-19,Waitrose,5411,Groceries,Supermarket,-88.7,GBP,-84501.99,POS,London,GB,4488,user_001,,
9c2084c7-9f74-4464-b228-a620ac158160,2027-07-17,2027-07-19,Tesco,5411,Groceries,Supermarket,-42.77,GBP,-84544.76,POS,London,GB,2219,user_001,,
b1e5e890-ff10-4a57-92ff-a98dff145b6f,2027-07-17,2027-07-19,Local Market,5499,Groceries,Specialty,-13.43,GBP,-84558.19,POS,London,GB,9074,user_001,,
63b37b3c-3a51-4ebd-a1cb-b3a23d7aad5a,2027-07-18,2027-07-19,Amazon UK,5942,Shopping,Online Retail,-95.39,GBP,-84653.58,E-Com,London,GB,4488,user_001,,
ae8b0129-e395-4381-b6f5-0109f956985e,2027-07-18,2027-07-19,Sainsbury's,5411,Groceries,Supermarket,-69.39,GBP,-84722.97,POS,London,GB,1045,user_001,,
a8954f28-e5d4-43be-9a24-5c643fa074ac,2027-07-19,2027-07-21,Spotify,5735,Entertainment,Subscriptions,-9.13,EUR,-84732.1,E-Com,Stockholm,SE,4488,user_001,rec_4c746d2c3b,FX purchase 10.34 EUR @ rate 1.13
fad5729c-a825-4507-a2ca-1a7b0540c072,2027-07-19,2027-07-20,GymBox,7997,Wellness,Gym,-51.35,GBP,-84783.45,Direct Debit,London,GB,2219,user_001,rec_3906953fd2,
46faf66f-744a-49ae-a7d6-f0e235b259a6,2027-07-20,2027-07-21,Apple.com/bill,5734,Shopping,Electronics,-73.55,GBP,-84857.0,E-Com,Cupertino,US,1045,user_001,,
50495986-2e5f-4b4c-bfac-f4f8e9e59c51,2027-07-21,2027-07-22,Netflix,7841,Entertainment,Subscriptions,-12.56,USD,-84869.56,E-Com,Los Gatos,US,1045,user_001,rec_1bfe33738d,FX purchase 15.39 USD @ rate 1.23
5956fa29-5c87-4f38-8c6d-fc2effebfefc,2027-07-21,2027-07-21,Sainsbury's,5411,Groceries,Supermarket,-33.17,GBP,-84902.73,POS,London,GB,9074,user_001,,
646854b8-e39c-4edc-b18e-87f40017734a,2027-07-21,2027-07-23,Transport for London,4111,Transport,Transit,-3.6,GBP,-84906.33,POS,London,GB,4488,user_001,,
b227ba9c-f6ea-4b30-8b3b-be580fc7d229,2027-07-21,2027-07-22,Apple.com/bill,5734,Shopping,Electronics,-160.4,GBP,-85066.73,E-Com,Cupertino,US,2219,user_002,,
f93b929a-f2f0-4020-9b1c-9324ab0bbcde,2027-07-21,2027-07-22,Pret A Manger,5814,Food & Drink,Eating Out,-11.94,GBP,-85078.67,POS,London,GB,4488,user_001,,
bb96659b-3283-453e-a39f-7128ec361b5a,2027-07-22,2027-07-23,Tesco,5411,Groceries,Supermarket,-67.98,GBP,-85146.65,POS,London,GB,2219,user_001,,
e0c51cd2-8f8b-4edb-965c-81a6f80bb29a,2027-07-22,2027-07-26,Deliveroo,5812,Food & Drink,Delivery,-21.84,GBP,-85168.49,E-Com,London,GB,9074,user_001,,
c4adaa14-9037-49da-a023-b0fe50ab0037,2027-07-23,2027-07-23,T212 Capital,6011,Income,Salary,3440.46,GBP,-81728.03,Credit,London,GB,2219,user_002,rec_c649d24d0f,
4cb2abde-cf46-40cb-813c-c88b361e95c8,2027-07-24,2027-07-26,Transport for London,4111,Transport,Transit,-5.6,GBP,-81733.63,POS,London,GB,9074,user_001,,
8487763a-eac5-49c8-91fe-0ee27282ff56,2027-07-24,2027-07-26,Waitrose,5411,Groceries,Supermarket,-32.44,GBP,-81766.07,POS,London,GB,1045,user_001,,
d5927b41-aa03-4b38-9497-cb420914f907,2027-07-24,2027-07-26,Waitrose,5411,Groceries,Supermarket,-69.91,GBP,-81835.98,POS,London,GB,4488,user_001,,
1a6d229d-d52b-45b8-b5e8-a07f88787001,2027-07-25,2027-07-26,Sainsbury's,5411,Groceries,Supermarket,-56.96,GBP,-81892.94,POS,London,GB,2219,user_001,,
1c334280-28bc-416a-a7b4-ddfc4fa352e3,2027-07-25,2027-07-27,Local Market,5499,Groceries,Specialty,-7.98,GBP,-81900.92,POS,London,GB,2219,user_001,,
3f42efa6-245c-4fa2-bc98-9b7818f9bb68,2027-07-25,2027-07-26,Tesco,5411,Groceries,Supermarket,-63.24,GBP,-81964.16,POS,London,GB,1045,user_001,,
589033c4-a1e0-46ed-afb7-fedba218a32b,2027-07-25,2027-07-26,Sainsbury's,5411,Groceries,Supermarket,-51.09,GBP,-82015.25,POS,London,GB,1045,user_001,,
5ddd2836-2a98-462c-90c4-29b4901bcbb1,2027-07-25,2027-07-26,Local Market,5499,Groceries,Specialty,-13.02,GBP,-82028.27,POS,London,GB,1045,user_002,,
52ebf7ce-2399-4132-9f2c-4e1784eebee8,2027-07-26,2027-07-27,Local Market,5499,Groceries,Specialty,-14.61,GBP,-82042.88,POS,London,GB,2219,user_002,,
5861e772-eb16-4b6b-b127-c9850f544f39,2027-07-26,2027-07-26,Uber UK,4121,Transport,Ride Hailing,-8.53,GBP,-82051.41,E-Com,London,GB,9074,user_001,,
66311006-590e-4f5f-832d-01b232f3f453,2027-07-26,2027-07-26,Shell,5541,Transport,Fuel,-48.81,GBP,-82100.22,POS,London,GB,9074,user_001,,
7f187e00-ea86-491a-9ddd-f550df3ee04a,2027-07-26,2027-07-28,Pret A Manger,5814,Food & Drink,Eating Out,-11.07,GBP,-82111.29,POS,London,GB,1045,user_001,,
08ee6735-361d-4f88-820e-2a0efe7a4a32,2027-07-29,2027-07-29,Local Market,5499,Groceries,Specialty,-7.16,GBP,-82118.45,POS,London,GB,1045,user_001,,
6c1dce7f-436a-421e-91c3-0c8e0342a57b,2027-07-29,2027-08-02,Deliveroo,5812,Food & Drink,Delivery,-20.58,GBP,-82139.03,E-Com,London,GB,4488,user_001,,
fa78ee04-2b15-4053-bbc6-5fa6146d55c1,2027-07-29,2027-08-02,Uber UK,4121,Transport,Ride Hailing,-14.63,GBP,-82153.66,E-Com,London,GB,4488,user_001,,
8bf77cbe-0ed9-4da3-8533-09c9224577b7,2027-07-30,2027-08-02,ATM Withdrawal,6011,Cash,ATM,-82.29,GBP,-82235.95,ATM,London,GB,1045,user_001,,
a32abb14-397a-47f1-89e5-6019c279e33d,2027-07-30,2027-08-02,Deliveroo,5812,Food & Drink,Delivery,-32.93,GBP,-82268.88,E-Com,London,GB,4488,user_001,,
2ba3a042-40c7-4cc7-be6b-9cc452400873,2027-07-31,2027-08-02,Shell,5541,Transport,Fuel,-82.34,GBP,-82351.22,POS,London,GB,4488,user_002,,
4f7ee2f7-5dea-4ca2-80dd-5022301d61bf,2027-07-31,2027-08-02,Sainsbury's,5411,Groceries,Supermarket,-40.69,GBP,-82391.91,POS,London,GB,2219,user_002,,
7060d68e-6cfa-4d5a-9a26-c833c19f6614,2027-07-31,2027-08-02,Waitrose,5411,Groceries,Supermarket,-56.91,GBP,-82448.82,POS,London,GB,1045,user_001,,
78e775b7-88ad-48e3-9d93-f4e22c6687ac,2027-07-31,2027-08-02,Apple.com/bill,5734,Shopping,Electronics,-99.16,USD,-82547.98,E-Com,Cupertino,US,9074,user_001,,FX purchase 119.73 USD @ rate 1.21
d4a99046-f11c-4a4a-a40a-f9ddca5e5521,2027-07-31,2027-08-02,Uber UK,4121,Transport,Ride Hailing,-11.81,GBP,-82559.79,E-Com,London,GB,1045,user_001,,
fb165a50-603a-4a72-9f17-70af9ff42839,2027-07-31,2027-08-02,Apple.com/bill,5734,Shopping,Electronics,-8.13,GBP,-82567.92,E-Com,Cupertino,US,4488,user_001,,
12d8dc3e-f7a5-4b6e-b887-4778338e519f,2027-08-01,2027-08-02,Tesco,5411,Groceries,Supermarket,-47.77,GBP,-82615.69,POS,London,GB,9074,user_001,,
54fb7dda-84fd-4c59-8fe5-4c58c50ceed1,2027-08-02,2027-08-04,Deliveroo,5812,Food & Drink,Delivery,-23.61,GBP,-82639.3,E-Com,London,GB,4488,user_002,,
a446a064-155b-48da-9262-9d2d139e9d28,2027-08-02,2027-08-03,Local Market,5499,Groceries,Specialty,-15.9,GBP,-82655.2,POS,London,GB,1045,user_001,,
a559188b-c554-4c34-9611-2f2be8b6f935,2027-08-02,2027-08-03,Crown Estates Lettings,6513,Housing,Rent,-1465.59,GBP,-84120.79,POS,London,GB,4488,user_001,rec_19f70fbcce,
523426ca-0c3c-4ffc-9b4c-abd786cd1657,2027-08-03,2027-08-03,Waitrose,5411,Groceries,Supermarket,-56.9,GBP,-84177.69,POS,London,GB,1045,user_001,,
fd81afbc-b415-4f72-9944-8e5fdcf198dc,2027-08-03,2027-08-04,ATM Withdrawal,6011,Cash,ATM,-73.96,GBP,-84251.65,ATM,London,GB,9074,user_001,,
ffb5ff2d-74dd-4a30-aceb-7549795b6ee5,2027-08-03,2027-08-04,ATM Withdrawal,6011,Cash,ATM,-119.7,GBP,-84371.35,ATM,London,GB,9074,user_001,,
0e55bd06-68af-435b-97f2-446dca86fb8d,2027-08-04,2027-08-04,Deliveroo,5812,Food & Drink,Delivery,-19.9,GBP,-84391.25,E-Com,London,GB,4488,user_002,,
b0e512ac-bff2-47e0-b152-4ee281a77eea,2027-08-04,2027-08-05,Sainsbury's,5411,Groceries,Supermarket,-42.52,GBP,-84433.77,POS,London,GB,9074,user_002,,
c6b26d25-41b5-45c4-b6d9-e85f2eb0345a,2027-08-04,2027-08-06,Deliveroo,5812,Food & Drink,Delivery,-28.68,GBP,-84462.45,E-Com,London,GB,4488,user_001,,
d62603c0-4d76-432d-b8e7-92c0d071931f,2027-08-04,2027-08-04,Waitrose,5411,Groceries,Supermarket,-75.04,GBP,-84537.49,POS,London,GB,4488,user_001,,
f15dc3ae-7005-4cee-981b-89b31363b4aa,2027-08-04,2027-08-05,Amazon UK,5942,Shopping,Online Retail,-24.89,GBP,-84562.38,E-Com,London,GB,2219,user_002,,
a993e7b5-445f-4385-800e-845666322c0c,2027-08-05,2027-08-06,Local Market,5499,Groceries,Specialty,-9.29,GBP,-84571.67,POS,London,GB,9074,user_001,,
aac3acec-1f0d-45c2-b79f-009fe29a8326,2027-08-05,2027-08-06,Transport for London,4111,Transport,Transit,-5.12,GBP,-84576.79,POS,London,GB,4488,user_001,,
95a62a7b-186a-4ba5-879e-4d9250746bad,2027-08-07,2027-08-09,Pret A Manger,5814,Food & Drink,Eating Out,-11.77,GBP,-84588.56,POS,London,GB,1045,user_002,,
ac553782-36bc-4eda-86e6-827d9de39c45,2027-08-07,2027-08-09,Amazon UK,5942,Shopping,Online Retail,-110.11,GBP,-84698.67,E-Com,London,GB,9074,user_001,,
15ed14e4-4c57-41d2-ad5f-c5a2e2d9d687,2027-08-08,2027-08-09,Pret A Manger,5814,Food & Drink,Eating Out,-7.97,GBP,-84706.64,POS,London,GB,4488,user_001,,
191300b2-4c46-4891-932a-eacd42d4ede9,2027-08-08,2027-08-10,Apple.com/bill,5734,Shopping,Electronics,-122.01,USD,-84828.65,E-Com,Cupertino,US,9074,user_002,,FX purchase 151.75 USD @ rate 1.24
6a2d19ac-a628-4d25-82e1-1d463de4107e,2027-08-08,2027-08-09,Tesco,5411,Groceries,Supermarket,-83.34,GBP,-84911.99,POS,London,GB,9074,user_001,,
7830c2a4-d02c-48ef-9a57-23010ad6b3ad,2027-08-09,2027-08-10,Local Market,5499,Groceries,Specialty,-10.01,GBP,-84922.0,POS,London,GB,2219,user_002,,
91259110-28c4-473b-ae45-549f8258b4e0,2027-08-09,2027-08-10,Tesco,5411,Groceries,Supermarket,-66.02,GBP,-84988.02,POS,London,GB,1045,user_001,,
a8f698e7-1384-4923-a689-2a92ee9e028f,2027-08-09,2027-08-11,Airbnb,7011,Travel,Accommodation,-392.11,EUR,-85380.13,E-Com,Dublin,IE,4488,user_002,,Business travel
b7e5fbb7-84d7-4dcc-b2ed-d16b173dd000,2027-08-09,2027-08-09,Octopus Energy,4900,Utilities,Electricity,-123.95,GBP,-85504.08,Direct Debit,London,GB,1045,user_001,rec_141a4a0666,
faedd417-c523-414b-8489-aa1679aa284a,2027-08-09,2027-08-10,Tesco,5411,Groceries,Supermarket,-46.39,GBP,-85550.47,POS,London,GB,1045,user_002,,
9157b57b-d9e8-427b-91f5-795a6a217c0e,2027-08-10,2027-08-10,Apple.com/bill,5734,Shopping,Electronics,-199.87,USD,-85750.34,E-Com,Cupertino,US,2219,user_001,,FX purchase 242.77 USD @ rate 1.21
39f2b819-92a1-42bd-8d39-aeebc102707a,2027-08-11,2027-08-13,Apple.com/bill,5734,Shopping,Electronics,-158.97,GBP,-85909.31,E-Com,Cupertino,US,4488,user_001,,
449269c8-f603-4501-a509-871fec51fc3c,2027-08-11,2027-08-13,Thames Water,4900,Utilities,Water,-40.11,GBP,-85949.42,Direct Debit,Reading,GB,1045,user_001,rec_3a34d62842,
5744bb45-f37d-4df1-99a6-f34bdf29c421,2027-08-11,2027-08-12,Amazon UK,5942,Shopping,Online Retail,-12.28,GBP,-85961.7,E-Com,London,GB,1045,user_001,,
91690042-bc9e-4d45-b1c0-ce7d955eddb0,2027-08-11,2027-08-11,Local Market,5499,Groceries,Specialty,-21.89,GBP,-85983.59,POS,London,GB,1045,user_001,,
b0326b3b-fc66-4655-90f4-edb809d6b399,2027-08-11,2027-08-12,Pret A Manger,5814,Food & Drink,Eating Out,-11.53,GBP,-85995.12,POS,London,GB,9074,user_001,,
1a4d4e3e-1e14-4abd-9f8c-867cd8614ec2,2027-08-12,2027-08-16,Local Market,5499,Groceries,Specialty,-10.21,GBP,-86005.33,POS,London,GB,4488,user_001,,
4898449f-5c2a-4e38-a81a-97cd88d31b94,2027-08-12,2027-08-12,Apple.com/bill,5734,Shopping,Electronics,-104.28,GBP,-86109.61,E-Com,Cupertino,US,4488,user_001,,
59f32190-0518-455d-b0d6-9058c753f74a,2027-08-12,2027-08-12,Local Market,5499,Groceries,Specialty,-10.29,GBP,-86119.9,POS,London,GB,4488,user_001,,
89538ffe-f6e7-4b30-b35e-cf5ef981736a,2027-08-12,2027-08-12,Transport for London,4111,Transport,Transit,-8.63,GBP,-86128.53,POS,London,GB,2219,user_002,,
b1f89976-c00e-436b-a944-f31cd78a6291,2027-08-13,2027-08-16,Sainsbury's,5411,Groceries,Supermarket,-53.37,GBP,-86181.9,POS,London,GB,1045,user_001,,
d887c686-d65a-4d1d-a61b-a937b9b869ab,2027-08-13,2027-08-16,City Council Tax,9399,Utilities,Council Tax,-163.85,GBP,-86345.75,Direct Debit,London,GB,9074,user_001,rec_f531495db5,
ddc8f79a-be47-4d19-93da-e558082f1008,2027-08-13,2027-08-16,Sainsbury's,5411,Groceries,Supermarket,-59.44,GBP,-86405.19,POS,London,GB,4488,user_002,,
16177cc8-bffc-4ce8-9c3f-83bc0659bd30,2027-08-14,2027-08-16,ATM Withdrawal,6011,Cash,ATM,-116.64,GBP,-86521.83,ATM,London,GB,2219,user_001,,
4d45f518-b083-4981-9c2b-9f29a653b80a,2027-08-14,2027-08-16,Sainsbury's,5411,Groceries,Supermarket,-30.78,GBP,-86552.61,POS,London,GB,1045,user_001,,
64f3474a-d482-49e3-b2a4-e9e2dec8709e,2027-08-14,2027-08-16,Uber UK,4121,Transport,Ride Hailing,-14.71,GBP,-86567.32,E-Com,London,GB,1045,user_002,,
99f65b33-d01a-4791-8d1d-d421e3a9e1f5,2027-08-14,2027-08-16,Local Market,5499,Groceries,Specialty,-19.6,GBP,-86586.92,POS,London,GB,1045,user_002,,
aa74108f-2fb0-4272-a998-aebf936cd994,2027-08-14,2027-08-16,Amazon UK,5942,Shopping,Online Retail,-41.95,GBP,-86628.87,E-Com,London,GB,9074,user_001,,
d02c07e0-77e8-456f-a92f-72757a433479,2027-08-14,2027-08-16,Pret A Manger,5814,Food & Drink,Eating Out,-7.77,GBP,-86636.64,POS,London,GB,2219,user_001,,
5f8cc6ab-8598-416d-9ad7-c5a916de143e,2027-08-15,2027-08-16,Tesco,5411,Groceries,Supermarket,-72.2,GBP,-86708.84,POS,London,GB,9074,user_002,,
b0d6232a-54a5-4cf7-ba84-e5dace323f37,2027-08-15,2027-08-16,Waitrose,5411,Groceries,Supermarket,-34.31,GBP,-86743.15,POS,London,GB,9074,user_001,,
d46cc5ea-9d5b-49e0-964e-f5c1a41ad097,2027-08-15,2027-08-16,Deliveroo,5812,Food & Drink,Delivery,-32.19,GBP,-86775.34,E-Com,London,GB,2219,user_001,,
e408c125-be34-4c26-ab8d-452f45bb8dc7,2027-08-15,2027-08-16,Tesco,5411,Groceries,Supermarket,-79.85,GBP,-86855.19,POS,London,GB,2219,user_001,,
ef158dce-eeb4-4018-a54c-c31b4a150743,2027-08-15,2027-08-16,Amazon UK,5942,Shopping,Online Retail,-97.04,GBP,-86952.23,E-Com,London,GB,4488,user_002,,
431b4de0-3cf1-4546-8f9b-ff06c5c03cca,2027-08-16,2027-08-17,Deliveroo,5812,Food & Drink,Delivery,-22.57,GBP,-86974.8,E-Com,London,GB,2219,user_001,,
ce8e8d75-2a59-4525-b44f-cd14231e4b29,2027-08-16,2027-08-16,O2 UK,4814,Bills,Mobile,-40.86,GBP,-87015.66,Direct Debit,Slough,GB,2219,user_001,rec_95042d8101,
82d9c03e-4d56-4c03-84fa-9cd6dc930aaf,2027-08-17,2027-08-19,Waitrose,5411,Groceries,Supermarket,-24.85,GBP,-87040.51,POS,London,GB,4488,user_002,,
f17c5359-b414-4d4d-b815-ee8e3a08b377,2027-08-17,2027-08-19,GymBox,7997,Wellness,Gym,-56.17,GBP,-87096.68,Direct Debit,London,GB,1045,user_002,rec_19771e79cd,
fa264c52-2e50-41f5-aaab-9b66f28438ea,2027-08-17,2027-08-18,Uber UK,4121,Transport,Ride Hailing,-28.15,GBP,-87124.83,E-Com,London,GB,4488,user_002,,
066d9d35-fd5a-452f-b674-d7e509be288c,2027-08-18,2027-08-20,Transport for London,4111,Transport,Transit,-9.0,GBP,-87133.83,POS,London,GB,9074,user_001,,
2b5a62cd-6200-4a55-a25b-fef4a10b69b5,2027-08-18,2027-08-20,Shell,5541,Transport,Fuel,-45.58,GBP,-87179.41,POS,London,GB,9074,user_001,,
cc76bff9-c8d6-419f-bcb1-67b0a613353a,2027-08-18,2027-08-19,Pret A Manger,5814,Food & Drink,Eating Out,-8.72,GBP,-87188.13,POS,London,GB,1045,user_001,,
0f98c89f-8f2c-4f0f-8d9f-0d9918dab1f6,2027-08-19,2027-08-23,Spotify,5735,Entertainment,Subscriptions,-9.46,GBP,-87197.59,E-Com,Stockholm,SE,2219,user_001,rec_4c746d2c3b,
a38d6607-8871-40de-a388-d97e7ec5d5f4,2027-08-19,2027-08-19,Deliveroo,5812,Food & Drink,Delivery,-32.39,GBP,-87229.98,E-Com,London,GB,2219,user_001,,
5fa6932d-e100-4b6c-8078-7a37d2ad1bb7,2027-08-20,2027-08-23,Local Market,5499,Groceries,Specialty,-18.33,GBP,-87248.31,POS,London,GB,1045,user_001,,
7bf81e67-8d39-481b-976a-5b6e04d30510,2027-08-20,2027-08-20,Uber UK,4121,Transport,Ride Hailing,-16.12,GBP,-87264.43,E-Com,London,GB,1045,user_001,,
de24ed13-f1af-4db1-903e-36a5c86e3391,2027-08-20,2027-08-20,Waitrose,5411,Groceries,Supermarket,-24.04,GBP,-87288.47,POS,London,GB,2219,user_001,,
7728fd6e-f6aa-4ff5-abe7-550f305986bf,2027-08-21,2027-08-23,Uber UK,4121,Transport,Ride Hailing,-29.08,GBP,-87317.55,E-Com,London,GB,1045,user_002,,
8a03559b-d4de-4276-a9ab-fa425d6f3421,2027-08-21,2027-08-23,Airline Refund,4511,Travel,Refund,175.67,GBP,-87141.88,Credit,London,GB,9074,user_001,,Refund for Apple.com/bill
9f18f535-6c2f-4bc7-8510-64bb601bf405,2027-08-21,2027-08-23,Tesco,5411,Groceries,Supermarket,-58.74,GBP,-87200.62,POS,London,GB,9074,user_002,,
f9a38e1f-6c8b-4f93-add4-603b2e04958f,2027-08-21,2027-08-23,Deliveroo,5812,Food & Drink,Delivery,-25.99,GBP,-87226.61,E-Com,London,GB,1045,user_001,,
21550716-1479-495c-9689-bdb33fe8895e,2027-08-22,2027-08-24,Deliveroo,5812,Food & Drink,Delivery,-32.26,GBP,-87258.87,E-Com,London,GB,4488,user_001,,
41653878-1018-4a54-bfc5-b8f37de559a2,2027-08-22,2027-08-23,Deliveroo,5812,Food & Drink,Delivery,-23.26,GBP,-87282.13,E-Com,London,GB,2219,user_001,,
4c480ee5-4695-4972-be47-82f228e15676,2027-08-22,2027-08-24,Amazon UK,5942,Shopping,Online Retail,-88.22,GBP,-87370.35,E-Com,London,GB,9074,user_001,,
6b96c5d5-89b2-4e6a-ac4a-b4ee1ff38d6b,2027-08-22,2027-08-23,Local Market,5499,Groceries,Specialty,-7.82,GBP,-87378.17,POS,London,GB,4488,user_001,,
90106695-53da-4af4-a8c7-9dc19d731ba3,2027-08-22,2027-08-23,Transport for London,4111,Transport,Transit,-9.61,GBP,-87387.78,POS,London,GB,4488,user_001,,
bf2461e2-1ebc-4ab3-aa5a-354d7f3ae913,2027-08-22,2027-08-23,Transport for London,4111,Transport,Transit,-9.86,GBP,-87397.64,POS,London,GB,2219,user_002,,
e4ccafb7-9039-44da-8f6e-c191acc5028a,2027-08-22,2027-08-24,Deliveroo,5812,Food & Drink,Delivery,-23.36,GBP,-87421.0,E-Com,London,GB,4488,user_001,,
5c4249ba-d4f5-4e98-92f4-0ca3353d3774,2027-08-23,2027-08-24,Deliveroo,5812,Food & Drink,Delivery,-24.66,GBP,-87445.66,E-Com,London,GB,2219,user_002,,
6a3da0bb-c2c5-4944-a3c9-06f4d9412f2b,2027-08-23,2027-08-25,Netflix,7841,Entertainment,Subscriptions,-14.23,GBP,-87459.89,E-Com,Los Gatos,US,9074,user_001,rec_1bfe33738d,
eeb1861c-7f15-4c4d-9d49-f7d969721c68,2027-08-23,2027-08-25,Sainsbury's,5411,Groceries,Supermarket,-62.58,GBP,-87522.47,POS,London,GB,1045,user_002,,
25d03afe-1e76-4abe-a812-fb96f500a027,2027-08-24,2027-08-25,Shell,5541,Transport,Fuel,-44.4,GBP,-87566.87,POS,London,GB,9074,user_001,,
4d98312b-34ce-4f9a-a1f1-07b42196d162,2027-08-24,2027-08-26,Sainsbury's,5411,Groceries,Supermarket,-53.33,GBP,-87620.2,POS,London,GB,9074,user_001,,
a5ab2842-fe71-4c50-9dad-af5aba651a37,2027-08-24,2027-08-25,Uber UK,4121,Transport,Ride Hailing,-19.37,GBP,-87639.57,E-Com,London,GB,1045,user_002,,
ae0941d6-e216-465c-ac74-15961601522d,2027-08-24,2027-08-25,Transport for London,4111,Transport,Transit,-6.82,GBP,-87646.39,POS,London,GB,2219,user_001,,
f59e9c8a-0560-4c03-90ae-5c1a4aa8ad38,2027-08-24,2027-08-26,Pret A Manger,5814,Food & Drink,Eating Out,-6.94,GBP,-87653.33,POS,London,GB,9074,user_001,,
4d0891da-92b2-4993-a9fe-cc8b4d5310fa,2027-08-25,2027-08-25,T212 Capital,6011,Income,Salary,3379.56,GBP,-84273.77,Credit,London,GB,2219,user_001,rec_2ff8f778d0,
d70ff3ee-653c-4628-a2f4-fe10b6eb61e4,2027-08-27,2027-08-30,Pret A Manger,5814,Food & Drink,Eating Out,-6.58,GBP,-84280.35,POS,London,GB,2219,user_002,,
91db523e-1d06-4c8f-a2fa-eb7d47e40d90,2027-08-28,2027-08-30,Deliveroo,5812,Food & Drink,Delivery,-15.77,GBP,-84296.12,E-Com,London,GB,2219,user_001,,
bb3b3856-ba08-4873-89fb-ca07ab4592ea,2027-08-28,2027-08-30,Apple.com/bill,5734,Shopping,Electronics,-13.71,USD,-84309.83,E-Com,Cupertino,US,1045,user_001,,FX purchase 17.24 USD @ rate 1.26
c46eb26e-c606-40a9-b94c-9909565a7a3c,2027-08-28,2027-08-30,Deliveroo,5812,Food & Drink,Delivery,-14.53,GBP,-84324.36,E-Com,London,GB,2219,user_001,,
9d284d32-d150-4c03-a5cb-dda52d83a035,2027-08-29,2027-08-30,Apple.com/bill,5734,Shopping,Electronics,-183.02,USD,-84507.38,E-Com,Cupertino,US,1045,user_001,,FX purchase 226.6 USD @ rate 1.24
a18baa3e-6de1-4aa4-b47f-76405472644e,2027-08-29,2027-08-30,Deliveroo,5812,Food & Drink,Delivery,-31.54,GBP,-84538.92,E-Com,London,GB,2219,user_002,,
ffe0da34-b4a3-4bef-8a9a-fb16be65ea6a,2027-08-29,2027-08-30,Waitrose,5411,Groceries,Supermarket,-77.61,GBP,-84616.53,POS,London,GB,9074,user_001,,
982a3771-62d6-44ef-9c3c-7ca12499b93d,2027-08-30,2027-08-31,Shell,5541,Transport,Fuel,-83.66,GBP,-84700.19,POS,London,GB,1045,user_001,,
277ff7fb-d1f9-484d-9d40-dd2decce3754,2027-08-31,2027-09-01,Transport for London,4111,Transport,Transit,-10.76,GBP,-84710.95,POS,London,GB,1045,user_001,,
6fba1751-4848-455f-befb-a9376d367ef3,2027-09-01,2027-09-03,Sainsbury's,5411,Groceries,Supermarket,-45.01,GBP,-84755.96,POS,London,GB,4488,user_001,,
8c061f5c-b668-48d6-a4c1-954c023d5805,2027-09-01,2027-09-02,Crown Estates Lettings,6513,Housing,Rent,-1565.51,GBP,-86321.47,POS,London,GB,1045,user_001,rec_19f70fbcce,
9666d20e-e17d-44ed-beca-c94b78efb109,2027-09-01,2027-09-01,Amazon UK,5942,Shopping,Online Retail,-75.57,GBP,-86397.04,E-Com,London,GB,1045,user_001,,
9f2f9b7d-ca0e-4c44-bdd0-84f56140b1c1,2027-09-01,2027-09-03,Pret A Manger,5814,Food & Drink,Eating Out,-7.08,GBP,-86404.12,POS,London,GB,4488,user_002,,
00ad752e-ea5a-44f0-a1c4-bf745c778d68,2027-09-02,2027-09-03,Tesco,5411,Groceries,Supermarket,-80.09,GBP,-86484.21,POS,London,GB,4488,user_001,,
8e1a122c-9b54-4844-ada0-245cedb55f4d,2027-09-03,2027-09-06,Tesco,5411,Groceries,Supermarket,-84.62,GBP,-86568.83,POS,London,GB,4488,user_001,,
9e8299e7-4643-48ea-b73e-eeaa3425a59f,2027-09-03,2027-09-06,Waitrose,5411,Groceries,Supermarket,-78.26,GBP,-86647.09,POS,London,GB,1045,user_001,,
40aad22a-0b03-4df2-970e-cc2c8179da48,2027-09-04,2027-09-06,Pret A Manger,5814,Food & Drink,Eating Out,-6.8,GBP,-86653.89,POS,London,GB,2219,user_001,,
ca5a6e2b-6350-407d-9261-34e65fcba79d,2027-09-04,2027-09-06,Transport for London,4111,Transport,Transit,-5.55,GBP,-86659.44,POS,London,GB,1045,user_001,,
12e115bf-f096-4551-a7ce-74e389e6f8a1,2027-09-05,2027-09-06,Apple.com/bill,5734,Shopping,Electronics,-21.19,GBP,-86680.63,E-Com,Cupertino,US,2219,user_001,,
1494032f-4ae4-4229-ab63-773ed6f7a1d7,2027-09-05,2027-09-06,Apple.com/bill,5734,Shopping,Electronics,-99.52,USD,-86780.15,E-Com,Cupertino,US,4488,user_002,,FX purchase 124.7 USD @ rate 1.25
284c2c7a-9e92-4338-8a9d-fe5631ebd99d,2027-09-05,2027-09-06,Apple.com/bill,5734,Shopping,Electronics,-109.29,GBP,-86889.44,E-Com,Cupertino,US,2219,user_001,,
97a2d4f3-0cc5-4a17-9652-d38d33c4528c,2027-09-05,2027-09-07,Pret A Manger,5814,Food & Drink,Eating Out,-7.17,GBP,-86896.61,POS,London,GB,4488,user_002,,
f7a1e6f7-181a-4c29-b268-aa8eca525c0e,2027-09-05,2027-09-06,Pret A Manger,5814,Food & Drink,Eating Out,-7.93,GBP,-86904.54,POS,London,GB,4488,user_001,,
153f52a1-f3ae-444c-8703-cdc37bbaadb3,2027-09-06,2027-09-07,Waitrose,5411,Groceries,Supermarket,-34.59,GBP,-86939.13,POS,London,GB,9074,user_001,,
83186a2d-cec9-476d-b2ac-41399871a48c,2027-09-06,2027-09-07,Amazon UK,5942,Shopping,Online Retail,-82.27,GBP,-87021.4,E-Com,London,GB,4488,user_001,,
687819d7-3b34-419d-88a0-32cf740f4d6c,2027-09-07,2027-09-08,ATM Withdrawal,6011,Cash,ATM,-101.37,GBP,-87122.77,ATM,London,GB,4488,user_001,,
a5f5e5a7-fadc-4bf6-8a33-9dc0b22134d1,2027-09-07,2027-09-09,Shell,5541,Transport,Fuel,-49.67,GBP,-87172.44,POS,London,GB,4488,user_001,,
fb4c94fe-1ee1-4626-9040-98ed75c8e4b8,2027-09-07,2027-09-08,Octopus Energy,4900,Utilities,Electricity,-134.25,GBP,-87306.69,Direct Debit,London,GB,1045,user_001,rec_141a4a0666,
33b0acec-9119-42bb-9dbd-6ff5a1288fa0,2027-09-08,2027-09-10,Sainsbury's,5411,Groceries,Supermarket,-55.93,GBP,-87362.62,POS,London,GB,1045,user_001,,
a2d34ea6-876f-40d8-8d06-ba8f6dabe948,2027-09-08,2027-09-10,ATM Withdrawal,6011,Cash,ATM,-117.26,GBP,-87479.88,ATM,London,GB,1045,user_001,,
cf3ea0ad-0009-477c-89a2-be6be1b92f16,2027-09-08,2027-09-10,Sainsbury's,5411,Groceries,Supermarket,-16.6,GBP,-87496.48,POS,London,GB,2219,user_002,,
51208302-21f5-4383-9b5c-893bc4770e3f,2027-09-09,2027-09-13,Uber UK,4121,Transport,Ride Hailing,-18.29,GBP,-87514.77,E-Com,London,GB,1045,user_001,,
f96c16aa-f364-4684-ba2d-4175f024d2f5,2027-09-09,2027-09-09,Transport for London,4111,Transport,Transit,-5.99,GBP,-87520.76,POS,London,GB,4488,user_001,,
46cca744-97ef-4567-bd1b-8ac04b8f7128,2027-09-10,2027-09-10,Local Market,5499,Groceries,Specialty,-13.18,GBP,-87533.94,POS,London,GB,2219,user_001,,
d216fa6b-d5f6-40e3-8c74-383183c9be08,2027-09-10,2027-09-13,Shell,5541,Transport,Fuel,-35.42,GBP,-87569.36,POS,London,GB,1045,user_001,,
93c6dcf8-6298-4c08-a01c-6823dc364531,2027-09-11,2027-09-13,Waitrose,5411,Groceries,Supermarket,-74.73,GBP,-87644.09,POS,London,GB,4488,user_001,,
c2675f4e-c0a1-4120-8bb7-472eeb9bab49,2027-09-11,2027-09-13,Deliveroo,5812,Food & Drink,Delivery,-21.82,GBP,-87665.91,E-Com,London,GB,1045,user_001,,
d820a9c0-b35f-4187-a55a-d020e2de4637,2027-09-11,2027-09-13,Deliveroo,5812,Food & Drink,Delivery,-26.37,GBP,-87692.28,E-Com,London,GB,2219,user_001,,
e3dfe06a-08b6-44db-a16a-83877c379707,2027-09-12,2027-09-13,Transport for London,4111,Transport,Transit,-10.43,GBP,-87702.71,POS,London,GB,4488,user_001,,
e5b168e4-5910-49ce-8f6c-f651fa04784c,2027-09-12,2027-09-13,Sainsbury's,5411,Groceries,Supermarket,-67.19,GBP,-87769.9,POS,London,GB,2219,user_002,,
1abafcec-25de-4a95-8dc7-ad1ee6f73afd,2027-09-13,2027-09-15,Sainsbury's,5411,Groceries,Supermarket,-18.45,GBP,-87788.35,POS,London,GB,2219,user_002,,
4017d425-cd17-4f3b-a97b-69cd214fd2d8,2027-09-13,2027-09-13,City Council Tax,9399,Utilities,Council Tax,-183.12,GBP,-87971.47,Direct Debit,London,GB,4488,user_001,rec_f531495db5,
a007a8e8-1854-45b9-b408-d19654f6348e,2027-09-13,2027-09-14,Thames Water,4900,Utilities,Water,-41.65,GBP,-88013.12,Direct Debit,Reading,GB,4488,user_002,rec_954d02400c,
022840e2-d94b-4109-9e7c-0187334800b1,2027-09-14,2027-09-15,Sainsbury's,5411,Groceries,Supermarket,-61.39,GBP,-88074.51,POS,London,GB,1045,user_002,,
a4b82152-c6ad-49b4-9d9a-50ae73ae00a4,2027-09-14,2027-09-14,Shell,5541,Transport,Fuel,-78.96,GBP,-88153.47,POS,London,GB,1045,user_002,,
e91f6499-e02f-42ce-a25f-b3c99a623f50,2027-09-14,2027-09-14,Amazon UK,5942,Shopping,Online Retail,-101.05,GBP,-88254.52,E-Com,London,GB,1045,user_001,,
0f69815d-edf8-49bc-a15e-899a7e93cf99,2027-09-15,2027-09-17,O2 UK,4814,Bills,Mobile,-51.91,GBP,-88306.43,Direct Debit,Slough,GB,9074,user_001,rec_95042d8101,
45db334c-eafa-4c1b-b085-b82fbbd1ba9a,2027-09-15,2027-09-17,Shell,5541,Transport,Fuel,-72.61,GBP,-88379.04,POS,London,GB,4488,user_001,,
50f85096-ee85-42bd-8e04-b48185155360,2027-09-15,2027-09-17,Pret A Manger,5814,Food & Drink,Eating Out,-8.92,GBP,-88387.96,POS,London,GB,9074,user_001,,
644d98de-1115-46ae-978f-1b88fbb69fe5,2027-09-15,2027-09-16,Local Market,5499,Groceries,Specialty,-8.58,GBP,-88396.54,POS,London,GB,9074,user_001,,
204fe0fe-be7c-4be9-bc29-6e14b4526c05,2027-09-17,2027-09-20,Local Market,5499,Groceries,Specialty,-13.77,GBP,-88410.31,POS,London,GB,9074,user_002,,
212fba8a-2d03-4c63-8ea0-392a459f9f44,2027-09-17,2027-09-17,Pret A Manger,5814,Food & Drink,Eating Out,-8.99,GBP,-88419.3,POS,London,GB,9074,user_001,,
b32cf9ee-3657-4429-a11a-c071c0efc483,2027-09-17,2027-09-20,Sainsbury's,5411,Groceries,Supermarket,-34.74,GBP,-88454.04,POS,London,GB,4488,user_002,,
b4c13b75-43b2-4801-8266-47fd587ba712,2027-09-17,2027-09-17,GymBox,7997,Wellness,Gym,-49.2,GBP,-88503.24,Direct Debit,London,GB,2219,user_001,rec_3906953fd2,
e0b1c717-c94b-440e-bf8c-7c9438a6544a,2027-09-17,2027-09-20,Amazon UK,5942,Shopping,Online Retail,-27.8,GBP,-88531.04,E-Com,London,GB,1045,user_002,,
ed706e47-ba7b-4541-9ec6-e3051e3c83d9,2027-09-17,2027-09-20,Apple.com/bill,5734,Shopping,Electronics,-4.83,USD,-88535.87,E-Com,Cupertino,US,1045,user_001,,FX purchase 6.0 USD @ rate 1.24
86734c66-401a-4a14-9a7b-251072434eca,2027-09-18,2027-09-20,Deliveroo,5812,Food & Drink,Delivery,-17.77,GBP,-88553.64,E-Com,London,GB,4488,user_001,,
91c0b5f0-cbc0-4c6d-b382-c17078bf926a,2027-09-18,2027-09-20,Shell,5541,Transport,Fuel,-48.88,GBP,-88602.52,POS,London,GB,2219,user_002,,
fd93b931-5d23-415b-a486-ed2381dd4c82,2027-09-18,2027-09-20,Apple.com/bill,5734,Shopping,Electronics,-14.93,GBP,-88617.45,E-Com,Cupertino,US,9074,user_001,,
43cdfcce-2f69-496c-a1ac-632f60d4b986,2027-09-19,2027-09-20,Waitrose,5411,Groceries,Supermarket,-52.0,GBP,-88669.45,POS,London,GB,4488,user_001,,
642c5f66-d9d2-42eb-a894-e402cf1e72c1,2027-09-19,2027-09-20,Shell,5541,Transport,Fuel,-86.57,GBP,-88756.02,POS,London,GB,4488,user_001,,
879b0aaf-7da8-416e-b3dd-ecb17ffe5f96,2027-09-19,2027-09-20,Sainsbury's,5411,Groceries,Supermarket,-46.51,GBP,-88802.53,POS,London,GB,1045,user_001,,
9d55034c-0e6c-4c59-83e5-de66dab80e58,2027-09-19,2027-09-20,Uber UK,4121,Transport,Ride Hailing,-31.63,GBP,-88834.16,E-Com,London,GB,1045,user_001,,
0ee11bc6-7fc1-4797-8daa-b7486051240a,2027-09-20,2027-09-21,Amazon UK,5942,Shopping,Online Retail,-81.05,GBP,-88915.21,E-Com,London,GB,1045,user_001,,
596c7b49-17c2-4b49-8043-fc778e9b5419,2027-09-20,2027-09-20,Pret A Manger,5814,Food & Drink,Eating Out,-6.99,GBP,-88922.2,POS,London,GB,9074,user_001,,
d2adf40f-aaa2-4e3b-9bc8-44ae8de6a468,2027-09-20,2027-09-22,Spotify,5735,Entertainment,Subscriptions,-9.84,EUR,-88932.04,E-Com,Stockholm,SE,1045,user_001,rec_4c746d2c3b,FX purchase 11.49 EUR @ rate 1.17
498770ac-40b9-4edd-8b8a-ac77b6be4b66,2027-09-21,2027-09-23,Netflix,7841,Entertainment,Subscriptions,-15.39,GBP,-88947.43,E-Com,Los Gatos,US,4488,user_002,rec_d9322c1382,
fda9e196-35cd-4bdd-82d2-04832e884e21,2027-09-22,2027-09-24,Pret A Manger,5814,Food & Drink,Eating Out,-10.79,GBP,-88958.22,POS,London,GB,2219,user_002,,
7270fe93-ec96-4d20-824f-ff18de446a46,2027-09-23,2027-09-23,Tesco,5411,Groceries,Supermarket,-61.1,GBP,-89019.32,POS,London,GB,4488,user_001,,
9b7dcc75-e1b8-447c-ba69-c47c72158a54,2027-09-23,2027-09-27,Shell,5541,Transport,Fuel,-62.29,GBP,-89081.61,POS,London,GB,4488,user_001,,
db3cea70-6da8-488f-bf76-dbb5fd836aa2,2027-09-23,2027-09-27,Local Market,5499,Groceries,Specialty,-15.5,GBP,-89097.11,POS,London,GB,2219,user_001,,
e52b52e6-9b93-4c72-8808-180e1ed2bb88,2027-09-23,2027-09-24,Deliveroo,5812,Food & Drink,Delivery,-19.18,GBP,-89116.29,E-Com,London,GB,9074,user_001,,
65de2158-485a-42da-8b55-d37ad7b2a298,2027-09-24,2027-09-24,T212 Capital,6011,Income,Salary,3244.16,GBP,-85872.13,Credit,London,GB,2219,user_002,rec_c649d24d0f,
5b945cc1-e84d-4e22-9835-f446e2af8d6a,2027-09-25,2027-09-27,Sainsbury's,5411,Groceries,Supermarket,-46.98,GBP,-85919.11,POS,London,GB,4488,user_001,,
72cffc43-25d0-46ef-bf40-3d4aa03a5b5d,2027-09-25,2027-09-27,Apple.com/bill,5734,Shopping,Electronics,-28.35,GBP,-85947.46,E-Com,Cupertino,US,9074,user_001,,
88e2e38a-0370-4a63-bbbf-3fd6eaaf0e54,2027-09-25,2027-09-27,Shell,5541,Transport,Fuel,-47.56,GBP,-85995.02,POS,London,GB,4488,user_001,,
915464e3-e31b-4ce0-a530-e20099e6cd4f,2027-09-25,2027-09-27,Transport for London,4111,Transport,Transit,-5.96,GBP,-86000.98,POS,London,GB,4488,user_001,,
b7f744f4-cda5-4df7-b233-0b7a276e7fad,2027-09-25,2027-09-27,Sainsbury's,5411,Groceries,Supermarket,-28.85,GBP,-86029.83,POS,London,GB,9074,user_001,,
b8a676af-3598-43ea-bb57-410b82050222,2027-09-26,2027-09-27,Apple.com/bill,5734,Shopping,Electronics,-188.55,GBP,-86218.38,E-Com,Cupertino,US,1045,user_001,,
ff86ab08-220f-4f18-b642-68d6b3187e89,2027-09-26,2027-09-27,Sainsbury's,5411,Groceries,Supermarket,-60.67,GBP,-86279.05,POS,London,GB,2219,user_001,,
0857055e-6d67-4687-9299-bed12d47b310,2027-09-27,2027-09-27,Uber UK,4121,Transport,Ride Hailing,-31.04,GBP,-86310.09,E-Com,London,GB,1045,user_001,,
1dc2851c-adf6-4f66-aed2-7e835dc7d9f7,2027-09-27,2027-09-28,Sainsbury's,5411,Groceries,Supermarket,-26.17,GBP,-86336.26,POS,London,GB,4488,user_001,,
ba055952-aaf6-4c03-811b-feea56e2601a,2027-09-27,2027-09-28,Deliveroo,5812,Food & Drink,Delivery,-14.02,GBP,-86350.28,E-Com,London,GB,1045,user_001,,
20176342-2bd7-4010-bcd3-f59383f4ee4c,2027-09-28,2027-09-30,Transport for London,4111,Transport,Transit,-10.42,GBP,-86360.7,POS,London,GB,9074,user_001,,
54b81af6-8694-4d89-9d47-818628abc56a,2027-09-28,2027-09-30,Local Market,5499,Groceries,Specialty,-21.85,GBP,-86382.55,POS,London,GB,4488,user_001,,
ad0a0ba6-5c53-48c6-b2c6-83cc9ed295f3,2027-09-29,2027-09-30,Deliveroo,5812,Food & Drink,Delivery,-20.83,GBP,-86403.38,E-Com,London,GB,2219,user_001,,
0f2f383e-ad25-4246-9c45-16c59b1ba077,2027-10-01,2027-10-01,Amazon UK,5942,Shopping,Online Retail,-74.02,GBP,-86477.4,E-Com,London,GB,2219,user_002,,
2cd3ac36-52df-4788-9462-e558261708f9,2027-10-01,2027-10-04,Crown Estates Lettings,6513,Housing,Rent,-1480.69,GBP,-87958.09,POS,London,GB,2219,user_001,rec_19f70fbcce,
5f13eb51-4338-49c3-8531-db9475db74bb,2027-10-01,2027-10-04,Shell,5541,Transport,Fuel,-93.55,GBP,-88051.64,POS,London,GB,4488,user_001,,
899ed97c-2efe-43b0-bf85-a990e25764e1,2027-10-01,2027-10-04,Shell,5541,Transport,Fuel,-53.99,GBP,-88105.63,POS,London,GB,4488,user_001,,
c2efef9d-dbc8-44ae-8c27-a89bb3e1a640,2027-10-01,2027-10-04,Waitrose,5411,Groceries,Supermarket,-61.27,GBP,-88166.9,POS,London,GB,2219,user_001,,
e1075883-cf38-4c5a-b0aa-be9245e96808,2027-10-01,2027-10-04,ATM Withdrawal,6011,Cash,ATM,-96.46,GBP,-88263.36,ATM,London,GB,1045,user_001,,
060f6bf1-069f-4719-88ba-4d2abbe9c46b,2027-10-02,2027-10-04,Amazon UK,5942,Shopping,Online Retail,-52.44,GBP,-88315.8,E-Com,London,GB,4488,user_001,,
542176d9-46e3-4d06-b5c0-c1c7f6271f47,2027-10-02,2027-10-04,Transport for London,4111,Transport,Transit,-4.68,GBP,-88320.48,POS,London,GB,2219,user_001,,
8a2df399-ca0c-4ac2-ac4b-4042d837da8a,2027-10-02,2027-10-04,Deliveroo,5812,Food & Drink,Delivery,-33.8,GBP,-88354.28,E-Com,London,GB,1045,user_002,,
8c56d3df-5700-49b6-a8e2-810423cf367c,2027-10-02,2027-10-04,Shell,5541,Transport,Fuel,-61.42,GBP,-88415.7,POS,London,GB,4488,user_001,,
c4cee93e-2a72-4c2b-be8f-48888908b399,2027-10-02,2027-10-04,Tesco,5411,Groceries,Supermarket,-70.67,GBP,-88486.37,POS,London,GB,2219,user_001,,
e1a22515-228d-44c2-ab3b-6a130ba06058,2027-10-02,2027-10-04,Uber UK,4121,Transport,Ride Hailing,-32.71,GBP,-88519.08,E-Com,London,GB,1045,user_002,,
29511354-a0aa-43a8-b4be-d932f522cefc,2027-10-03,2027-10-05,Apple.com/bill,5734,Shopping,Electronics,-28.36,GBP,-88547.44,E-Com,Cupertino,US,4488,user_001,,
42dc5aa7-1ebc-485e-90c0-bda3b7284c97,2027-10-03,2027-10-04,Apple.com/bill,5734,Shopping,Electronics,-148.48,GBP,-88695.92,E-Com,Cupertino,US,4488,user_001,,
772f3938-42ce-4ccd-8b07-cfd6fd3b086a,2027-10-03,2027-10-04,Airline Refund,4511,Travel,Refund,6.3,GBP,-88689.62,Credit,London,GB,9074,user_001,,Refund for Pret A Manger
996b1dc0-cfc4-406a-a207-57b6b5ea00b8,2027-10-03,2027-10-05,Apple.com/bill,5734,Shopping,Electronics,-181.75,USD,-88871.37,E-Com,Cupertino,US,2219,user_001,,FX purchase 222.29 USD @ rate 1.22
a342384b-6c93-436e-a5e7-d91f6c6c178f,2027-10-05,2027-10-07,Sainsbury's,5411,Groceries,Supermarket,-18.87,GBP,-88890.24,POS,London,GB,4488,user_001,,
e474dda0-0eae-4285-b5ef-935dbc936cda,2027-10-05,2027-10-05,Uber UK,4121,Transport,Ride Hailing,-26.85,GBP,-88917.09,E-Com,London,GB,2219,user_001,,
193b1c98-2e24-4214-8d1c-33c7d6e3672f,2027-10-06,2027-10-08,Shell,5541,Transport,Fuel,-59.17,GBP,-88976.26,POS,London,GB,4488,user_002,,
6fad8561-15f5-4b78-86bf-9a693a383a0a,2027-10-06,2027-10-06,Waitrose,5411,Groceries,Supermarket,-67.94,GBP,-89044.2,POS,London,GB,1045,user_001,,
84c3d13a-60cf-423e-841b-385c839e2d2b,2027-10-06,2027-10-07,Pret A Manger,5814,Food & Drink,Eating Out,-9.86,GBP,-89054.06,POS,London,GB,4488,user_002,,
cf1c0106-1ec9-46d5-872e-4439e6ba2d9f,2027-10-06,2027-10-07,Waitrose,5411,Groceries,Supermarket,-72.26,GBP,-89126.32,POS,London,GB,9074,user_001,,
54043b88-4689-41f1-9ee7-e10e16e7d891,2027-10-07,2027-10-07,Local Market,5499,Groceries,Specialty,-19.41,GBP,-89145.73,POS,London,GB,1045,user_001,,
5ba8b32d-2392-4da5-ad43-9227f8a77877,2027-10-07,2027-10-08,Deliveroo,5812,Food & Drink,Delivery,-17.98,GBP,-89163.71,E-Com,London,GB,4488,user_001,,
6e68270a-2674-4478-b312-798b59306a5d,2027-10-07,2027-10-07,Uber UK,4121,Transport,Ride Hailing,-30.0,GBP,-89193.71,E-Com,London,GB,4488,user_001,,
83f2abb2-5865-4fb9-b28f-8a14c0fe2614,2027-10-07,2027-10-07,Local Market,5499,Groceries,Specialty,-21.81,GBP,-89215.52,POS,London,GB,9074,user_001,,
89ecb0cb-1098-4197-aa82-898320e21db4,2027-10-07,2027-10-11,Octopus Energy,4900,Utilities,Electricity,-127.91,GBP,-89343.43,Direct Debit,London,GB,9074,user_001,rec_141a4a0666,
c48f3135-ec03-4416-93e6-45b35e724a15,2027-10-07,2027-10-08,Pret A Manger,5814,Food & Drink,Eating Out,-7.22,GBP,-89350.65,POS,London,GB,2219,user_001,,
16ffb9b8-3f5f-4b45-9fcb-5e7cc6a67340,2027-10-09,2027-10-11,Waitrose,5411,Groceries,Supermarket,-28.73,GBP,-89379.38,POS,London,GB,1045,user_001,,
2de77a5c-4d36-4c1a-a455-e865a1e873d1,2027-10-09,2027-10-11,Pret A Manger,5814,Food & Drink,Eating Out,-8.2,GBP,-89387.58,POS,London,GB,2219,user_001,,
92bf1b39-1e11-4a56-90ab-f1561a04d16e,2027-10-09,2027-10-11,Deliveroo,5812,Food & Drink,Delivery,-29.02,GBP,-89416.6,E-Com,London,GB,4488,user_001,,
9cc665ef-c672-4292-b32a-a4f7a4e3d7af,2027-10-09,2027-10-11,Tesco,5411,Groceries,Supermarket,-56.02,GBP,-89472.62,POS,London,GB,1045,user_001,,
061d9bdb-3f94-4679-a427-68ea3d0a19dd,2027-10-10,2027-10-11,HM Revenue & Customs,9311,Income,Tax Refund,15.56,GBP,-89457.06,Credit,London,GB,4488,user_002,,Refund for Deliveroo
37d638fd-6276-4d58-bdb2-9ce6fe726119,2027-10-10,2027-10-12,Uber UK,4121,Transport,Ride Hailing,-13.12,GBP,-89470.18,E-Com,London,GB,4488,user_001,,
de01c0be-8a75-429c-a6b4-f15700ea6f6c,2027-10-10,2027-10-12,Deliveroo,5812,Food & Drink,Delivery,-23.23,GBP,-89493.41,E-Com,London,GB,4488,user_002,,
de3b6356-e3e2-4054-96c0-0955e56809dd,2027-10-10,2027-10-11,Uber UK,4121,Transport,Ride Hailing,-22.93,GBP,-89516.34,E-Com,London,GB,9074,user_001,,
e91049f1-083a-4252-8763-efba1e44fd06,2027-10-10,2027-10-11,Sainsbury's,5411,Groceries,Supermarket,-45.55,GBP,-89561.89,POS,London,GB,9074,user_001,,
f6b7dffb-0d76-40d2-b33b-d2d80f8c1d10,2027-10-10,2027-10-11,Apple.com/bill,5734,Shopping,Electronics,-69.26,GBP,-89631.15,E-Com,Cupertino,US,1045,user_001,,
258996a7-8ce7-4bb9-9714-0d145ecc822c,2027-10-11,2027-10-12,Amazon UK,5942,Shopping,Online Retail,-30.52,GBP,-89661.67,E-Com,London,GB,1045,user_001,,
a8bae021-846c-4673-b9d8-af471b4726c4,2027-10-11,2027-10-13,Waitrose,5411,Groceries,Supermarket,-89.24,GBP,-89750.91,POS,London,GB,4488,user_002,,
abcee758-3c60-40d3-83c8-4819d34b29cc,2027-10-11,2027-10-12,Thames Water,4900,Utilities,Water,-42.86,GBP,-89793.77,Direct Debit,Reading,GB,9074,user_001,rec_3a34d62842,
9d78c780-6097-45e6-9e21-b5042f06d9b6,2027-10-12,2027-10-13,Transport for London,4111,Transport,Transit,-10.11,GBP,-89803.88,POS,London,GB,1045,user_002,,
c3645781-162a-46db-8e5c-7895751c4ce9,2027-10-12,2027-10-13,Pret A Manger,5814,Food & Drink,Eating Out,-11.87,GBP,-89815.75,POS,London,GB,4488,user_001,,
557fe1a1-e563-4f88-a282-e09433437e97,2027-10-13,2027-10-13,Amazon UK,5942,Shopping,Online Retail,-58.9,GBP,-89874.65,E-Com,London,GB,4488,user_001,,
66c7af5f-017f-4d90-b8a6-ae4d29e3ab9c,2027-10-13,2027-10-15,Uber UK,4121,Transport,Ride Hailing,-29.62,GBP,-89904.27,E-Com,London,GB,1045,user_001,,
c4face3a-808e-419d-b698-bc29bf066e8f,2027-10-13,2027-10-15,Deliveroo,5812,Food & Drink,Delivery,-26.46,GBP,-89930.73,E-Com,London,GB,2219,user_001,,
d5611396-d8e9-4ab5-a4e7-711f9163a729,2027-10-13,2027-10-15,City Council Tax,9399,Utilities,Council Tax,-151.66,GBP,-90082.39,Direct Debit,London,GB,9074,user_001,rec_f531495db5,
08e8994f-7702-4f60-9f5f-e6f93c5fe948,2027-10-14,2027-10-18,Deliveroo,5812,Food & Drink,Delivery,-12.58,GBP,-90094.97,E-Com,London,GB,1045,user_001,,
38a84bf6-1425-47b5-a674-83c7c94abbf0,2027-10-14,2027-10-14,Apple.com/bill,5734,Shopping,Electronics,-111.58,USD,-90206.55,E-Com,Cupertino,US,9074,user_001,,FX purchase 141.46 USD @ rate 1.27
5bb2a038-0f31-4ae1-be02-55728f4eafea,2027-10-14,2027-10-14,Amazon UK,5942,Shopping,Online Retail,-16.56,GBP,-90223.11,E-Com,London,GB,2219,user_001,,
7a4b3872-6c32-48c5-a2b1-499ed8ddf447,2027-10-14,2027-10-15,Apple.com/bill,5734,Shopping,Electronics,-178.3,USD,-90401.41,E-Com,Cupertino,US,1045,user_001,,FX purchase 225.48 USD @ rate 1.26
05ceb55c-e3bf-4d6c-9a62-d97349498238,2027-10-15,2027-10-18,Sainsbury's,5411,Groceries,Supermarket,-32.69,GBP,-90434.1,POS,London,GB,2219,user_001,,
2205951f-cd22-4e25-8651-94694a33de18,2027-10-15,2027-10-18,O2 UK,4814,Bills,Mobile,-40.38,GBP,-90474.48,Direct Debit,Slough,GB,2219,user_001,rec_95042d8101,
41e970ba-935f-47ec-84ea-e67ebb11c7e1,2027-10-15,2027-10-18,British Airways,4511,Travel,Flights,-592.05,USD,-91066.53,E-Com,London,GB,9074,user_001,,Business travel
784430da-ea32-4a6a-8428-7e6e83286f99,2027-10-16,2027-10-18,Sainsbury's,5411,Groceries,Supermarket,-18.81,GBP,-91085.34,POS,London,GB,2219,user_002,,
faf2fe16-95cb-4f61-bc32-7d5ca0b923d2,2027-10-16,2027-10-18,Sainsbury's,5411,Groceries,Supermarket,-45.47,GBP,-91130.81,POS,London,GB,9074,user_001,,
6527f221-0297-4e45-9811-1b6887a3ee7d,2027-10-17,2027-10-19,Local Market,5499,Groceries,Specialty,-10.41,GBP,-91141.22,POS,London,GB,1045,user_002,,
ad52f25f-5b12-48b0-8f8d-0596b654deec,2027-10-17,2027-10-18,Sainsbury's,5411,Groceries,Supermarket,-54.78,GBP,-91196.0,POS,London,GB,9074,user_001,,
b5168e3a-3d78-47e1-9e2a-70ea82b2da26,2027-10-17,2027-10-18,Pret A Manger,5814,Food & Drink,Eating Out,-7.69,GBP,-91203.69,POS,London,GB,9074,user_001,,
d4e02a96-5c10-429c-9ffd-d2477c887466,2027-10-17,2027-10-19,Uber UK,4121,Transport,Ride Hailing,-30.14,GBP,-91233.83,E-Com,London,GB,9074,user_001,,
7277a42c-0748-420e-9576-a54fe8fa1543,2027-10-18,2027-10-20,GymBox,7997,Wellness,Gym,-57.18,GBP,-91291.01,Direct Debit,London,GB,1045,user_001,rec_3906953fd2,
db3f35a9-0be8-4e26-9943-e47bd098c76a,2027-10-18,2027-10-19,Transport for London,4111,Transport,Transit,-7.93,GBP,-91298.94,POS,London,GB,1045,user_001,,
1ec92767-7bae-4a9e-af0a-ad9a6c58aa19,2027-10-19,2027-10-21,Deliveroo,5812,Food & Drink,Delivery,-19.35,GBP,-91318.29,E-Com,London,GB,9074,user_001,,
7222a08a-d31b-443f-b4d9-4719b419102d,2027-10-19,2027-10-19,Deliveroo,5812,Food & Drink,Delivery,-13.08,GBP,-91331.37,E-Com,London,GB,1045,user_001,,
94dfc9eb-f63b-4c88-b31d-81ab238ef664,2027-10-19,2027-10-21,Transport for London,4111,Transport,Transit,-8.57,GBP,-91339.94,POS,London,GB,4488,user_002,,
94e2b118-c6a5-4c20-ba97-675e7aa2b402,2027-10-19,2027-10-21,Apple.com/bill,5734,Shopping,Electronics,-81.47,GBP,-91421.41,E-Com,Cupertino,US,4488,user_002,,
ad07febd-4259-4b66-b695-aef94412aa87,2027-10-19,2027-10-21,Spotify,5735,Entertainment,Subscriptions,-8.16,GBP,-91429.57,E-Com,Stockholm,SE,1045,user_001,rec_4c746d2c3b,
e0e02bc7-afa3-480a-a142-1a17ebfce565,2027-10-19,2027-10-19,Amazon UK,5942,Shopping,Online Retail,-115.19,GBP,-91544.76,E-Com,London,GB,4488,user_001,,
f045d1d2-3e55-4711-9113-e059b22f26a8,2027-10-20,2027-10-22,Uber UK,4121,Transport,Ride Hailing,-10.84,GBP,-91555.6,E-Com,London,GB,4488,user_001,,
1b2b4ee2-f698-412b-a494-578f31d95b80,2027-10-21,2027-10-22,Local Market,5499,Groceries,Specialty,-15.73,GBP,-91571.33,POS,London,GB,1045,user_002,,
402dca57-6750-49bf-9ef5-7388e04bbf5c,2027-10-21,2027-10-22,Local Market,5499,Groceries,Specialty,-18.14,GBP,-91589.47,POS,London,GB,1045,user_001,,
47214110-d9a1-4ac2-b578-d90f44f99c25,2027-10-21,2027-10-22,Netflix,7841,Entertainment,Subscriptions,-14.47,GBP,-91603.94,E-Com,Los Gatos,US,1045,user_001,rec_1bfe33738d,
de3839c4-b9f4-4a0d-9d4f-81068d2be763,2027-10-21,2027-10-21,HM Revenue & Customs,9311,Income,Tax Refund,28.96,GBP,-91574.98,Credit,London,GB,9074,user_001,,Refund for Tesco
3cb5ff16-5d93-4799-b505-8de3c81936d1,2027-10-22,2027-10-25,Transport for London,4111,Transport,Transit,-3.78,GBP,-91578.76,POS,London,GB,1045,user_001,,
822761e9-1851-45fb-9ce5-a4a034afe848,2027-10-22,2027-10-22,Sainsbury's,5411,Groceries,Supermarket,-15.82,GBP,-91594.58,POS,London,GB,1045,user_002,,
fbee6a68-f76f-40cb-8701-5fb5fe0722bd,2027-10-23,2027-10-25,Sainsbury's,5411,Groceries,Supermarket,-24.73,GBP,-91619.31,POS,London,GB,9074,user_002,,
31d7694d-96b5-4155-bfc4-50dd806fab42,2027-10-24,2027-10-25,Deliveroo,5812,Food & Drink,Delivery,-27.99,GBP,-91647.3,E-Com,London,GB,1045,user_002,,
48540dd0-2804-416e-8c53-4dcdcdc1b840,2027-10-24,2027-10-25,Uber UK,4121,Transport,Ride Hailing,-19.87,GBP,-91667.17,E-Com,London,GB,1045,user_001,,
f11f1c33-fdbd-4277-b7e5-36d5c2a28883,2027-10-24,2027-10-25,Tesco,5411,Groceries,Supermarket,-45.36,GBP,-91712.53,POS,London,GB,9074,user_001,,
380b9595-4115-46e6-a374-1ae313632ad3,2027-10-25,2027-10-25,ATM Withdrawal,6011,Cash,ATM,-97.34,GBP,-91809.87,ATM,London,GB,1045,user_001,,
7e8ad162-6c69-42c0-bc3d-9d5ff20f4d0f,2027-10-25,2027-10-26,Pret A Manger,5814,Food & Drink,Eating Out,-6.07,GBP,-91815.94,POS,London,GB,9074,user_001,,
8dbf4569-1550-4975-96f5-1b28f10edb0b,2027-10-25,2027-10-26,Uber UK,4121,Transport,Ride Hailing,-19.24,GBP,-91835.18,E-Com,London,GB,9074,user_001,,
95321390-76ea-4593-8b60-acfb8243be24,2027-10-25,2027-10-27,Sainsbury's,5411,Groceries,Supermarket,-14.46,GBP,-91849.64,POS,London,GB,2219,user_001,,
9e04c7ea-eefe-412b-94a7-0fbaa147b66a,2027-10-25,2027-10-25,T212 Capital,6011,Income,Salary,3188.31,GBP,-88661.33,Credit,London,GB,2219,user_001,rec_2ff8f778d0,
b699ce5c-bfc7-419b-9553-5baf6b872f07,2027-10-25,2027-10-25,Local Market,5499,Groceries,Specialty,-18.48,GBP,-88679.81,POS,London,GB,9074,user_001,,
074491ca-10c7-4912-81b7-d9e1cab7572d,2027-10-27,2027-10-27,Uber UK,4121,Transport,Ride Hailing,-30.29,GBP,-88710.1,E-Com,London,GB,9074,user_001,,
3ee1a133-3f10-41a9-be23-07ebf5f67eaa,2027-10-27,2027-10-27,Waitrose,5411,Groceries,Supermarket,-55.62,GBP,-88765.72,POS,London,GB,9074,user_001,,
27ad7d7c-be33-4c29-a5d1-ad6bd8849d61,2027-10-28,2027-10-28,Uber UK,4121,Transport,Ride Hailing,-15.74,GBP,-88781.46,E-Com,London,GB,9074,user_001,,
51963156-2c90-44c2-a08e-6c9d588e138e,2027-10-28,2027-10-28,Apple.com/bill,5734,Shopping,Electronics,-189.89,USD,-88971.35,E-Com,Cupertino,US,2219,user_001,,FX purchase 235.67 USD @ rate 1.24
83a3f03a-b4ba-4c50-9547-7b18c2a93d69,2027-10-28,2027-10-28,HM Revenue & Customs,9311,Income,Tax Refund,15.66,GBP,-88955.69,Credit,London,GB,4488,user_001,,Refund for Uber UK
9fa8604f-8a41-431c-b895-1c160bf18e87,2027-10-28,2027-10-29,Tesco,5411,Groceries,Supermarket,-60.6,GBP,-89016.29,POS,London,GB,1045,user_001,,
0f2cc4be-56b4-4f92-98b1-c2ef0701ff2c,2027-10-29,2027-11-01,Waitrose,5411,Groceries,Supermarket,-80.71,GBP,-89097.0,POS,London,GB,2219,user_001,,
b01e27bb-09da-46c3-8156-5dc5bcc6306c,2027-10-29,2027-10-29,Sainsbury's,5411,Groceries,Supermarket,-40.42,GBP,-89137.42,POS,London,GB,9074,user_001,,
3379340a-3089-42ee-b606-ffbfc2529055,2027-10-30,2027-11-01,Amazon UK,5942,Shopping,Online Retail,-28.58,GBP,-89166.0,E-Com,London,GB,2219,user_001,,
49b010d4-5409-4e62-b158-8af3e6194764,2027-10-30,2027-11-01,Tesco,5411,Groceries,Supermarket,-78.77,GBP,-89244.77,POS,London,GB,2219,user_001,,
64c782b3-9741-4bee-b303-7903f5a348fa,2027-10-30,2027-11-01,Local Market,5499,Groceries,Specialty,-17.04,GBP,-89261.81,POS,London,GB,9074,user_001,,
7fdb61ca-eb61-4243-9605-7aecba6cc8eb,2027-10-30,2027-11-01,Waitrose,5411,Groceries,Supermarket,-32.72,GBP,-89294.53,POS,London,GB,2219,user_001,,
81233f3e-26d8-4ac7-af01-7c2064cee147,2027-10-30,2027-11-01,Sainsbury's,5411,Groceries,Supermarket,-56.14,GBP,-89350.67,POS,London,GB,2219,user_002,,
88d3b76f-e71d-4fb0-9725-1733d666a761,2027-10-30,2027-11-01,Tesco,5411,Groceries,Supermarket,-73.35,GBP,-89424.02,POS,London,GB,9074,user_001,,
dcd117cb-c8ae-48cf-aa22-97ed8bed73f8,2027-10-30,2027-11-01,Sainsbury's,5411,Groceries,Supermarket,-69.42,GBP,-89493.44,POS,London,GB,4488,user_001,,
07973963-23cd-4afe-946d-5747819748ea,2027-10-31,2027-11-01,Deliveroo,5812,Food & Drink,Delivery,-18.66,GBP,-89512.1,E-Com,London,GB,4488,user_001,,
5bf7db71-94f7-4afd-9f35-2f2658c87290,2027-10-31,2027-11-02,Deliveroo,5812,Food & Drink,Delivery,-16.53,GBP,-89528.63,E-Com,London,GB,4488,user_001,,
63cfb96e-bb21-4a8e-95a2-fe1ac00ca6ab,2027-10-31,2027-11-01,Sainsbury's,5411,Groceries,Supermarket,-40.48,GBP,-89569.11,POS,London,GB,4488,user_001,,
8ec2dd76-ae9a-4a1a-b7f9-1f999fd6e739,2027-10-31,2027-11-01,Tesco,5411,Groceries,Supermarket,-31.47,GBP,-89600.58,POS,London,GB,2219,user_002,,
da0b22ca-1b98-476a-9710-1c71c53bb58c,2027-10-31,2027-11-01,Shell,5541,Transport,Fuel,-36.27,GBP,-89636.85,POS,London,GB,9074,user_002,,
e9ea08fd-01fd-41ad-a827-c4dd3e7b4103,2027-10-31,2027-11-02,Deliveroo,5812,Food & Drink,Delivery,-23.99,GBP,-89660.84,E-Com,London,GB,1045,user_001,,
0e26dec0-1117-43c9-9e9f-cd9c4f8bcabe,2027-11-01,2027-11-01,Tesco,5411,Groceries,Supermarket,-57.72,GBP,-89718.56,POS,London,GB,9074,user_002,,
2f1d5f47-78d4-4013-9975-1604282aefe8,2027-11-01,2027-11-01,ATM Withdrawal,6011,Cash,ATM,-104.52,GBP,-89823.08,ATM,London,GB,4488,user_002,,
514d7f3b-3ece-4125-88a9-9a5d02b43ff6,2027-11-01,2027-11-01,Crown Estates Lettings,6513,Housing,Rent,-1598.2,GBP,-91421.28,POS,London,GB,1045,user_001,rec_19f70fbcce,
5f37f404-4a4f-4e7d-a320-bfc62fb2efa5,2027-11-01,2027-11-02,Waitrose,5411,Groceries,Supermarket,-49.04,GBP,-91470.32,POS,London,GB,4488,user_002,,
1bd3daaa-1c39-4007-8dc5-e73f5f71b8bf,2027-11-02,2027-11-02,Pret A Manger,5814,Food & Drink,Eating Out,-9.04,GBP,-91479.36,POS,London,GB,4488,user_001,,
7dd182c8-a48e-4e21-9195-af9d53d22a47,2027-11-02,2027-11-04,Uber UK,4121,Transport,Ride Hailing,-23.39,GBP,-91502.75,E-Com,London,GB,9074,user_001,,
b09dfc0f-9daa-4e47-85fd-d95e12cebbba,2027-11-02,2027-11-03,Deliveroo,5812,Food & Drink,Delivery,-20.82,GBP,-91523.57,E-Com,London,GB,2219,user_001,,
c254c74b-16a3-42e4-96fe-42af7bda5340,2027-11-02,2027-11-03,Sainsbury's,5411,Groceries,Supermarket,-63.76,GBP,-91587.33,POS,London,GB,9074,user_001,,
ca4fb13a-4ed1-4056-b610-448790a7054e,2027-11-02,2027-11-03,ATM Withdrawal,6011,Cash,ATM,-67.75,GBP,-91655.08,ATM,London,GB,4488,user_001,,
ef01d9f4-feeb-4880-88c9-a5a6321b76c2,2027-11-02,2027-11-02,Apple.com/bill,5734,Shopping,Electronics,-84.42,GBP,-91739.5,E-Com,Cupertino,US,1045,user_001,,
5d47c2fb-096d-4fa8-86f2-2f8f20cda939,2027-11-03,2027-11-05,Sainsbury's,5411,Groceries,Supermarket,-30.9,GBP,-91770.4,POS,London,GB,1045,user_002,,
7c5d3ec5-677a-46be-a6e3-ac84ec047e2d,2027-11-03,2027-11-05,Tesco,5411,Groceries,Supermarket,-38.14,GBP,-91808.54,POS,London,GB,9074,user_002,,
7e796de7-9e1f-4d43-8ef3-2e7ac108f9d1,2027-11-04,2027-11-05,Transport for London,4111,Transport,Transit,-11.9,GBP,-91820.44,POS,London,GB,4488,user_001,,
91f6e433-6657-49f1-b4a0-38411998f386,2027-11-04,2027-11-05,Shell,5541,Transport,Fuel,-91.54,GBP,-91911.98,POS,London,GB,9074,user_001,,
a274b58d-d56c-4bd2-938c-98958cec42a0,2027-11-04,2027-11-05,Apple.com/bill,5734,Shopping,Electronics,-195.63,GBP,-92107.61,E-Com,Cupertino,US,1045,user_001,,
25e78dad-5ba1-412e-a7bd-001f2587c3aa,2027-11-05,2027-11-05,Local Market,5499,Groceries,Specialty,-12.1,GBP,-92119.71,POS,London,GB,9074,user_001,,
28ddb44b-c0b9-4bf3-b1b5-576d14a019ef,2027-11-05,2027-11-05,Sainsbury's,5411,Groceries,Supermarket,-34.29,GBP,-92154.0,POS,London,GB,4488,user_001,,
5596d707-989f-4ab1-9f8a-3af8775142bc,2027-11-05,2027-11-08,Local Market,5499,Groceries,Specialty,-10.53,GBP,-92164.53,POS,London,GB,4488,user_001,,
8b1e17b5-4803-47c1-8f23-f841a63757c7,2027-11-05,2027-11-08,Uber UK,4121,Transport,Ride Hailing,-33.89,GBP,-92198.42,E-Com,London,GB,9074,user_001,,
cb295639-9304-4d27-a2c1-39817a143b5c,2027-11-05,2027-11-05,Airline Refund,4511,Travel,Refund,1.57,GBP,-92196.85,Credit,London,GB,2219,user_001,,Refund for Transport for London
0d9458d8-a9d7-4980-a934-e99df3e8fcae,2027-11-06,2027-11-08,Apple.com/bill,5734,Shopping,Electronics,-138.77,GBP,-92335.62,E-Com,Cupertino,US,9074,user_001,,
2f68c0db-ad42-41c0-8fb5-f51ca7faa9d1,2027-11-06,2027-11-08,Pret A Manger,5814,Food & Drink,Eating Out,-11.95,GBP,-92347.57,POS,London,GB,4488,user_001,,
b73ed681-539c-45b3-b27b-0ef9c6b7d3ad,2027-11-06,2027-11-08,Pret A Manger,5814,Food & Drink,Eating Out,-9.77,GBP,-92357.34,POS,London,GB,2219,user_001,,
b88dbedf-64ff-43bf-82c7-d0f21c4b480e,2027-11-06,2027-11-08,Apple.com/bill,5734,Shopping,Electronics,-71.16,GBP,-92428.5,E-Com,Cupertino,US,2219,user_002,,
284bb816-0e01-4f11-bdbe-25a8b4730b41,2027-11-07,2027-11-08,Shell,5541,Transport,Fuel,-75.78,GBP,-92504.28,POS,London,GB,9074,user_001,,
36edd54c-41c7-46fc-a442-8fe0be2501fd,2027-11-07,2027-11-09,Waitrose,5411,Groceries,Supermarket,-59.84,GBP,-92564.12,POS,London,GB,4488,user_001,,
d3c7ece2-55bd-4165-ace8-11f44ab78f14,2027-11-07,2027-11-08,Pret A Manger,5814,Food & Drink,Eating Out,-6.96,GBP,-92571.08,POS,London,GB,4488,user_001,,
d7f4696b-7b38-4480-9b8b-692b4702a730,2027-11-07,2027-11-09,Sainsbury's,5411,Groceries,Supermarket,-23.57,GBP,-92594.65,POS,London,GB,4488,user_001,,
11a568f8-519e-4249-a728-39602b37170f,2027-11-08,2027-11-09,Pret A Manger,5814,Food & Drink,Eating Out,-9.98,GBP,-92604.63,POS,London,GB,2219,user_001,,
9d319734-be88-44dc-a56e-fbdd3cb345d8,2027-11-08,2027-11-09,Octopus Energy,4900,Utilities,Electricity,-131.47,GBP,-92736.1,Direct Debit,London,GB,2219,user_001,rec_141a4a0666,
a629cc5b-0c58-4cbc-8ced-2903e2b9f1ad,2027-11-08,2027-11-08,Waitrose,5411,Groceries,Supermarket,-56.45,GBP,-92792.55,POS,London,GB,4488,user_001,,
2ff89235-7bef-4f85-bb04-47e2a7299725,2027-11-09,2027-11-09,Local Market,5499,Groceries,Specialty,-12.66,GBP,-92805.21,POS,London,GB,9074,user_001,,
388175d7-a0be-419d-b734-40c1b48153cf,2027-11-09,2027-11-11,Pret A Manger,5814,Food & Drink,Eating Out,-11.87,GBP,-92817.08,POS,London,GB,9074,user_001,,
5d8e921e-8578-42da-977e-c17e8440ebad,2027-11-09,2027-11-10,Shell,5541,Transport,Fuel,-45.79,GBP,-92862.87,POS,London,GB,9074,user_001,,
f072ba69-fb74-41a7-9d8b-b14798e94351,2027-11-09,2027-11-09,Tesco,5411,Groceries,Supermarket,-20.6,GBP,-92883.47,POS,London,GB,2219,user_002,,
2c1b6220-f43e-46ab-89c7-95871201f3c7,2027-11-10,2027-11-11,Waitrose,5411,Groceries,Supermarket,-81.22,GBP,-92964.69,POS,London,GB,9074,user_002,,
5d930fda-cbf0-482f-834b-87451c8581d0,2027-11-10,2027-11-11,Deliveroo,5812,Food & Drink,Delivery,-32.59,GBP,-92997.28,E-Com,London,GB,4488,user_001,,
44f93b9c-3284-432b-81fa-d719d5483f86,2027-11-11,2027-11-11,Deliveroo,5812,Food & Drink,Delivery,-15.73,GBP,-93013.01,E-Com,London,GB,1045,user_001,,
5b782406-aa73-4cd9-887a-a1aa81439b2a,2027-11-11,2027-11-12,Thames Water,4900,Utilities,Water,-38.59,GBP,-93051.6,Direct Debit,Reading,GB,4488,user_001,rec_3a34d62842,
86844a69-e7ad-4321-b87e-e87665686d32,2027-11-12,2027-11-15,Transport for London,4111,Transport,Transit,-9.99,GBP,-93061.59,POS,London,GB,9074,user_001,,
90ae93ea-49f3-4b27-94a3-9840044981e4,2027-11-12,2027-11-15,Local Market,5499,Groceries,Specialty,-8.6,GBP,-93070.19,POS,London,GB,2219,user_002,,
1e3f89af-ec94-45a5-943a-144f6357eb8a,2027-11-13,2027-11-15,Apple.com/bill,5734,Shopping,Electronics,-56.95,GBP,-93127.14,E-Com,Cupertino,US,1045,user_002,,
38cbfc87-ce65-4aad-a47f-24501e219de9,2027-11-13,2027-11-15,Local Market,5499,Groceries,Specialty,-14.72,GBP,-93141.86,POS,London,GB,4488,user_001,,
3f78fd5c-10fa-4952-80ee-78b8ea4f906c,2027-11-13,2027-11-15,Shell,5541,Transport,Fuel,-37.57,GBP,-93179.43,POS,London,GB,1045,user_001,,
46e3f874-bc6d-4e9f-895f-4ea003ecb57a,2027-11-13,2027-11-15,Transport for London,4111,Transport,Transit,-8.82,GBP,-93188.25,POS,London,GB,9074,user_001,,
67c98f3d-552a-4d55-b6b4-2fce059e69ba,2027-11-13,2027-11-15,Uber UK,4121,Transport,Ride Hailing,-29.39,GBP,-93217.64,E-Com,London,GB,1045,user_001,,
694c769e-a27c-4038-a7d1-5ea9b7c2c09a,2027-11-13,2027-11-15,Amazon UK,5942,Shopping,Online Retail,-51.04,GBP,-93268.68,E-Com,London,GB,4488,user_001,,
fdca5ba6-37ef-480b-ab72-da9fa7d0cbc8,2027-11-13,2027-11-15,Apple.com/bill,5734,Shopping,Electronics,-85.95,GBP,-93354.63,E-Com,Cupertino,US,1045,user_002,,
61b3bf27-299b-4f29-9a61-a8f7b70b7b0b,2027-11-14,2027-11-15,Waitrose,5411,Groceries,Supermarket,-72.88,GBP,-93427.51,POS,London,GB,4488,user_001,,
806ea347-d078-4656-ace5-1b678bc0200a,2027-11-14,2027-11-15,Waitrose,5411,Groceries,Supermarket,-43.24,GBP,-93470.75,POS,London,GB,2219,user_002,,
c63063f9-4295-490c-a5c0-7d1bd68a2f84,2027-11-14,2027-11-15,Uber UK,4121,Transport,Ride Hailing,-10.89,GBP,-93481.64,E-Com,London,GB,2219,user_002,,
d489c4a5-086b-4adf-a7b5-48467d7e99f3,2027-11-14,2027-11-15,Deliveroo,5812,Food & Drink,Delivery,-23.5,GBP,-93505.14,E-Com,London,GB,9074,user_002,,
0fa18cc5-5637-4ed3-9670-70715920c8e2,2027-11-15,2027-11-17,Sainsbury's,5411,Groceries,Supermarket,-59.3,GBP,-93564.44,POS,London,GB,9074,user_001,,
23819b53-e3f3-4a08-ae98-03e702011e69,2027-11-15,2027-11-15,O2 UK,4814,Bills,Mobile,-43.9,GBP,-93608.34,Direct Debit,Slough,GB,2219,user_001,rec_95042d8101,
2c2e7f2f-2aeb-46d9-b0b0-2462ff0a79d3,2027-11-15,2027-11-15,Local Market,5499,Groceries,Specialty,-14.04,GBP,-93622.38,POS,London,GB,9074,user_002,,
5bc37e81-f535-42ec-838f-c84730f7fe27,2027-11-15,2027-11-17,City Council Tax,9399,Utilities,Council Tax,-156.25,GBP,-93778.63,Direct Debit,London,GB,1045,user_001,rec_f531495db5,
7117a950-baf0-4fff-9bef-aa60dc19f037,2027-11-15,2027-11-16,Amazon UK,5942,Shopping,Online Retail,-62.86,GBP,-93841.49,E-Com,London,GB,9074,user_001,,
9f78c87f-7d04-4d94-81bb-b4ff1c8c1230,2027-11-15,2027-11-15,Waitrose,5411,Groceries,Supermarket,-81.17,GBP,-93922.66,POS,London,GB,2219,user_001,,
78b6df97-ebee-43a0-8313-f3089a08a11b,2027-11-16,2027-11-18,Local Market,5499,Groceries,Specialty,-13.72,GBP,-93936.38,POS,London,GB,9074,user_001,,
20dc73f1-82c5-43a5-b1d3-38e7f595e4b3,2027-11-17,2027-11-17,GymBox,7997,Wellness,Gym,-49.79,GBP,-93986.17,Direct Debit,London,GB,4488,user_001,rec_3906953fd2,
23447c70-6a4a-4868-a2e3-5dabc073f4f1,2027-11-17,2027-11-18,Transport for London,4111,Transport,Transit,-8.42,GBP,-93994.59,POS,London,GB,9074,user_001,,
6b8992ab-4984-450a-ab96-7b65e4047955,2027-11-17,2027-11-18,Deliveroo,5812,Food & Drink,Delivery,-22.79,GBP,-94017.38,E-Com,London,GB,9074,user_001,,
9f609afb-1c71-4e44-b361-c456b3e33462,2027-11-18,2027-11-22,ATM Withdrawal,6011,Cash,ATM,-117.5,GBP,-94134.88,ATM,London,GB,2219,user_001,,
2e7be5c0-802f-4fc8-b1ec-02454c30d3fe,2027-11-19,2027-11-22,Transport for London,4111,Transport,Transit,-9.56,GBP,-94144.44,POS,London,GB,2219,user_001,,
4ab25818-6ae4-45c5-973e-e76b251a9af9,2027-11-19,2027-11-22,Pret A Manger,5814,Food & Drink,Eating Out,-5.92,GBP,-94150.36,POS,London,GB,2219,user_001,,
ad5d3193-3761-4ef3-a058-48d303c1f09e,2027-11-19,2027-11-19,Spotify,5735,Entertainment,Subscriptions,-8.42,EUR,-94158.78,E-Com,Stockholm,SE,4488,user_001,rec_4c746d2c3b,FX purchase 9.44 EUR @ rate 1.12
e3e91eda-560f-4a08-9f60-6b791d45994e,2027-11-19,2027-11-22,Pret A Manger,5814,Food & Drink,Eating Out,-8.78,GBP,-94167.56,POS,London,GB,4488,user_001,,
05081068-8906-4383-9382-44a5019fc968,2027-11-20,2027-11-22,Pret A Manger,5814,Food & Drink,Eating Out,-10.82,GBP,-94178.38,POS,London,GB,2219,user_001,,
4a455535-dd60-4552-a31a-a5eb15c575e7,2027-11-20,2027-11-22,Apple.com/bill,5734,Shopping,Electronics,-206.98,GBP,-94385.36,E-Com,Cupertino,US,1045,user_001,,
e2433ff9-d945-47dd-90f2-29c713ac4ea2,2027-11-20,2027-11-22,Tesco,5411,Groceries,Supermarket,-79.11,GBP,-94464.47,POS,London,GB,4488,user_001,,
bcf7d055-f0dd-4850-96ec-0ed229bae755,2027-11-21,2027-11-22,Amazon UK,5942,Shopping,Online Retail,-19.52,GBP,-94483.99,E-Com,London,GB,9074,user_001,,
00f3e5b4-f4b6-4ae6-8e39-127bf0805ee9,2027-11-22,2027-11-22,Tesco,5411,Groceries,Supermarket,-76.97,GBP,-94560.96,POS,London,GB,1045,user_001,,
065c427e-a7a0-4ce5-9e47-837f661be75d,2027-11-22,2027-11-22,Netflix,7841,Entertainment,Subscriptions,-15.76,GBP,-94576.72,E-Com,Los Gatos,US,2219,user_002,rec_d9322c1382,
1a85a368-80fb-4760-9013-624a744c6b50,2027-11-22,2027-11-23,Local Market,5499,Groceries,Specialty,-11.45,GBP,-94588.17,POS,London,GB,2219,user_001,,
7c2a0a64-eaad-435d-a58e-de4753a846b2,2027-11-22,2027-11-24,Waitrose,5411,Groceries,Supermarket,-48.27,GBP,-94636.44,POS,London,GB,2219,user_001,,
c7db8367-e81d-43d6-bc4d-fffef75a7462,2027-11-22,2027-11-23,Deliveroo,5812,Food & Drink,Delivery,-25.12,GBP,-94661.56,E-Com,London,GB,1045,user_001,,
be0d7de9-84fd-4646-b6ff-ec86d95a7eba,2027-11-23,2027-11-23,Shell,5541,Transport,Fuel,-80.68,GBP,-94742.24,POS,London,GB,9074,user_001,,
8abc1cac-1c53-4f27-82f4-66c8b12bd757,2027-11-24,2027-11-24,Deliveroo,5812,Food & Drink,Delivery,-31.17,GBP,-94773.41,E-Com,London,GB,1045,user_001,,
0c4bc2c0-584c-4de6-a3da-f663e0bb344b,2027-11-25,2027-11-25,Transport for London,4111,Transport,Transit,-11.25,GBP,-94784.66,POS,London,GB,9074,user_001,,
23fd49e4-202c-40f2-8253-f63c4f2a4b1f,2027-11-25,2027-11-25,T212 Capital,6011,Income,Salary,3407.27,GBP,-91377.39,Credit,London,GB,9074,user_001,rec_2ff8f778d0,
4a51e878-8701-42bc-8561-4ea21255e875,2027-11-25,2027-11-25,Local Market,5499,Groceries,Specialty,-13.61,GBP,-91391.0,POS,London,GB,2219,user_002,,
5606b081-1454-4d1d-948e-d859b5bf8603,2027-11-25,2027-11-25,Deliveroo,5812,Food & Drink,Delivery,-12.7,GBP,-91403.7,E-Com,London,GB,4488,user_002,,
03ae26ed-8c61-43a2-8daf-ed4f11f5ae1a,2027-11-26,2027-11-26,Pret A Manger,5814,Food & Drink,Eating Out,-8.67,GBP,-91412.37,POS,London,GB,9074,user_001,,
50bdf032-599c-4e02-9276-46909287b09e,2027-11-27,2027-11-29,Deliveroo,5812,Food & Drink,Delivery,-17.75,GBP,-91430.12,E-Com,London,GB,4488,user_001,,
8ca4e3ba-5c55-42fc-b724-3ae85e3f3158,2027-11-27,2027-11-29,Amazon UK,5942,Shopping,Online Retail,-11.97,GBP,-91442.09,E-Com,London,GB,1045,user_002,,
b568c048-5437-4ff4-9ec5-2aa45776f003,2027-11-28,2027-11-29,Apple.com/bill,5734,Shopping,Electronics,-10.01,USD,-91452.1,E-Com,Cupertino,US,4488,user_002,,FX purchase 12.68 USD @ rate 1.27
c21800c3-8eee-41b1-b019-1e49aa36d9ba,2027-11-28,2027-11-30,Amazon UK,5942,Shopping,Online Retail,-67.06,GBP,-91519.16,E-Com,London,GB,9074,user_002,,
d345a490-5239-4723-b5ba-e9ab37456636,2027-11-28,2027-11-29,Apple.com/bill,5734,Shopping,Electronics,-145.1,GBP,-91664.26,E-Com,Cupertino,US,4488,user_002,,
28fba2ae-a37e-4727-94ed-457b839abe71,2027-11-29,2027-12-01,Deliveroo,5812,Food & Drink,Delivery,-29.26,GBP,-91693.52,E-Com,London,GB,4488,user_001,,
c97e08d2-4106-4657-a6bb-168f0b16a052,2027-11-29,2027-12-01,Pret A Manger,5814,Food & Drink,Eating Out,-7.29,GBP,-91700.81,POS,London,GB,9074,user_002,,
7d50d6b1-500c-4b03-9ffa-f74f69aa53e6,2027-11-30,2027-12-02,Amazon UK,5942,Shopping,Online Retail,-74.92,GBP,-91775.73,E-Com,London,GB,4488,user_001,,
0c1c4a33-64ce-427c-9b51-ebc4ef8acb06,2027-12-01,2027-12-02,Apple.com/bill,5734,Shopping,Electronics,-101.32,GBP,-91877.05,E-Com,Cupertino,US,2219,user_001,,
2844f350-a1b5-4316-b9b4-9046c2f93e74,2027-12-01,2027-12-01,Airline Refund,4511,Travel,Refund,193.56,GBP,-91683.49,Credit,London,GB,1045,user_001,,Refund for Apple.com/bill
4d89cbe6-6139-48b8-b454-97fb2e5bff70,2027-12-01,2027-12-03,Uber UK,4121,Transport,Ride Hailing,-33.14,GBP,-91716.63,E-Com,London,GB,4488,user_001,,
c9493c3a-beec-4b6b-a324-1fcb2396c5d2,2027-12-01,2027-12-01,Crown Estates Lettings,6513,Housing,Rent,-1534.39,GBP,-93251.02,POS,London,GB,1045,user_001,rec_19f70fbcce,
bd986f9f-dd93-4d1d-9c17-abcb8b44e9eb,2027-12-02,2027-12-06,Local Market,5499,Groceries,Specialty,-7.54,GBP,-93258.56,POS,London,GB,2219,user_001,,
cb7ece6a-4df7-455c-be58-adea5ab2a7ee,2027-12-02,2027-12-02,Tesco,5411,Groceries,Supermarket,-51.56,GBP,-93310.12,POS,London,GB,2219,user_001,,
fc252bd6-30aa-4903-b610-7990e94fe77a,2027-12-02,2027-12-02,Apple.com/bill,5734,Shopping,Electronics,-172.77,USD,-93482.89,E-Com,Cupertino,US,9074,user_001,,FX purchase 209.85 USD @ rate 1.21
8ed7ebe0-c035-4999-bb19-571290ba176c,2027-12-03,2027-12-06,Shell,5541,Transport,Fuel,-70.5,GBP,-93553.39,POS,London,GB,2219,user_001,,
1d07b48e-1acd-4df4-9c23-bb7546e3eeac,2027-12-04,2027-12-06,Transport for London,4111,Transport,Transit,-8.88,GBP,-93562.27,POS,London,GB,2219,user_002,,
930921ab-5a0a-40bf-8e59-e7d1a1abdc1d,2027-12-04,2027-12-06,Tesco,5411,Groceries,Supermarket,-21.22,GBP,-93583.49,POS,London,GB,4488,user_001,,
d469cb32-d7d9-4d88-87d4-3b178c4054a6,2027-12-04,2027-12-06,Uber UK,4121,Transport,Ride Hailing,-22.7,GBP,-93606.19,E-Com,London,GB,2219,user_002,,
d757ad3f-3d99-40f7-8c77-fb1687a17c04,2027-12-04,2027-12-06,Shell,5541,Transport,Fuel,-51.3,GBP,-93657.49,POS,London,GB,1045,user_001,,
e1422618-9ca8-4694-8d98-71dedddc07dc,2027-12-04,2027-12-06,Tesco,5411,Groceries,Supermarket,-73.37,GBP,-93730.86,POS,London,GB,2219,user_001,,
5744d732-3fd4-4909-b8c9-a4c2a5aed441,2027-12-05,2027-12-06,Apple.com/bill,5734,Shopping,Electronics,-24.43,GBP,-93755.29,E-Com,Cupertino,US,9074,user_001,,
9c6f1514-5c1e-4f4c-96fe-9d664c28fe21,2027-12-05,2027-12-06,Shell,5541,Transport,Fuel,-81.54,GBP,-93836.83,POS,London,GB,2219,user_001,,
aa294caf-ce82-4563-9fe2-6ba2adffaba8,2027-12-05,2027-12-06,Deliveroo,5812,Food & Drink,Delivery,-30.06,GBP,-93866.89,E-Com,London,GB,2219,user_002,,
151abaa7-c887-42ad-835b-44a4e6c5980f,2027-12-06,2027-12-08,Uber UK,4121,Transport,Ride Hailing,-35.9,GBP,-93902.79,E-Com,London,GB,2219,user_001,,
af9ceedf-23b3-43fe-8777-26dd27ff2e01,2027-12-06,2027-12-08,Tesco,5411,Groceries,Supermarket,-65.87,GBP,-93968.66,POS,London,GB,9074,user_001,,
235a66d8-a379-4468-8c24-09b65044887c,2027-12-07,2027-12-09,Tesco,5411,Groceries,Supermarket,-52.19,GBP,-94020.85,POS,London,GB,9074,user_001,,
57aae72c-edac-47f5-8dd8-de04d5929497,2027-12-07,2027-12-08,Transport for London,4111,Transport,Transit,-11.69,GBP,-94032.54,POS,London,GB,2219,user_001,,
8bbf1a59-ca5b-4965-b04c-c432b5fbb98a,2027-12-07,2027-12-09,Octopus Energy,4900,Utilities,Electricity,-137.26,GBP,-94169.8,Direct Debit,London,GB,9074,user_001,rec_141a4a0666,
ef4c3513-313e-43c7-a7cd-76b12253cf87,2027-12-08,2027-12-10,Local Market,5499,Groceries,Specialty,-17.07,GBP,-94186.87,POS,London,GB,4488,user_001,,
4beb72e6-a31c-4042-aaeb-1bd4374712dc,2027-12-09,2027-12-10,Local Market,5499,Groceries,Specialty,-7.71,GBP,-94194.58,POS,London,GB,2219,user_001,,
5332eac6-d0cc-4700-b7b9-05d89acb2a92,2027-12-09,2027-12-13,Shell,5541,Transport,Fuel,-31.27,GBP,-94225.85,POS,London,GB,2219,user_001,,
a7bae039-059a-4a02-96f6-5dc7f37602aa,2027-12-09,2027-12-09,Transport for London,4111,Transport,Transit,-4.32,GBP,-94230.17,POS,London,GB,2219,user_001,,
0b3edf05-ba5d-419c-a73c-66983ba0860c,2027-12-11,2027-12-13,Waitrose,5411,Groceries,Supermarket,-82.35,GBP,-94312.52,POS,London,GB,4488,user_001,,
31bfe264-3e15-4624-92c3-58a5dd4a541a,2027-12-11,2027-12-13,Deliveroo,5812,Food & Drink,Delivery,-16.73,GBP,-94329.25,E-Com,London,GB,4488,user_001,,
3accca6a-e6e6-47c9-bc8b-42934c676e91,2027-12-12,2027-12-13,Waitrose,5411,Groceries,Supermarket,-29.79,GBP,-94359.04,POS,London,GB,1045,user_001,,
437b01d7-c7e2-42af-853b-1b83a3c67c9d,2027-12-12,2027-12-14,Shell,5541,Transport,Fuel,-87.43,GBP,-94446.47,POS,London,GB,9074,user_001,,
e6d7bae5-343a-4aa7-9912-bfe55325bbbe,2027-12-12,2027-12-14,Amazon UK,5942,Shopping,Online Retail,-24.5,GBP,-94470.97,E-Com,London,GB,9074,user_001,,
366583da-4a65-41b6-8566-4ef3e58f3737,2027-12-13,2027-12-14,City Council Tax,9399,Utilities,Council Tax,-178.81,GBP,-94649.78,Direct Debit,London,GB,1045,user_001,rec_f531495db5,
4ce874f3-6cd8-4601-b5a7-b8d6010bb4a0,2027-12-13,2027-12-13,Sainsbury's,5411,Groceries,Supermarket,-21.93,GBP,-94671.71,POS,London,GB,1045,user_002,,
8cd19dd6-9534-43bb-a1d8-62f806440e8a,2027-12-13,2027-12-14,Waitrose,5411,Groceries,Supermarket,-36.51,GBP,-94708.22,POS,London,GB,9074,user_001,,
e156b245-09ac-4af4-94b9-2fb450129f54,2027-12-13,2027-12-15,Waitrose,5411,Groceries,Supermarket,-89.25,GBP,-94797.47,POS,London,GB,4488,user_001,,
ef1861b7-a4a9-4c14-80c2-06fa452686c2,2027-12-13,2027-12-13,Thames Water,4900,Utilities,Water,-39.99,GBP,-94837.46,Direct Debit,Reading,GB,1045,user_001,rec_3a34d62842,
f6e217f8-fe58-47d3-956f-9b82a762414f,2027-12-13,2027-12-13,Apple.com/bill,5734,Shopping,Electronics,-73.7,GBP,-94911.16,E-Com,Cupertino,US,4488,user_001,,
14fe146c-cdc0-47f0-9d9b-dfe5b184d756,2027-12-15,2027-12-17,Deliveroo,5812,Food & Drink,Delivery,-14.58,GBP,-94925.74,E-Com,London,GB,1045,user_002,,
23fdb707-2377-4b64-93bd-3fd43a20f3e9,2027-12-15,2027-12-16,O2 UK,4814,Bills,Mobile,-52.63,GBP,-94978.37,Direct Debit,Slough,GB,4488,user_001,rec_95042d8101,
77c4b0e6-6659-48ce-afda-0cf51dff4376,2027-12-16,2027-12-20,Amazon UK,5942,Shopping,Online Retail,-68.31,GBP,-95046.68,E-Com,London,GB,1045,user_001,,
7c862224-6a7f-487c-98f7-2593ed133928,2027-12-16,2027-12-17,Amazon UK,5942,Shopping,Online Retail,-71.78,GBP,-95118.46,E-Com,London,GB,2219,user_001,,
9caca168-b91b-415d-bffb-baf03c7854c4,2027-12-17,2027-12-17,GymBox,7997,Wellness,Gym,-47.65,GBP,-95166.11,Direct Debit,London,GB,1045,user_001,rec_3906953fd2,
c9e9c807-db0e-4d61-8a93-d4e75f4f5985,2027-12-17,2027-12-20,Pret A Manger,5814,Food & Drink,Eating Out,-7.28,GBP,-95173.39,POS,London,GB,9074,user_001,,
41db13ef-b2c5-4bd5-9e21-9e44f398b204,2027-12-18,2027-12-20,Sainsbury's,5411,Groceries,Supermarket,-19.38,GBP,-95192.77,POS,London,GB,2219,user_001,,
5e3f6924-e107-42ce-8d9d-b9bd3da30ae1,2027-12-18,2027-12-20,Uber UK,4121,Transport,Ride Hailing,-14.6,GBP,-95207.37,E-Com,London,GB,1045,user_001,,
9088d326-8c3b-42c9-b08e-7b92cd383741,2027-12-18,2027-12-20,Amazon UK,5942,Shopping,Online Retail,-104.19,GBP,-95311.56,E-Com,London,GB,4488,user_001,,
d57dc516-11dc-4084-a8f0-92696b86832b,2027-12-18,2027-12-20,Deliveroo,5812,Food & Drink,Delivery,-12.18,GBP,-95323.74,E-Com,London,GB,1045,user_001,,
18e97d0e-2fd4-427d-a474-9df388bfb7eb,2027-12-19,2027-12-21,Apple.com/bill,5734,Shopping,Electronics,-27.12,USD,-95350.86,E-Com,Cupertino,US,9074,user_001,,FX purchase 33.73 USD @ rate 1.24
1d61613a-9656-44d9-b587-b94dee806884,2027-12-19,2027-12-21,Pret A Manger,5814,Food & Drink,Eating Out,-11.34,GBP,-95362.2,POS,London,GB,9074,user_001,,
39b5bfac-432f-49e7-bbf5-8e2ae7ac1fae,2027-12-19,2027-12-20,Shell,5541,Transport,Fuel,-83.15,GBP,-95445.35,POS,London,GB,4488,user_001,,
46985368-6192-4c5a-a8ce-78d99913a46e,2027-12-19,2027-12-21,Shell,5541,Transport,Fuel,-70.87,GBP,-95516.22,POS,London,GB,2219,user_001,,
4712bf64-a28a-447d-aac7-de87d543c3cd,2027-12-19,2027-12-20,Uber UK,4121,Transport,Ride Hailing,-23.9,GBP,-95540.12,E-Com,London,GB,4488,user_002,,
623cb4b4-522e-4a1b-8b4d-73ab9852014d,2027-12-19,2027-12-20,Tesco,5411,Groceries,Supermarket,-37.36,GBP,-95577.48,POS,London,GB,4488,user_001,,
a0e103ba-108e-48ca-88cd-ad4faaf565b6,2027-12-19,2027-12-20,Transport for London,4111,Transport,Transit,-8.68,GBP,-95586.16,POS,London,GB,1045,user_001,,
e7766885-db5a-47ac-9321-3c73d1e1258c,2027-12-20,2027-12-20,Spotify,5735,Entertainment,Subscriptions,-8.15,GBP,-95594.31,E-Com,Stockholm,SE,9074,user_001,rec_4c746d2c3b,
2a56b581-4b48-480f-a3e6-f3a98b41d7e4,2027-12-21,2027-12-23,Netflix,7841,Entertainment,Subscriptions,-10.03,GBP,-95604.34,E-Com,Los Gatos,US,4488,user_001,rec_1bfe33738d,
c574b09b-b301-476a-8b66-0cc63fd398a7,2027-12-21,2027-12-22,ATM Withdrawal,6011,Cash,ATM,-84.81,GBP,-95689.15,ATM,London,GB,4488,user_001,,
d0c0a7dc-1268-45ea-81d0-2189a39e2865,2027-12-22,2027-12-22,Shell,5541,Transport,Fuel,-73.23,GBP,-95762.38,POS,London,GB,1045,user_001,,
d2bc7bda-e932-4baa-b50a-6fc6bf2c96e1,2027-12-23,2027-12-27,Amazon UK,5942,Shopping,Online Retail,-40.9,GBP,-95803.28,E-Com,London,GB,9074,user_001,,
e3ecb94a-f7b5-469c-ab9c-0d9cf59768cd,2027-12-24,2027-12-24,T212 Capital,6011,Income,Salary,2918.57,GBP,-92884.71,Credit,London,GB,9074,user_002,rec_c649d24d0f,
02729600-06a2-418d-bd8c-b32b1afe0646,2027-12-25,2027-12-27,Amazon UK,5942,Shopping,Online Retail,-97.85,GBP,-92982.56,E-Com,London,GB,1045,user_001,,
4b82fca6-1a4a-4e48-9ac0-c43c5b814396,2027-12-25,2027-12-27,Deliveroo,5812,Food & Drink,Delivery,-27.32,GBP,-93009.88,E-Com,London,GB,2219,user_001,,
768b710d-f4a2-45e4-b4dd-83fe108f8fd5,2027-12-25,2027-12-27,Uber UK,4121,Transport,Ride Hailing,-17.01,GBP,-93026.89,E-Com,London,GB,9074,user_002,,
c7f9bb3b-d4bb-488b-aedd-8d905567109f,2027-12-25,2027-12-27,Local Market,5499,Groceries,Specialty,-16.24,GBP,-93043.13,POS,London,GB,9074,user_002,,
52aa05e3-e377-4478-95c0-3c93ccf6a3ac,2027-12-26,2027-12-28,Deliveroo,5812,Food & Drink,Delivery,-30.63,GBP,-93073.76,E-Com,London,GB,2219,user_001,,
7c9892dd-a0dd-4bff-adf9-a240e6f61832,2027-12-26,2027-12-27,Transport for London,4111,Transport,Transit,-7.27,GBP,-93081.03,POS,London,GB,1045,user_001,,
8eccc061-5bf6-4a6b-b254-b067f6942dc4,2027-12-26,2027-12-28,Apple.com/bill,5734,Shopping,Electronics,-88.54,GBP,-93169.57,E-Com,Cupertino,US,4488,user_001,,
004f5fc7-4f96-46b2-b62f-05983c5c28de,2027-12-28,2027-12-30,Local Market,5499,Groceries,Specialty,-8.51,GBP,-93178.08,POS,London,GB,1045,user_001,,
712adaab-83aa-4c36-8129-6e81f7f56fc7,2027-12-29,2027-12-31,Local Market,5499,Groceries,Specialty,-21.43,GBP,-93199.51,POS,London,GB,2219,user_001,,
da13fc58-62ee-48cb-a151-4e7404dc358f,2027-12-29,2027-12-29,Pret A Manger,5814,Food & Drink,Eating Out,-11.82,GBP,-93211.33,POS,London,GB,2219,user_001,,
218436a1-06e7-44c4-ad38-7f38cc555220,2027-12-30,2028-01-03,Deliveroo,5812,Food & Drink,Delivery,-13.29,GBP,-93224.62,E-Com,London,GB,9074,user_001,,
56937a52-75aa-4f7a-8995-a9efdd622235,2027-12-30,2028-01-03,Deliveroo,5812,Food & Drink,Delivery,-12.87,GBP,-93237.49,E-Com,London,GB,9074,user_002,,
5f21d3b1-32b8-44b3-ba42-afc29acb42b9,2027-12-31,2028-01-03,Amazon UK,5942,Shopping,Online Retail,-71.21,GBP,-93308.7,E-Com,London,GB,4488,user_001,,
74984a4a-081e-40dd-84fa-7aa14c317f8f,2027-12-31,2027-12-31,Sainsbury's,5411,Groceries,Supermarket,-54.73,GBP,-93363.43,POS,London,GB,4488,user_001,,
b5aef15f-d203-47a3-a422-dc9dfbbef0a9,2027-12-31,2028-01-03,Pret A Manger,5814,Food & Drink,Eating Out,-9.06,GBP,-93372.49,POS,London,GB,1045,user_002,,
cb75bd2c-6759-4726-bc28-a96a6eee0378,2027-12-31,2027-12-31,Deliveroo,5812,Food & Drink,Delivery,-20.0,GBP,-93392.49,E-Com,London,GB,2219,user_001,,
01af2dbb-7ce6-4095-a8a9-9e93bed74ae9,2028-01-01,2028-01-03,Amazon UK,5942,Shopping,Online Retail,-48.48,GBP,-93440.97,E-Com,London,GB,9074,user_001,,
34ba8a95-5ba0-4588-94ba-a28ac12b07ec,2028-01-01,2028-01-03,Tesco,5411,Groceries,Supermarket,-52.27,GBP,-93493.24,POS,London,GB,1045,user_001,,
603e5bc5-fe8f-4bd2-abf1-797cbb410b20,2028-01-01,2028-01-03,Transport for London,4111,Transport,Transit,-7.38,GBP,-93500.62,POS,London,GB,4488,user_001,,
096c8daf-40df-4b25-8520-2c5dc65b95a9,2028-01-02,2028-01-03,Sainsbury's,5411,Groceries,Supermarket,-62.94,GBP,-93563.56,POS,London,GB,4488,user_001,,
77b03c37-4124-43da-8a21-04eb991777d2,2028-01-02,2028-01-04,Uber UK,4121,Transport,Ride Hailing,-14.97,GBP,-93578.53,E-Com,London,GB,2219,user_001,,
81493499-d69a-45e5-99f9-f551c1883012,2028-01-02,2028-01-03,Deliveroo,5812,Food & Drink,Delivery,-20.71,GBP,-93599.24,E-Com,London,GB,9074,user_001,,
a0c5046d-e825-4976-9f18-2238552f55ed,2028-01-02,2028-01-03,Uber UK,4121,Transport,Ride Hailing,-16.81,GBP,-93616.05,E-Com,London,GB,2219,user_001,,
a752ca5f-f4a6-48ee-8caf-7c355e343142,2028-01-02,2028-01-03,Deliveroo,5812,Food & Drink,Delivery,-18.63,GBP,-93634.68,E-Com,London,GB,2219,user_001,,
fa16f939-b42d-4602-9e24-40e1bb4d7900,2028-01-02,2028-01-03,Shell,5541,Transport,Fuel,-61.47,GBP,-93696.15,POS,London,GB,4488,user_001,,
3a24ea1d-1f9a-4791-a4ec-c043edd7973e,2028-01-03,2028-01-03,Crown Estates Lettings,6513,Housing,Rent,-1611.63,GBP,-95307.78,POS,London,GB,9074,user_001,rec_19f70fbcce,
7feca358-fa8f-4661-85a1-fd6617ccec92,2028-01-03,2028-01-03,Amazon UK,5942,Shopping,Online Retail,-77.82,GBP,-95385.6,E-Com,London,GB,2219,user_001,,
d1d9d03b-e39e-4951-952d-6f3b018be33b,2028-01-03,2028-01-04,Uber UK,4121,Transport,Ride Hailing,-23.57,GBP,-95409.17,E-Com,London,GB,2219,user_002,,
2a9e14c6-2c10-41ea-9a82-b1cd3f790925,2028-01-04,2028-01-04,ATM Withdrawal,6011,Cash,ATM,-98.93,GBP,-95508.1,ATM,London,GB,1045,user_001,,
bee27fa9-e90e-4e56-bc53-61df94ab1b99,2028-01-05,2028-01-07,ATM Withdrawal,6011,Cash,ATM,-63.06,GBP,-95571.16,ATM,London,GB,2219,user_001,,
26b06ab9-9b48-4867-b778-103f483840bc,2028-01-06,2028-01-10,Waitrose,5411,Groceries,Supermarket,-55.7,GBP,-95626.86,POS,London,GB,2219,user_001,,
f52d0d80-9e15-4a3b-bbef-510c81d9ec50,2028-01-06,2028-01-10,Apple.com/bill,5734,Shopping,Electronics,-15.36,GBP,-95642.22,E-Com,Cupertino,US,2219,user_001,,
608cbaa7-c3ad-4db0-982a-b6155d827721,2028-01-07,2028-01-10,Tesco,5411,Groceries,Supermarket,-25.27,GBP,-95667.49,POS,London,GB,9074,user_002,,
686163de-910f-4e1a-9642-e3d1384048e3,2028-01-07,2028-01-10,Octopus Energy,4900,Utilities,Electricity,-117.44,GBP,-95784.93,Direct Debit,London,GB,1045,user_002,rec_09c3f12b18,
9aa51877-05a9-4c8e-bbe2-912bb2e449fc,2028-01-07,2028-01-10,Waitrose,5411,Groceries,Supermarket,-23.2,GBP,-95808.13,POS,London,GB,1045,user_001,,
a24da1e4-6d9e-4284-8ca5-de2b0b030f94,2028-01-07,2028-01-07,Amazon UK,5942,Shopping,Online Retail,-70.01,GBP,-95878.14,E-Com,London,GB,2219,user_001,,
0a163b61-6bf6-45a6-bba1-e1bd0aead0c7,2028-01-08,2028-01-10,Tesco,5411,Groceries,Supermarket,-57.57,GBP,-95935.71,POS,London,GB,1045,user_001,,
717c6076-b9d3-4559-a61a-5d7bc3c699b3,2028-01-08,2028-01-10,Uber UK,4121,Transport,Ride Hailing,-27.86,GBP,-95963.57,E-Com,London,GB,2219,user_002,,
76164c38-d0a1-4abb-83ab-e3d027da0395,2028-01-08,2028-01-10,Deliveroo,5812,Food & Drink,Delivery,-30.4,GBP,-95993.97,E-Com,London,GB,9074,user_002,,
801a41eb-d4d8-43b2-a7b3-eda92ada854c,2028-01-08,2028-01-10,Local Market,5499,Groceries,Specialty,-7.88,GBP,-96001.85,POS,London,GB,2219,user_001,,
c5ed8673-1fd8-4ba9-a199-cc0b248a3fb0,2028-01-08,2028-01-10,Apple.com/bill,5734,Shopping,Electronics,-168.79,GBP,-96170.64,E-Com,Cupertino,US,9074,user_002,,
f0cbcf9c-d6f6-4d70-8f0c-6acd2a1d2fa4,2028-01-08,2028-01-10,Waitrose,5411,Groceries,Supermarket,-34.36,GBP,-96205.0,POS,London,GB,4488,user_001,,
0114f4d9-05b2-4280-bb44-8d9698e617d9,2028-01-09,2028-01-10,Pret A Manger,5814,Food & Drink,Eating Out,-5.74,GBP,-96210.74,POS,London,GB,2219,user_001,,
2e3907c6-ab5b-4df8-89b4-2f67096bab5e,2028-01-09,2028-01-11,Apple.com/bill,5734,Shopping,Electronics,-156.88,USD,-96367.62,E-Com,Cupertino,US,2219,user_002,,FX purchase 194.16 USD @ rate 1.24
7e5ce52f-bd74-45a0-a7a0-0b80aeeb82b1,2028-01-09,2028-01-10,Shell,5541,Transport,Fuel,-88.06,GBP,-96455.68,POS,London,GB,9074,user_001,,
05500c2c-478e-4b13-99d1-f64274fef8fc,2028-01-11,2028-01-12,Waitrose,5411,Groceries,Supermarket,-40.68,GBP,-96496.36,POS,London,GB,9074,user_001,,
0dd612e9-6050-462f-81c7-25afd926f7a6,2028-01-11,2028-01-11,Apple.com/bill,5734,Shopping,Electronics,-58.47,GBP,-96554.83,E-Com,Cupertino,US,2219,user_002,,
3a185d3f-7239-4b19-a2a1-feb216682431,2028-01-11,2028-01-11,Thames Water,4900,Utilities,Water,-43.28,GBP,-96598.11,Direct Debit,Reading,GB,9074,user_001,rec_3a34d62842,
cc4a2fef-4292-4475-8e4a-f6bd0981f707,2028-01-11,2028-01-13,Shell,5541,Transport,Fuel,-54.72,GBP,-96652.83,POS,London,GB,2219,user_001,,
dcc48c1b-1011-46bd-bfa6-60d6d6c7011d,2028-01-12,2028-01-12,Uber UK,4121,Transport,Ride Hailing,-9.02,GBP,-96661.85,E-Com,London,GB,9074,user_001,,
05c0da2b-0352-44fc-a7d8-6b62cb4dbbdc,2028-01-13,2028-01-13,Shell,5541,Transport,Fuel,-32.42,GBP,-96694.27,POS,London,GB,1045,user_001,,
27c9db1f-b1ab-4fab-8f22-5f3dc45ff9fe,2028-01-13,2028-01-13,Sainsbury's,5411,Groceries,Supermarket,-69.11,GBP,-96763.38,POS,London,GB,1045,user_002,,
343bc8e9-17f7-41d4-b5b5-96c13ebfe1f7,2028-01-13,2028-01-14,Waitrose,5411,Groceries,Supermarket,-59.19,GBP,-96822.57,POS,London,GB,2219,user_001,,
780e7b54-7535-45bd-940a-064e15442e6b,2028-01-13,2028-01-17,Apple.com/bill,5734,Shopping,Electronics,-65.16,USD,-96887.73,E-Com,Cupertino,US,1045,user_002,,FX purchase 79.3 USD @ rate 1.22
aae4076a-1ca0-4965-be2b-decd0fd4d73b,2028-01-13,2028-01-17,City Council Tax,9399,Utilities,Council Tax,-180.22,GBP,-97067.95,Direct Debit,London,GB,9074,user_001,rec_f531495db5,
e3d78755-8760-4966-9274-09b9af0aa0be,2028-01-13,2028-01-17,Apple.com/bill,5734,Shopping,Electronics,-185.53,GBP,-97253.48,E-Com,Cupertino,US,4488,user_002,,
e18c776a-263c-4af5-9577-d94021f33f0b,2028-01-14,2028-01-17,Sainsbury's,5411,Groceries,Supermarket,-63.2,GBP,-97316.68,POS,London,GB,2219,user_001,,
6897d5b6-c1d9-4035-9181-7e4f4c584213,2028-01-15,2028-01-17,Airline Refund,4511,Travel,Refund,22.37,GBP,-97294.31,Credit,London,GB,2219,user_001,,Refund for Amazon UK
73041ca1-36cb-4d2c-9809-f4913f3f9469,2028-01-15,2028-01-17,Apple.com/bill,5734,Shopping,Electronics,-8.73,GBP,-97303.04,E-Com,Cupertino,US,9074,user_001,,
f0dd368a-b881-40b7-98ad-f3c78af98074,2028-01-15,2028-01-17,Local Market,5499,Groceries,Specialty,-11.31,GBP,-97314.35,POS,London,GB,1045,user_001,,
f3d77bae-3465-41af-8917-d85ce8fe5a14,2028-01-15,2028-01-17,Uber UK,4121,Transport,Ride Hailing,-21.82,GBP,-97336.17,E-Com,London,GB,1045,user_001,,
1a9c8c10-d349-4445-825a-f5db00bc82b1,2028-01-16,2028-01-17,Apple.com/bill,5734,Shopping,Electronics,-123.39,USD,-97459.56,E-Com,Cupertino,US,2219,user_001,,FX purchase 148.94 USD @ rate 1.21
4c42d154-7938-4ef5-b7d7-d5442e740feb,2028-01-16,2028-01-17,Amazon UK,5942,Shopping,Online Retail,-64.33,GBP,-97523.89,E-Com,London,GB,9074,user_001,,
4e40f6e1-1670-4b16-b5fe-6f0f43c625d9,2028-01-16,2028-01-17,Waitrose,5411,Groceries,Supermarket,-76.54,GBP,-97600.43,POS,London,GB,4488,user_001,,
b113c56d-fbe6-4852-bc63-58210d78404f,2028-01-16,2028-01-18,Uber UK,4121,Transport,Ride Hailing,-34.47,GBP,-97634.9,E-Com,London,GB,2219,user_001,,
b3c2809c-56a5-4d84-985b-747b14de7731,2028-01-16,2028-01-17,Shell,5541,Transport,Fuel,-88.68,GBP,-97723.58,POS,London,GB,9074,user_001,,
b77e7352-5c49-4194-ae99-aa8b8f7fb4d0,2028-01-16,2028-01-17,Deliveroo,5812,Food & Drink,Delivery,-15.32,GBP,-97738.9,E-Com,London,GB,9074,user_001,,
2c9019ef-545e-495b-9742-46f0679045ac,2028-01-17,2028-01-19,GymBox,7997,Wellness,Gym,-49.47,GBP,-97788.37,Direct Debit,London,GB,4488,user_001,rec_3906953fd2,
687fe748-3684-4eb1-83fb-dae3cbf00a95,2028-01-17,2028-01-19,O2 UK,4814,Bills,Mobile,-47.38,GBP,-97835.75,Direct Debit,Slough,GB,4488,user_002,rec_d2dce4c42f,
c121c95e-f0c9-4804-9226-958ef6c8cb86,2028-01-17,2028-01-18,Amazon UK,5942,Shopping,Online Retail,-31.94,GBP,-97867.69,E-Com,London,GB,9074,user_001,,
fb98359d-2079-4ef8-b8a0-aebfd77728dc,2028-01-17,2028-01-19,Deliveroo,5812,Food & Drink,Delivery,-16.78,GBP,-97884.47,E-Com,London,GB,1045,user_002,,
d031ba9f-1885-48c0-be02-dc9c13e61271,2028-01-18,2028-01-19,Tesco,5411,Groceries,Supermarket,-64.16,GBP,-97948.63,POS,London,GB,4488,user_001,,
5734303c-0793-4948-9429-f0c66b3e9148,2028-01-19,2028-01-20,Local Market,5499,Groceries,Specialty,-15.58,GBP,-97964.21,POS,London,GB,2219,user_002,,
8f3a68e1-c3a4-4ee1-81b0-22cb7c83c537,2028-01-19,2028-01-19,Spotify,5735,Entertainment,Subscriptions,-9.68,GBP,-97973.89,E-Com,Stockholm,SE,1045,user_001,rec_4c746d2c3b,
d8112a1c-2a03-4447-9091-b5a2cce9069b,2028-01-19,2028-01-20,Tesco,5411,Groceries,Supermarket,-33.9,GBP,-98007.79,POS,London,GB,9074,user_001,,
f5207d41-01d0-4888-a20c-72fb657fae06,2028-01-19,2028-01-19,Pret A Manger,5814,Food & Drink,Eating Out,-10.39,GBP,-98018.18,POS,London,GB,1045,user_001,,
3f9f7508-5f4f-41d0-be80-ed00630656cd,2028-01-20,2028-01-20,HM Revenue & Customs,9311,Income,Tax Refund,45.64,GBP,-97972.54,Credit,London,GB,1045,user_002,,Refund for Apple.com/bill
8732bd34-0029-4eb8-8a6e-c435cecd2409,2028-01-20,2028-01-20,Transport for London,4111,Transport,Transit,-4.06,GBP,-97976.6,POS,London,GB,4488,user_001,,
aa7c83ec-79fc-4b3c-acca-08cd3e40e36c,2028-01-20,2028-01-20,Amazon UK,5942,Shopping,Online Retail,-44.8,GBP,-98021.4,E-Com,London,GB,9074,user_001,,
722487b1-8fcc-4ad9-bb40-48ab92473432,2028-01-21,2028-01-21,Apple.com/bill,5734,Shopping,Electronics,-177.98,USD,-98199.38,E-Com,Cupertino,US,9074,user_001,,FX purchase 216.72 USD @ rate 1.22
7f3b275d-0076-4d28-ad37-80f21100ee6e,2028-01-21,2028-01-21,ATM Withdrawal,6011,Cash,ATM,-65.7,GBP,-98265.08,ATM,London,GB,9074,user_001,,
e2f30dcb-a859-46fa-a44a-d6861e472f0b,2028-01-21,2028-01-21,Netflix,7841,Entertainment,Subscriptions,-14.32,USD,-98279.4,E-Com,Los Gatos,US,2219,user_001,rec_1bfe33738d,FX purchase 17.69 USD @ rate 1.24
2254d312-77ca-456a-9990-71fa657ac165,2028-01-22,2028-01-24,Sainsbury's,5411,Groceries,Supermarket,-47.78,GBP,-98327.18,POS,London,GB,1045,user_001,,
9c4b5cae-cba8-4aad-be36-cdeee3ac350a,2028-01-22,2028-01-24,Pret A Manger,5814,Food & Drink,Eating Out,-8.45,GBP,-98335.63,POS,London,GB,9074,user_001,,
6a938576-74a0-400e-a8ba-a03cf57bb34b,2028-01-23,2028-01-24,Deliveroo,5812,Food & Drink,Delivery,-32.74,GBP,-98368.37,E-Com,London,GB,9074,user_001,,
b76ae3cd-1ac1-4429-b382-797b0d66607a,2028-01-23,2028-01-24,ATM Withdrawal,6011,Cash,ATM,-97.72,GBP,-98466.09,ATM,London,GB,4488,user_002,,
d2ad928c-2c25-428e-995e-3b35728313d6,2028-01-23,2028-01-24,Apple.com/bill,5734,Shopping,Electronics,-60.64,GBP,-98526.73,E-Com,Cupertino,US,1045,user_001,,
62a9f8d9-4d97-4e9b-93e4-58acff36b2ed,2028-01-25,2028-01-25,Sainsbury's,5411,Groceries,Supermarket,-22.58,GBP,-98549.31,POS,London,GB,2219,user_001,,
7e43513b-7b8b-4ec2-89c1-87f0f3df796d,2028-01-25,2028-01-25,T212 Capital,6011,Income,Salary,3046.3,GBP,-95503.01,Credit,London,GB,2219,user_001,rec_2ff8f778d0,
95390496-c0a4-4785-a3e9-1f2ae925fda6,2028-01-25,2028-01-27,Transport for London,4111,Transport,Transit,-4.12,GBP,-95507.13,POS,London,GB,1045,user_001,,
035879c7-fe90-4cc9-ba2a-7abc86180425,2028-01-27,2028-01-31,Apple.com/bill,5734,Shopping,Electronics,-77.51,GBP,-95584.64,E-Com,Cupertino,US,1045,user_001,,
82e5d7d7-d627-4f4d-a97a-1c806631c0d1,2028-01-27,2028-01-28,Tesco,5411,Groceries,Supermarket,-23.45,GBP,-95608.09,POS,London,GB,9074,user_002,,
8f8cfb65-42f0-452a-b692-f5dfb8266416,2028-01-27,2028-01-31,Apple.com/bill,5734,Shopping,Electronics,-145.93,USD,-95754.02,E-Com,Cupertino,US,2219,user_001,,FX purchase 184.21 USD @ rate 1.26
259438b4-244b-42ba-bc4d-00675ab9a280,2028-01-29,2028-01-31,Sainsbury's,5411,Groceries,Supermarket,-63.76,GBP,-95817.78,POS,London,GB,1045,user_001,,
e2838c60-6f0c-464e-b944-73f5ed8bfee9,2028-01-29,2028-01-31,Apple.com/bill,5734,Shopping,Electronics,-91.22,GBP,-95909.0,E-Com,Cupertino,US,4488,user_001,,
e6d8587a-1542-4476-b6f3-ad4dcd9ab6ab,2028-01-30,2028-01-31,Local Market,5499,Groceries,Specialty,-15.37,GBP,-95924.37,POS,London,GB,2219,user_001,,
169b2c46-60d1-4026-8463-bee55d00de6c,2028-01-31,2028-01-31,Waitrose,5411,Groceries,Supermarket,-88.13,GBP,-96012.5,POS,London,GB,4488,user_001,,
5e087b39-1982-4e5d-907a-661e7c1dd5be,2028-01-31,2028-01-31,Amazon UK,5942,Shopping,Online Retail,-50.37,GBP,-96062.87,E-Com,London,GB,1045,user_001,,
439af639-ecec-41cf-a3d1-bcb6e0a4680e,2028-02-01,2028-02-02,Uber UK,4121,Transport,Ride Hailing,-25.79,GBP,-96088.66,E-Com,London,GB,2219,user_001,,
f17fcc6c-37d8-4bcd-a9c8-17273c0ab02d,2028-02-01,2028-02-03,Shell,5541,Transport,Fuel,-69.38,GBP,-96158.04,POS,London,GB,1045,user_001,,
ff4e815c-85f8-4d96-bed8-72019e2fd541,2028-02-01,2028-02-01,Crown Estates Lettings,6513,Housing,Rent,-1601.98,GBP,-97760.02,POS,London,GB,1045,user_002,rec_fc2ae06846,
473fb60d-d1bb-4ad7-b9e1-1d5f45165999,2028-02-03,2028-02-04,Transport for London,4111,Transport,Transit,-7.08,GBP,-97767.1,POS,London,GB,9074,user_001,,
d60447a0-a3c8-4067-8190-08b34f6dbfb6,2028-02-03,2028-02-03,Deliveroo,5812,Food & Drink,Delivery,-23.79,GBP,-97790.89,E-Com,London,GB,1045,user_002,,
3a53eb59-d316-48a2-8eba-242f557a5896,2028-02-04,2028-02-07,Uber UK,4121,Transport,Ride Hailing,-12.04,GBP,-97802.93,E-Com,London,GB,9074,user_001,,
611cf1cc-1c23-4692-976d-5396f594ddf9,2028-02-04,2028-02-07,Waitrose,5411,Groceries,Supermarket,-39.01,GBP,-97841.94,POS,London,GB,2219,user_001,,
782eced5-6f22-4875-890b-13dc5e0d3f6c,2028-02-04,2028-02-07,Shell,5541,Transport,Fuel,-82.43,GBP,-97924.37,POS,London,GB,1045,user_001,,
0d385148-6266-4eaf-aeb7-e969618dad8c,2028-02-05,2028-02-07,Apple.com/bill,5734,Shopping,Electronics,-44.37,GBP,-97968.74,E-Com,Cupertino,US,9074,user_001,,
3614c556-3f8b-4215-872f-e128ac4543f4,2028-02-05,2028-02-07,Pret A Manger,5814,Food & Drink,Eating Out,-7.82,GBP,-97976.56,POS,London,GB,4488,user_001,,
3d4ffc13-0f27-4947-91a5-4be6bab22dff,2028-02-05,2028-02-07,Tesco,5411,Groceries,Supermarket,-20.95,GBP,-97997.51,POS,London,GB,1045,user_001,,
67599ccd-b0cd-46ae-9fc4-32b6d5f7f64a,2028-02-05,2028-02-07,Transport for London,4111,Transport,Transit,-4.67,GBP,-98002.18,POS,London,GB,9074,user_001,,
a9aa71d4-e448-42c7-a993-f0d4e61e1f9e,2028-02-05,2028-02-07,Shell,5541,Transport,Fuel,-31.46,GBP,-98033.64,POS,London,GB,9074,user_001,,
adb009b2-2c4e-4625-acd0-d05a59a484be,2028-02-05,2028-02-07,Amazon UK,5942,Shopping,Online Retail,-24.6,GBP,-98058.24,E-Com,London,GB,9074,user_001,,
eb4ab3e8-4de1-4057-bd74-5b1f89faa4cb,2028-02-05,2028-02-07,Uber UK,4121,Transport,Ride Hailing,-10.48,GBP,-98068.72,E-Com,London,GB,4488,user_002,,
fb6868bb-05b1-49c2-b015-86742b8e3fa4,2028-02-05,2028-02-07,Pret A Manger,5814,Food & Drink,Eating Out,-6.85,GBP,-98075.57,POS,London,GB,4488,user_001,,
fd3e7373-115e-4de4-9ae1-008fca6ad642,2028-02-05,2028-02-07,Tesco,5411,Groceries,Supermarket,-64.84,GBP,-98140.41,POS,London,GB,4488,user_002,,
1457824d-073d-4d1d-8217-36043b4e3ea8,2028-02-06,2028-02-08,Deliveroo,5812,Food & Drink,Delivery,-14.65,GBP,-98155.06,E-Com,London,GB,9074,user_001,,
64880fe7-32bd-4f7b-a077-98b804981bef,2028-02-06,2028-02-07,ATM Withdrawal,6011,Cash,ATM,-82.7,GBP,-98237.76,ATM,London,GB,9074,user_001,,
9af8453b-6985-4349-a6d9-3f461d0abfaf,2028-02-06,2028-02-07,Transport for London,4111,Transport,Transit,-7.3,GBP,-98245.06,POS,London,GB,4488,user_001,,
c36428ca-ea4d-4057-a450-32173655f1d2,2028-02-06,2028-02-08,Uber UK,4121,Transport,Ride Hailing,-35.97,GBP,-98281.03,E-Com,London,GB,1045,user_001,,
d65a09a3-16f9-44dd-b226-7478210c0c49,2028-02-06,2028-02-07,Deliveroo,5812,Food & Drink,Delivery,-14.23,GBP,-98295.26,E-Com,London,GB,9074,user_001,,
d7b0347d-197a-42bb-beee-ca9aef018c1e,2028-02-06,2028-02-07,Airline Refund,4511,Travel,Refund,41.4,GBP,-98253.86,Credit,London,GB,9074,user_001,,Refund for Sainsbury's
1bc09b21-3803-4d44-be9b-4907e43536bc,2028-02-07,2028-02-09,Waitrose,5411,Groceries,Supermarket,-65.23,GBP,-98319.09,POS,London,GB,2219,user_001,,
3139995c-b8b0-44c1-a779-fb8dfebe738b,2028-02-07,2028-02-09,Octopus Energy,4900,Utilities,Electricity,-129.27,GBP,-98448.36,Direct Debit,London,GB,2219,user_001,rec_141a4a0666,
ac20cb2e-d371-41ae-b44a-7da3886122a4,2028-02-07,2028-02-08,Transport for London,4111,Transport,Transit,-8.51,GBP,-98456.87,POS,London,GB,9074,user_001,,
5cdc3bcd-847c-411a-a657-6c36c8282e06,2028-02-08,2028-02-08,Transport for London,4111,Transport,Transit,-11.44,GBP,-98468.31,POS,London,GB,2219,user_002,,
81b46b41-07e1-430e-99a3-2c82a35cb357,2028-02-08,2028-02-08,Amazon UK,5942,Shopping,Online Retail,-106.47,GBP,-98574.78,E-Com,London,GB,2219,user_001,,
b66f9fe7-80c9-486b-ae37-8071f4a5438b,2028-02-08,2028-02-08,Shell,5541,Transport,Fuel,-60.71,GBP,-98635.49,POS,London,GB,9074,user_001,,
30d8d4b4-6b32-4c16-a946-19596faac303,2028-02-09,2028-02-09,Amazon UK,5942,Shopping,Online Retail,-107.32,GBP,-98742.81,E-Com,London,GB,9074,user_001,,
f0889751-c617-40fe-b001-3ed8aff97e38,2028-02-10,2028-02-14,Apple.com/bill,5734,Shopping,Electronics,-195.06,USD,-98937.87,E-Com,Cupertino,US,9074,user_001,,FX purchase 231.29 USD @ rate 1.19
365c2fbf-4e92-46c1-8109-f8c234106854,2028-02-11,2028-02-14,Thames Water,4900,Utilities,Water,-41.85,GBP,-98979.72,Direct Debit,Reading,GB,4488,user_001,rec_3a34d62842,
0ff3beb4-c8ce-4eaf-8666-1f32eaae0b36,2028-02-12,2028-02-14,Local Market,5499,Groceries,Specialty,-13.63,GBP,-98993.35,POS,London,GB,4488,user_001,,
12525295-a892-4572-b49a-85a4784d5312,2028-02-12,2028-02-14,Sainsbury's,5411,Groceries,Supermarket,-16.93,GBP,-99010.28,POS,London,GB,4488,user_002,,
34b4dcee-7192-4bea-9bb9-6ab7707b92b7,2028-02-12,2028-02-14,Pret A Manger,5814,Food & Drink,Eating Out,-10.61,GBP,-99020.89,POS,London,GB,1045,user_002,,
592e44f3-fcc1-4c51-8600-02ab63fc8e93,2028-02-12,2028-02-14,Waitrose,5411,Groceries,Supermarket,-50.07,GBP,-99070.96,POS,London,GB,1045,user_001,,
c70e3eb2-bfa4-413e-b545-31edd6df1702,2028-02-12,2028-02-14,Shell,5541,Transport,Fuel,-60.59,GBP,-99131.55,POS,London,GB,4488,user_001,,
1e6aeb46-d94c-44dd-80c6-a28876b87d6b,2028-02-13,2028-02-14,Waitrose,5411,Groceries,Supermarket,-80.16,GBP,-99211.71,POS,London,GB,2219,user_001,,
5c05e114-d908-4032-8501-fa7e313caa20,2028-02-13,2028-02-14,Pret A Manger,5814,Food & Drink,Eating Out,-5.67,GBP,-99217.38,POS,London,GB,1045,user_001,,
cb25875b-78e4-45a9-ab34-e7eba74a19eb,2028-02-13,2028-02-14,Transport for London,4111,Transport,Transit,-6.45,GBP,-99223.83,POS,London,GB,2219,user_001,,
1372c9e2-02d1-4386-b6f1-51b3a11334bb,2028-02-14,2028-02-16,Apple.com/bill,5734,Shopping,Electronics,-157.83,GBP,-99381.66,E-Com,Cupertino,US,1045,user_001,,
2ddc7a51-a9cb-43be-a12d-f5d6f8a3f6f6,2028-02-14,2028-02-16,City Council Tax,9399,Utilities,Council Tax,-155.34,GBP,-99537.0,Direct Debit,London,GB,9074,user_001,rec_f531495db5,
5fb7c074-3ec7-430f-9846-6f84e0a05d0f,2028-02-14,2028-02-14,Tesco,5411,Groceries,Supermarket,-82.43,GBP,-99619.43,POS,London,GB,1045,user_002,,
160f3575-c2bf-4ae6-9984-de7df6b2f98a,2028-02-15,2028-02-15,O2 UK,4814,Bills,Mobile,-54.27,GBP,-99673.7,Direct Debit,Slough,GB,2219,user_001,rec_95042d8101,
6ac9039a-e0b0-4aa6-b922-94ca29a16341,2028-02-16,2028-02-16,Uber UK,4121,Transport,Ride Hailing,-35.27,GBP,-99708.97,E-Com,London,GB,9074,user_002,,
11dac710-5e3f-4115-ba1c-bd695f8c15ed,2028-02-17,2028-02-18,GymBox,7997,Wellness,Gym,-54.27,GBP,-99763.24,Direct Debit,London,GB,1045,user_001,rec_3906953fd2,
bc458359-c307-40b0-8ad5-57fab0c04a1b,2028-02-17,2028-02-17,Shell,5541,Transport,Fuel,-91.35,GBP,-99854.59,POS,London,GB,4488,user_001,,
f8d5875d-7dae-4d1f-b8f4-41ed99c34661,2028-02-18,2028-02-18,Apple.com/bill,5734,Shopping,Electronics,-47.03,GBP,-99901.62,E-Com,Cupertino,US,2219,user_001,,
939376b5-6d95-4e41-a261-c335f13108b4,2028-02-19,2028-02-21,Shell,5541,Transport,Fuel,-88.86,GBP,-99990.48,POS,London,GB,4488,user_001,,
45c3a419-87fc-4d74-ada4-8a4c49b4ff6f,2028-02-20,2028-02-22,Sainsbury's,5411,Groceries,Supermarket,-16.8,GBP,-100007.28,POS,London,GB,4488,user_002,,
ab540306-f1d6-438a-91f6-21f79ea2c484,2028-02-20,2028-02-21,Tesco,5411,Groceries,Supermarket,-40.38,GBP,-100047.66,POS,London,GB,9074,user_001,,
2895599b-5a5b-463c-a7de-e6bae1514484,2028-02-21,2028-02-23,Netflix,7841,Entertainment,Subscriptions,-11.63,USD,-100059.29,E-Com,Los Gatos,US,4488,user_001,rec_1bfe33738d,FX purchase 14.17 USD @ rate 1.22
3c917291-ce69-4f44-8d38-2867dd2a90d2,2028-02-21,2028-02-22,Uber UK,4121,Transport,Ride Hailing,-27.03,GBP,-100086.32,E-Com,London,GB,9074,user_001,,
4b0a3e61-8969-4afc-9419-1a90f077b7dd,2028-02-21,2028-02-21,Pret A Manger,5814,Food & Drink,Eating Out,-8.08,GBP,-100094.4,POS,London,GB,9074,user_001,,
e060e42a-70d1-4f89-8d96-b1340d33c146,2028-02-21,2028-02-21,Waitrose,5411,Groceries,Supermarket,-21.37,GBP,-100115.77,POS,London,GB,9074,user_002,,
e9ddcd1e-c6d6-4706-a8fb-11a6b37eb847,2028-02-21,2028-02-22,Spotify,5735,Entertainment,Subscriptions,-8.7,GBP,-100124.47,E-Com,Stockholm,SE,9074,user_001,rec_4c746d2c3b,
3e51d815-fcc7-444d-90b1-4eefc995ed00,2028-02-22,2028-02-23,Shell,5541,Transport,Fuel,-30.09,GBP,-100154.56,POS,London,GB,9074,user_001,,
b90e9a4e-50e6-4754-822d-1b4284e55309,2028-02-22,2028-02-24,Waitrose,5411,Groceries,Supermarket,-85.01,GBP,-100239.57,POS,London,GB,4488,user_001,,
2343e0f3-495f-4dcd-9ede-6ef34a9ea226,2028-02-24,2028-02-28,Local Market,5499,Groceries,Specialty,-9.45,GBP,-100249.02,POS,London,GB,4488,user_001,,
314553bf-8f9f-46e1-ade3-60f0d051279e,2028-02-24,2028-02-25,Shell,5541,Transport,Fuel,-84.92,GBP,-100333.94,POS,London,GB,2219,user_001,,
4457282f-336f-4246-be65-78d79b5e02f1,2028-02-24,2028-02-24,HM Revenue & Customs,9311,Income,Tax Refund,4.4,GBP,-100329.54,Credit,London,GB,4488,user_001,,Refund for Transport for London
6046aa74-b3fc-42d3-b998-9978f6366c9c,2028-02-25,2028-02-28,Waitrose,5411,Groceries,Supermarket,-52.66,GBP,-100382.2,POS,London,GB,9074,user_001,,
749838b9-408f-46bb-98ac-451b07f4d472,2028-02-25,2028-02-25,T212 Capital,6011,Income,Salary,3429.46,GBP,-96952.74,Credit,London,GB,2219,user_001,rec_2ff8f778d0,
84dbf04a-aecf-44e9-bcdd-7bbd06acd901,2028-02-25,2028-02-28,Uber UK,4121,Transport,Ride Hailing,-22.06,GBP,-96974.8,E-Com,London,GB,2219,user_001,,
abb1f195-15bf-429a-9f7b-db49e798886d,2028-02-25,2028-02-28,ATM Withdrawal,6011,Cash,ATM,-112.75,GBP,-97087.55,ATM,London,GB,9074,user_001,,
0c3e905e-2b59-40f6-ba62-20061185efb6,2028-02-26,2028-02-28,Uber UK,4121,Transport,Ride Hailing,-15.99,GBP,-97103.54,E-Com,London,GB,4488,user_001,,
17d169dd-3e1f-4a88-9587-50a5a878fb04,2028-02-26,2028-02-28,Waitrose,5411,Groceries,Supermarket,-53.07,GBP,-97156.61,POS,London,GB,9074,user_001,,
ce0e2e3b-9b1c-476b-b8e6-e331f8e2f07e,2028-02-26,2028-02-28,Uber UK,4121,Transport,Ride Hailing,-33.03,GBP,-97189.64,E-Com,London,GB,4488,user_001,,
2c6d4d4e-ca1a-4075-86aa-75bd34944738,2028-02-27,2028-02-29,Sainsbury's,5411,Groceries,Supermarket,-62.82,GBP,-97252.46,POS,London,GB,4488,user_001,,
31940e0c-2709-4ae6-9fe0-ec97e67fde1c,2028-02-27,2028-02-29,Uber UK,4121,Transport,Ride Hailing,-35.52,GBP,-97287.98,E-Com,London,GB,4488,user_002,,
c1d762ea-6597-4d58-9650-a443cd04c0fc,2028-02-27,2028-02-29,Uber UK,4121,Transport,Ride Hailing,-23.15,GBP,-97311.13,E-Com,London,GB,9074,user_001,,
9a9d0647-c3ea-419e-950c-dc304e7a9232,2028-02-28,2028-03-01,Shell,5541,Transport,Fuel,-56.94,GBP,-97368.07,POS,London,GB,1045,user_001,,
9b3d819f-6749-4047-9776-db582b874a2c,2028-02-28,2028-02-29,Shell,5541,Transport,Fuel,-51.39,GBP,-97419.46,POS,London,GB,2219,user_002,,
120eb239-b94d-4480-96bf-ecb05c5b69c0,2028-02-29,2028-03-01,Uber UK,4121,Transport,Ride Hailing,-14.46,GBP,-97433.92,E-Com,London,GB,4488,user_001,,
87a1ee59-c3cf-473f-8358-a01bee35f525,2028-02-29,2028-02-29,Sainsbury's,5411,Groceries,Supermarket,-34.63,GBP,-97468.55,POS,London,GB,2219,user_002,,
180b02c7-97c4-465f-81de-b12420cb7e40,2028-03-01,2028-03-02,Crown Estates Lettings,6513,Housing,Rent,-1511.84,GBP,-98980.39,POS,London,GB,9074,user_001,rec_19f70fbcce,
80930f09-cecf-4a1e-9dbe-05355404b462,2028-03-02,2028-03-03,Tesco,5411,Groceries,Supermarket,-70.54,GBP,-99050.93,POS,London,GB,1045,user_001,,
0507e72c-c5a7-42f5-8d1e-1dd9ce568113,2028-03-03,2028-03-03,Apple.com/bill,5734,Shopping,Electronics,-56.84,USD,-99107.77,E-Com,Cupertino,US,9074,user_001,,FX purchase 69.77 USD @ rate 1.23
c5699f96-1c25-4de6-99ef-d02fd274bd81,2028-03-03,2028-03-06,Shell,5541,Transport,Fuel,-31.55,GBP,-99139.32,POS,London,GB,4488,user_002,,
00779263-2174-4996-ae2e-6109819e51da,2028-03-04,2028-03-06,Sainsbury's,5411,Groceries,Supermarket,-64.85,GBP,-99204.17,POS,London,GB,9074,user_001,,
041b93f1-991a-4aa4-88d7-fab0bee4d0e3,2028-03-04,2028-03-06,Apple.com/bill,5734,Shopping,Electronics,-124.2,USD,-99328.37,E-Com,Cupertino,US,1045,user_002,,FX purchase 153.17 USD @ rate 1.23
b44d18e8-b4aa-4f98-aee2-0ef05266913d,2028-03-04,2028-03-06,Transport for London,4111,Transport,Transit,-8.34,GBP,-99336.71,POS,London,GB,2219,user_001,,
e678f5f1-83d8-4b01-8556-e78dce8b124e,2028-03-04,2028-03-06,Waitrose,5411,Groceries,Supermarket,-21.87,GBP,-99358.58,POS,London,GB,1045,user_002,,
5882af1e-ed04-4716-a4df-3a735860b632,2028-03-05,2028-03-06,Amazon UK,5942,Shopping,Online Retail,-84.91,GBP,-99443.49,E-Com,London,GB,9074,user_001,,
8115ff3e-55d7-49bc-8f36-d50a679f6e4e,2028-03-05,2028-03-06,Sainsbury's,5411,Groceries,Supermarket,-38.7,GBP,-99482.19,POS,London,GB,4488,user_001,,
89cef528-3552-4aba-8da0-2504edc1c3f4,2028-03-05,2028-03-07,Sainsbury's,5411,Groceries,Supermarket,-19.72,GBP,-99501.91,POS,London,GB,1045,user_001,,
d9b2fc3d-f033-4928-bbdb-1fc8f8a1ea91,2028-03-06,2028-03-08,Transport for London,4111,Transport,Transit,-8.53,GBP,-99510.44,POS,London,GB,2219,user_002,,
f6989030-f7af-4431-b63a-092270c1fa21,2028-03-06,2028-03-08,Local Market,5499,Groceries,Specialty,-20.91,GBP,-99531.35,POS,London,GB,9074,user_001,,
19ac1e1b-f650-42c4-9a28-c54cba64b222,2028-03-07,2028-03-07,Octopus Energy,4900,Utilities,Electricity,-118.84,GBP,-99650.19,Direct Debit,London,GB,9074,user_001,rec_141a4a0666,
3541d8f3-c49b-4fa2-865b-fad97b956793,2028-03-07,2028-03-07,Waitrose,5411,Groceries,Supermarket,-29.21,GBP,-99679.4,POS,London,GB,4488,user_002,,
7d108119-d639-4455-957c-21fd97e862e9,2028-03-07,2028-03-09,Amazon UK,5942,Shopping,Online Retail,-78.41,GBP,-99757.81,E-Com,London,GB,9074,user_001,,
df12a0a3-1808-4474-9443-098b76ff30d3,2028-03-08,2028-03-09,Shell,5541,Transport,Fuel,-40.34,GBP,-99798.15,POS,London,GB,2219,user_001,,
e2421aae-8d58-4884-8f2b-aeeb92045e0b,2028-03-08,2028-03-09,Local Market,5499,Groceries,Specialty,-21.94,GBP,-99820.09,POS,London,GB,1045,user_001,,
63b499e2-f7d4-42be-ab70-c3c894e073c3,2028-03-09,2028-03-10,Waitrose,5411,Groceries,Supermarket,-80.62,GBP,-99900.71,POS,London,GB,9074,user_001,,
be76776e-9953-40be-9c1c-09740e83b835,2028-03-09,2028-03-10,Uber UK,4121,Transport,Ride Hailing,-8.26,GBP,-99908.97,E-Com,London,GB,9074,user_001,,
fb876e1f-5ccb-4098-99e0-d7248dc701ce,2028-03-09,2028-03-10,Shell,5541,Transport,Fuel,-45.86,GBP,-99954.83,POS,London,GB,9074,user_002,,
0ce44eba-e21a-41ba-ba3e-f5d7b753a212,2028-03-10,2028-03-13,Pret A Manger,5814,Food & Drink,Eating Out,-7.98,GBP,-99962.81,POS,London,GB,9074,user_001,,
4d7b13c2-f918-4cc9-b624-57f5317837da,2028-03-10,2028-03-13,Waitrose,5411,Groceries,Supermarket,-78.52,GBP,-100041.33,POS,London,GB,4488,user_001,,
0bc3bb5f-2469-4990-aa7a-27f18a9200f7,2028-03-11,2028-03-13,Sainsbury's,5411,Groceries,Supermarket,-22.79,GBP,-100064.12,POS,London,GB,1045,user_001,,
395942be-21b9-435d-a82d-f69386e14482,2028-03-11,2028-03-13,Uber UK,4121,Transport,Ride Hailing,-33.66,GBP,-100097.78,E-Com,London,GB,2219,user_001,,
3dc14402-bdc3-4dc0-85b0-96f66e1fb4c5,2028-03-11,2028-03-13,Shell,5541,Transport,Fuel,-46.96,GBP,-100144.74,POS,London,GB,4488,user_001,,
b10c50b9-8d69-42d2-84df-339c3ea9c288,2028-03-11,2028-03-13,Shell,5541,Transport,Fuel,-75.17,GBP,-100219.91,POS,London,GB,9074,user_001,,
2d4b5131-77b2-452c-a75b-d9f7e19badca,2028-03-12,2028-03-14,Transport for London,4111,Transport,Transit,-5.12,GBP,-100225.03,POS,London,GB,9074,user_002,,
39d2f419-976c-4a54-bd59-837b5660ff5f,2028-03-12,2028-03-13,Local Market,5499,Groceries,Specialty,-11.66,GBP,-100236.69,POS,London,GB,1045,user_001,,
9202bc39-8c83-49d6-851c-89b70d30b2de,2028-03-12,2028-03-14,Uber UK,4121,Transport,Ride Hailing,-17.96,GBP,-100254.65,E-Com,London,GB,4488,user_001,,
ede92300-ae85-42d5-9810-1af399c93bf4,2028-03-12,2028-03-13,Tesco,5411,Groceries,Supermarket,-28.83,GBP,-100283.48,POS,London,GB,1045,user_001,,
fc1d8274-59e5-4f14-abbf-f49409f0217f,2028-03-12,2028-03-14,Local Market,5499,Groceries,Specialty,-12.61,GBP,-100296.09,POS,London,GB,4488,user_002,,
15091cc0-af43-4a4e-82c0-885556a9b91d,2028-03-13,2028-03-15,Apple.com/bill,5734,Shopping,Electronics,-34.34,GBP,-100330.43,E-Com,Cupertino,US,1045,user_001,,
597e2f41-7413-4735-b039-4c256a0b67bb,2028-03-13,2028-03-13,City Council Tax,9399,Utilities,Council Tax,-188.29,GBP,-100518.72,Direct Debit,London,GB,1045,user_002,rec_6feaa5d43f,
94292dca-e12b-4050-a097-c9f7c23f0c57,2028-03-13,2028-03-14,Thames Water,4900,Utilities,Water,-36.48,GBP,-100555.2,Direct Debit,Reading,GB,2219,user_001,rec_3a34d62842,
964b6078-894a-4ffd-9423-892da07bbf91,2028-03-13,2028-03-14,Shell,5541,Transport,Fuel,-89.2,GBP,-100644.4,POS,London,GB,9074,user_002,,
9e702b25-f783-4d7d-8577-515f92f13c32,2028-03-13,2028-03-14,Amazon UK,5942,Shopping,Online Retail,-59.48,GBP,-100703.88,E-Com,London,GB,4488,user_001,,
4b5fa97f-be9c-42cf-9b03-aa7ab63415e7,2028-03-14,2028-03-15,Transport for London,4111,Transport,Transit,-10.96,GBP,-100714.84,POS,London,GB,1045,user_001,,
9c30eea2-f28b-4521-82b2-125dd3787f7d,2028-03-15,2028-03-17,O2 UK,4814,Bills,Mobile,-47.05,GBP,-100761.89,Direct Debit,Slough,GB,4488,user_002,rec_d2dce4c42f,
b0d2dcc0-ae7c-4059-bae1-6bd295423e0c,2028-03-15,2028-03-17,Amazon UK,5942,Shopping,Online Retail,-82.59,GBP,-100844.48,E-Com,London,GB,4488,user_001,,
ca6256a6-da96-4438-96e1-563b28eca5ee,2028-03-15,2028-03-16,Waitrose,5411,Groceries,Supermarket,-66.44,GBP,-100910.92,POS,London,GB,4488,user_001,,
0aa22f72-d3fa-4978-a690-91ac264290c8,2028-03-16,2028-03-16,Tesco,5411,Groceries,Supermarket,-59.71,GBP,-100970.63,POS,London,GB,2219,user_001,,
5d57dd43-56c4-42a1-9ec7-d30f4524d1f8,2028-03-16,2028-03-16,Sainsbury's,5411,Groceries,Supermarket,-63.89,GBP,-101034.52,POS,London,GB,2219,user_001,,
1da52314-d863-4357-81bf-c70aa0124410,2028-03-17,2028-03-20,Local Market,5499,Groceries,Specialty,-13.91,GBP,-101048.43,POS,London,GB,9074,user_001,,
504e7c9d-a3c6-47e0-994f-201c1b535350,2028-03-17,2028-03-20,GymBox,7997,Wellness,Gym,-63.51,GBP,-101111.94,Direct Debit,London,GB,9074,user_001,rec_3906953fd2,
444e8f0b-e24c-4204-ba4c-3b6d1c790508,2028-03-18,2028-03-20,Deliveroo,5812,Food & Drink,Delivery,-15.64,GBP,-101127.58,E-Com,London,GB,9074,user_001,,
aa1ff5ce-2667-48c5-b5b3-934e01082fc5,2028-03-18,2028-03-20,Sainsbury's,5411,Groceries,Supermarket,-49.69,GBP,-101177.27,POS,London,GB,2219,user_002,,
1b16d4d1-a046-4b5b-a2e8-09b7258d733a,2028-03-19,2028-03-21,Sainsbury's,5411,Groceries,Supermarket,-40.91,GBP,-101218.18,POS,London,GB,1045,user_002,,
547a5b60-32d4-4eda-a3dc-442bbe14c2d0,2028-03-19,2028-03-20,Transport for London,4111,Transport,Transit,-4.64,GBP,-101222.82,POS,London,GB,9074,user_002,,
7aa15d88-8059-4a90-80ae-61cdbae3fa65,2028-03-19,2028-03-20,Shell,5541,Transport,Fuel,-93.5,GBP,-101316.32,POS,London,GB,4488,user_002,,
e5078507-8f72-4049-a464-eef742118d7b,2028-03-19,2028-03-20,Deliveroo,5812,Food & Drink,Delivery,-13.46,GBP,-101329.78,E-Com,London,GB,9074,user_001,,
3f1c4fad-92ef-4ff2-8c3a-d48f50a490b3,2028-03-20,2028-03-21,Spotify,5735,Entertainment,Subscriptions,-9.4,GBP,-101339.18,E-Com,Stockholm,SE,2219,user_002,rec_34b6e9e33f,
3451cd14-d269-4637-94b3-b3ac742eefc0,2028-03-21,2028-03-23,Uber UK,4121,Transport,Ride Hailing,-28.7,GBP,-101367.88,E-Com,London,GB,4488,user_001,,
6fb89e26-08aa-476f-8883-db6acc86ed97,2028-03-21,2028-03-22,Netflix,7841,Entertainment,Subscriptions,-11.3,GBP,-101379.18,E-Com,Los Gatos,US,1045,user_001,rec_1bfe33738d,
a704ceeb-c6fc-455d-9db7-9cc33c34a224,2028-03-21,2028-03-21,Airbnb,7011,Travel,Accommodation,-261.68,EUR,-101640.86,E-Com,Dublin,IE,2219,user_001,,Holiday booking
9ced99fb-2ad5-46c2-a726-f5d82ebc44f1,2028-03-22,2028-03-23,Apple.com/bill,5734,Shopping,Electronics,-197.48,GBP,-101838.34,E-Com,Cupertino,US,9074,user_001,,
acb1358c-b587-4a82-9fdc-9c22917b0ddb,2028-03-22,2028-03-22,Shell,5541,Transport,Fuel,-48.67,GBP,-101887.01,POS,London,GB,2219,user_001,,
d2335afc-7355-4306-9693-0ea49a773c5b,2028-03-22,2028-03-24,Apple.com/bill,5734,Shopping,Electronics,-127.2,GBP,-102014.21,E-Com,Cupertino,US,1045,user_001,,
e8c83e35-f699-4b71-822b-097bdc095a15,2028-03-22,2028-03-22,Deliveroo,5812,Food & Drink,Delivery,-31.36,GBP,-102045.57,E-Com,London,GB,9074,user_001,,
4c6484c6-5eb2-4172-a656-f5843fbbf3a3,2028-03-23,2028-03-23,Shell,5541,Transport,Fuel,-92.78,GBP,-102138.35,POS,London,GB,9074,user_001,,
c8b0f7c2-af8d-4977-aa2e-10b0b9769b26,2028-03-23,2028-03-23,Shell,5541,Transport,Fuel,-77.27,GBP,-102215.62,POS,London,GB,4488,user_001,,
73ef500e-8a22-4c4e-a585-7d76f94b13ec,2028-03-24,2028-03-24,T212 Capital,6011,Income,Salary,3290.53,GBP,-98925.09,Credit,London,GB,2219,user_001,rec_2ff8f778d0,
86a1283f-72d9-4ff0-89db-5e22a1e50357,2028-03-24,2028-03-27,Apple.com/bill,5734,Shopping,Electronics,-189.5,GBP,-99114.59,E-Com,Cupertino,US,9074,user_001,,
b6cb2792-eec1-428d-994d-3a49eb7f821f,2028-03-24,2028-03-27,Tesco,5411,Groceries,Supermarket,-34.11,GBP,-99148.7,POS,London,GB,9074,user_001,,
981a302e-e24a-486c-90f1-fcc3c8186411,2028-03-25,2028-03-27,Transport for London,4111,Transport,Transit,-6.35,GBP,-99155.05,POS,London,GB,2219,user_001,,
302c8ed6-d7d2-45ff-a0dc-02bba58fb690,2028-03-26,2028-03-27,Uber UK,4121,Transport,Ride Hailing,-11.69,GBP,-99166.74,E-Com,London,GB,2219,user_001,,
dee8e975-83f9-4c3d-8a8e-6400941e4740,2028-03-26,2028-03-27,Deliveroo,5812,Food & Drink,Delivery,-25.31,GBP,-99192.05,E-Com,London,GB,2219,user_001,,
12f3b466-bca8-4a94-8cd4-a713424e14d8,2028-03-27,2028-03-27,Deliveroo,5812,Food & Drink,Delivery,-25.92,GBP,-99217.97,E-Com,London,GB,1045,user_002,,
248b7d47-bda3-42d0-b30e-647907fe4e70,2028-03-27,2028-03-27,Pret A Manger,5814,Food & Drink,Eating Out,-7.52,GBP,-99225.49,POS,London,GB,9074,user_002,,
57c7aaa9-eaee-4c6f-9263-e7bac7998121,2028-03-27,2028-03-28,Deliveroo,5812,Food & Drink,Delivery,-13.47,GBP,-99238.96,E-Com,London,GB,2219,user_001,,
9d35982d-e13b-43a4-bd30-73695fc0b0fe,2028-03-27,2028-03-29,Pret A Manger,5814,Food & Drink,Eating Out,-8.47,GBP,-99247.43,POS,London,GB,9074,user_002,,
bb862427-6d18-44b2-865a-1e9c221b70af,2028-03-27,2028-03-29,Transport for London,4111,Transport,Transit,-11.21,GBP,-99258.64,POS,London,GB,1045,user_001,,
db8a9afc-c5d0-4940-956a-fcf578ca546b,2028-03-27,2028-03-27,Shell,5541,Transport,Fuel,-79.75,GBP,-99338.39,POS,London,GB,1045,user_002,,
1ddf2885-d4cc-4ac7-ad32-164dc533109b,2028-03-28,2028-03-29,Amazon UK,5942,Shopping,Online Retail,-31.59,GBP,-99369.98,E-Com,London,GB,9074,user_001,,
be4ef281-53fd-4d37-9cd4-d6562b634f4d,2028-03-28,2028-03-29,Pret A Manger,5814,Food & Drink,Eating Out,-9.94,GBP,-99379.92,POS,London,GB,1045,user_002,,
8f1d056d-3fe8-43b4-84b4-e810d4b7528b,2028-03-29,2028-03-29,Amazon UK,5942,Shopping,Online Retail,-20.07,GBP,-99399.99,E-Com,London,GB,4488,user_002,,
fd1ce287-a346-46cc-bd93-358657dbe8b6,2028-03-29,2028-03-29,Airline Refund,4511,Travel,Refund,8.52,GBP,-99391.47,Credit,London,GB,9074,user_001,,Refund for Netflix
90d859b7-e7c0-4c52-bdcb-450f7eaedef9,2028-03-30,2028-03-31,Apple.com/bill,5734,Shopping,Electronics,-77.23,GBP,-99468.7,E-Com,Cupertino,US,4488,user_001,,
a5f00de1-8d34-46ae-a663-a2dd82ab64f3,2028-03-30,2028-03-31,Pret A Manger,5814,Food & Drink,Eating Out,-6.34,GBP,-99475.04,POS,London,GB,1045,user_001,,
dca7270c-0bb4-439c-8ce6-dcd359c96431,2028-03-30,2028-03-30,Local Market,5499,Groceries,Specialty,-12.58,GBP,-99487.62,POS,London,GB,1045,user_001,,
fb91f0a9-c1d1-4560-b685-deb64f7e89d6,2028-03-30,2028-03-30,Deliveroo,5812,Food & Drink,Delivery,-33.62,GBP,-99521.24,E-Com,London,GB,9074,user_001,,
27ee012a-e68e-4b3b-a158-340af98bba31,2028-04-01,2028-04-03,Pret A Manger,5814,Food & Drink,Eating Out,-7.45,GBP,-99528.69,POS,London,GB,1045,user_002,,
3268a805-cdb6-4657-81e9-8b718e9db7ae,2028-04-01,2028-04-03,Tesco,5411,Groceries,Supermarket,-67.33,GBP,-99596.02,POS,London,GB,2219,user_001,,
802d1611-305e-4276-9cc3-08fdf2b3b2a5,2028-04-01,2028-04-03,Apple.com/bill,5734,Shopping,Electronics,-164.63,GBP,-99760.65,E-Com,Cupertino,US,2219,user_001,,
a89911a3-0048-47bc-a86f-6446c2232a4a,2028-04-01,2028-04-03,ATM Withdrawal,6011,Cash,ATM,-91.06,GBP,-99851.71,ATM,London,GB,2219,user_001,,
c52148a5-b233-4458-8981-4f282476261c,2028-04-01,2028-04-03,Amazon UK,5942,Shopping,Online Retail,-59.58,GBP,-99911.29,E-Com,London,GB,9074,user_001,,
01fd84c2-a6af-4319-82bb-474f28f605cf,2028-04-02,2028-04-04,Tesco,5411,Groceries,Supermarket,-30.58,GBP,-99941.87,POS,London,GB,1045,user_002,,
0d077e96-9aab-4aa4-bd91-14d79b0ba48f,2028-04-02,2028-04-04,Apple.com/bill,5734,Shopping,Electronics,-75.15,GBP,-100017.02,E-Com,Cupertino,US,9074,user_001,,
82cb020a-d9e9-4703-8db9-af8448a67edb,2028-04-02,2028-04-03,Sainsbury's,5411,Groceries,Supermarket,-33.4,GBP,-100050.42,POS,London,GB,9074,user_001,,
875c0e81-5fc9-45fb-88c6-a299cfee1a40,2028-04-02,2028-04-03,Local Market,5499,Groceries,Specialty,-16.75,GBP,-100067.17,POS,London,GB,4488,user_001,,
c70d1f6e-d4e3-44b8-a576-8ddef18318ca,2028-04-02,2028-04-03,Amazon UK,5942,Shopping,Online Retail,-28.87,GBP,-100096.04,E-Com,London,GB,2219,user_001,,
e9b1bbd4-a2a6-47ed-9e16-e9b992594e58,2028-04-02,2028-04-04,Pret A Manger,5814,Food & Drink,Eating Out,-7.69,GBP,-100103.73,POS,London,GB,9074,user_001,,
c1725751-a212-4121-a6fd-5a6e25e6f7b2,2028-04-03,2028-04-05,Sainsbury's,5411,Groceries,Supermarket,-67.51,GBP,-100171.24,POS,London,GB,9074,user_001,,
c71502bd-0726-476c-b7ca-2d9ef8ac5e11,2028-04-03,2028-04-03,Crown Estates Lettings,6513,Housing,Rent,-1539.62,GBP,-101710.86,POS,London,GB,1045,user_001,rec_19f70fbcce,
fd06c406-6fc7-41a3-991b-1f919d5c8b91,2028-04-03,2028-04-05,Local Market,5499,Groceries,Specialty,-21.0,GBP,-101731.86,POS,London,GB,2219,user_001,,
626cd352-7409-43e2-991b-e703bddd0eac,2028-04-04,2028-04-06,Tesco,5411,Groceries,Supermarket,-22.89,GBP,-101754.75,POS,London,GB,9074,user_001,,
1ca8db99-d06f-424a-90fe-31b25e23f2ef,2028-04-05,2028-04-06,Sainsbury's,5411,Groceries,Supermarket,-58.23,GBP,-101812.98,POS,London,GB,4488,user_001,,
3526a210-2e59-4957-8b7a-25ac6ce0c17a,2028-04-05,2028-04-07,Apple.com/bill,5734,Shopping,Electronics,-51.29,USD,-101864.27,E-Com,Cupertino,US,2219,user_001,,FX purchase 64.82 USD @ rate 1.26
6ca56cc4-2b36-4469-b8f3-1513e3fbb680,2028-04-05,2028-04-06,Tesco,5411,Groceries,Supermarket,-41.8,GBP,-101906.07,POS,London,GB,4488,user_001,,
273f011c-46cc-4fcd-b362-c1de929564ad,2028-04-06,2028-04-06,Uber UK,4121,Transport,Ride Hailing,-18.89,GBP,-101924.96,E-Com,London,GB,4488,user_001,,
2952fc4b-d058-4f0c-87b5-721b51e48f69,2028-04-06,2028-04-07,Transport for London,4111,Transport,Transit,-9.7,GBP,-101934.66,POS,London,GB,9074,user_001,,
43763029-5a66-47a3-a5ff-34e75ff66514,2028-04-06,2028-04-06,Tesco,5411,Groceries,Supermarket,-62.62,GBP,-101997.28,POS,London,GB,4488,user_001,,
4a8c324b-5516-48eb-ab65-c1313d42b5cc,2028-04-06,2028-04-06,Pret A Manger,5814,Food & Drink,Eating Out,-11.31,GBP,-102008.59,POS,London,GB,1045,user_001,,
7c440580-eea9-4c98-81a2-6e5e09639821,2028-04-06,2028-04-10,Tesco,5411,Groceries,Supermarket,-60.85,GBP,-102069.44,POS,London,GB,2219,user_001,,
a9da3ef2-b050-420b-a3a0-9cebd04ba70f,2028-04-06,2028-04-06,Deliveroo,5812,Food & Drink,Delivery,-26.4,GBP,-102095.84,E-Com,London,GB,2219,user_002,,
fd0f7f10-fb4e-458e-991a-629411e91906,2028-04-06,2028-04-07,Local Market,5499,Groceries,Specialty,-17.19,GBP,-102113.03,POS,London,GB,2219,user_002,,
2189faf8-6c90-461c-8ed8-79af4a7c42a9,2028-04-07,2028-04-10,Octopus Energy,4900,Utilities,Electricity,-122.83,GBP,-102235.86,Direct Debit,London,GB,4488,user_001,rec_141a4a0666,
1771615a-d242-4ede-9b7b-75616366a9b3,2028-04-08,2028-04-10,Transport for London,4111,Transport,Transit,-9.78,GBP,-102245.64,POS,London,GB,1045,user_001,,
39dd6360-36e0-46aa-ade8-d6f00818eb2b,2028-04-08,2028-04-10,Apple.com/bill,5734,Shopping,Electronics,-118.81,GBP,-102364.45,E-Com,Cupertino,US,1045,user_001,,
bc6642f4-224a-435d-9879-935d0483dd0e,2028-04-08,2028-04-10,Sainsbury's,5411,Groceries,Supermarket,-60.34,GBP,-102424.79,POS,London,GB,9074,user_001,,
e702089c-f2e5-48f7-8b46-828850e8c895,2028-04-08,2028-04-10,Waitrose,5411,Groceries,Supermarket,-42.08,GBP,-102466.87,POS,London,GB,9074,user_001,,
42275fb1-ac93-4f2e-95df-8b4b7c6eed28,2028-04-09,2028-04-11,Transport for London,4111,Transport,Transit,-9.79,GBP,-102476.66,POS,London,GB,2219,user_002,,
9625847f-cb74-4002-a2fa-78d1b8ca9fa7,2028-04-09,2028-04-10,Local Market,5499,Groceries,Specialty,-14.25,GBP,-102490.91,POS,London,GB,2219,user_001,,
9d78a68e-ffed-4d5d-a6fb-8acc331a17e9,2028-04-09,2028-04-10,Transport for London,4111,Transport,Transit,-5.57,GBP,-102496.48,POS,London,GB,9074,user_001,,
04c94833-6271-48e9-babb-bf433ba3ed2a,2028-04-10,2028-04-10,Sainsbury's,5411,Groceries,Supermarket,-65.52,GBP,-102562.0,POS,London,GB,1045,user_001,,
134a5b2f-fccc-4ec1-b359-e2340346e8cd,2028-04-10,2028-04-10,Tesco,5411,Groceries,Supermarket,-56.32,GBP,-102618.32,POS,London,GB,1045,user_001,,
16b2a5b0-b737-4cfe-a32f-379c081abbc8,2028-04-10,2028-04-10,ATM Withdrawal,6011,Cash,ATM,-96.38,GBP,-102714.7,ATM,London,GB,1045,user_001,,
77615a89-490c-4496-9be2-9ff4ee3469f9,2028-04-11,2028-04-11,Uber UK,4121,Transport,Ride Hailing,-19.16,GBP,-102733.86,E-Com,London,GB,1045,user_001,,
931e830a-968a-4537-92cd-49673160c308,2028-04-11,2028-04-12,Thames Water,4900,Utilities,Water,-33.07,GBP,-102766.93,Direct Debit,Reading,GB,2219,user_002,rec_954d02400c,
ce1e1fce-b387-404e-b92c-d43dfa38fefb,2028-04-12,2028-04-12,Sainsbury's,5411,Groceries,Supermarket,-22.85,GBP,-102789.78,POS,London,GB,1045,user_001,,
fa51ff46-ba05-463d-aa4d-2efecd75ef0a,2028-04-12,2028-04-13,Shell,5541,Transport,Fuel,-80.17,GBP,-102869.95,POS,London,GB,9074,user_001,,
04ebc243-5b5a-41e9-ba08-fe986034316e,2028-04-13,2028-04-13,City Council Tax,9399,Utilities,Council Tax,-176.73,GBP,-103046.68,Direct Debit,London,GB,9074,user_002,rec_6feaa5d43f,
4598e70a-76ba-4557-bb9e-cba84adcc2e6,2028-04-14,2028-04-14,Tesco,5411,Groceries,Supermarket,-19.48,GBP,-103066.16,POS,London,GB,9074,user_001,,
5d535699-3426-4a9d-a987-810180f4d095,2028-04-14,2028-04-17,Shell,5541,Transport,Fuel,-91.03,GBP,-103157.19,POS,London,GB,4488,user_001,,
dab9494d-500c-435f-88d4-b5bd8c5872a3,2028-04-15,2028-04-17,Pret A Manger,5814,Food & Drink,Eating Out,-10.38,GBP,-103167.57,POS,London,GB,9074,user_001,,
4e6e74d2-f27f-40e8-a8f7-f4cdf3700ded,2028-04-16,2028-04-18,Deliveroo,5812,Food & Drink,Delivery,-13.17,GBP,-103180.74,E-Com,London,GB,1045,user_001,,
98c56944-5d8c-43cb-b255-7c1b0d47b04f,2028-04-16,2028-04-17,Tesco,5411,Groceries,Supermarket,-39.11,GBP,-103219.85,POS,London,GB,9074,user_001,,
9d945315-9d12-4481-9080-598e2c1cde84,2028-04-16,2028-04-17,Amazon UK,5942,Shopping,Online Retail,-77.19,GBP,-103297.04,E-Com,London,GB,1045,user_001,,
09ed4086-a3a7-45d2-9fd6-f464aa1acdbb,2028-04-17,2028-04-18,O2 UK,4814,Bills,Mobile,-35.6,GBP,-103332.64,Direct Debit,Slough,GB,2219,user_001,rec_95042d8101,
33268360-a4ea-4f5d-bbd4-ed52cad91a89,2028-04-17,2028-04-19,GymBox,7997,Wellness,Gym,-50.09,GBP,-103382.73,Direct Debit,London,GB,4488,user_001,rec_3906953fd2,
b3ed8cf8-fecb-4c34-b8be-1647cf0d3d16,2028-04-17,2028-04-18,Uber UK,4121,Transport,Ride Hailing,-14.93,GBP,-103397.66,E-Com,London,GB,4488,user_001,,
2064560f-18e4-4375-a9e7-ab1a52422401,2028-04-19,2028-04-20,Spotify,5735,Entertainment,Subscriptions,-9.87,GBP,-103407.53,E-Com,Stockholm,SE,9074,user_001,rec_4c746d2c3b,
43a96578-3d79-4b66-9592-cb56f6db2cf8,2028-04-20,2028-04-24,Waitrose,5411,Groceries,Supermarket,-65.59,GBP,-103473.12,POS,London,GB,4488,user_001,,
6e427cb1-5d48-446a-b7ad-6d660697eb43,2028-04-21,2028-04-21,Netflix,7841,Entertainment,Subscriptions,-12.53,USD,-103485.65,E-Com,Los Gatos,US,9074,user_001,rec_1bfe33738d,FX purchase 15.2 USD @ rate 1.21
8a278f3d-a8fc-4f85-b96d-9794e3d11acb,2028-04-21,2028-04-24,Deliveroo,5812,Food & Drink,Delivery,-22.38,GBP,-103508.03,E-Com,London,GB,1045,user_001,,
2fe2b60a-9dfc-494a-9344-893b1bdd1651,2028-04-22,2028-04-24,Local Market,5499,Groceries,Specialty,-19.06,GBP,-103527.09,POS,London,GB,4488,user_001,,
8cb41a49-8493-47aa-831c-0b2deee4497a,2028-04-22,2028-04-24,Shell,5541,Transport,Fuel,-74.72,GBP,-103601.81,POS,London,GB,4488,user_001,,
bac638ec-ec39-4ec0-9ec3-c26e4036cabd,2028-04-22,2028-04-24,Shell,5541,Transport,Fuel,-69.72,GBP,-103671.53,POS,London,GB,4488,user_001,,
e504f122-4970-477a-9e4f-6cd6e84c37ec,2028-04-22,2028-04-24,Amazon UK,5942,Shopping,Online Retail,-115.76,GBP,-103787.29,E-Com,London,GB,1045,user_001,,
43a1ab33-a085-4bdc-9365-ffc257e5e489,2028-04-23,2028-04-25,Tesco,5411,Groceries,Supermarket,-77.16,GBP,-103864.45,POS,London,GB,9074,user_001,,
1cd21eeb-cc4e-4e81-8968-059ae21545f5,2028-04-24,2028-04-26,Tesco,5411,Groceries,Supermarket,-59.22,GBP,-103923.67,POS,London,GB,4488,user_001,,
d84d079e-4a1a-4897-b143-1a6093dbd1b9,2028-04-24,2028-04-24,Waitrose,5411,Groceries,Supermarket,-81.22,GBP,-104004.89,POS,London,GB,2219,user_001,,
f02e910e-66d8-48b9-84d1-03b0ccc6be92,2028-04-24,2028-04-25,ATM Withdrawal,6011,Cash,ATM,-105.29,GBP,-104110.18,ATM,London,GB,2219,user_001,,
12697ad9-0da1-49b2-b378-853e93bd363f,2028-04-25,2028-04-25,T212 Capital,6011,Income,Salary,3374.26,GBP,-100735.92,Credit,London,GB,2219,user_001,rec_2ff8f778d0,
6c00c6aa-4124-4f52-b527-b4ecec2d859e,2028-04-25,2028-04-25,Local Market,5499,Groceries,Specialty,-10.34,GBP,-100746.26,POS,London,GB,9074,user_001,,
ae821765-a4f1-4c70-ba2d-b26f4bee93af,2028-04-25,2028-04-25,Pret A Manger,5814,Food & Drink,Eating Out,-8.94,GBP,-100755.2,POS,London,GB,1045,user_002,,
d6ddff6d-4afb-4ca1-93d4-b910ebfceb48,2028-04-25,2028-04-25,Local Market,5499,Groceries,Specialty,-16.01,GBP,-100771.21,POS,London,GB,4488,user_001,,
253f1a52-a20a-4ead-886a-5dfe36c68607,2028-04-26,2028-04-28,Deliveroo,5812,Food & Drink,Delivery,-28.88,GBP,-100800.09,E-Com,London,GB,2219,user_001,,
2d00b3e0-9c62-42e9-a943-3ef590ddf3e0,2028-04-26,2028-04-27,Sainsbury's,5411,Groceries,Supermarket,-52.87,GBP,-100852.96,POS,London,GB,1045,user_001,,
32c5a70c-ff63-4917-a0c9-ac406fad4b68,2028-04-26,2028-04-28,Waitrose,5411,Groceries,Supermarket,-88.32,GBP,-100941.28,POS,London,GB,2219,user_001,,
581bff5c-eee6-483c-b34d-48d0256ae7d5,2028-04-26,2028-04-27,Waitrose,5411,Groceries,Supermarket,-23.45,GBP,-100964.73,POS,London,GB,2219,user_001,,
ee6bf7ab-0d30-4385-a224-6ea6930fd8d4,2028-04-26,2028-04-27,Apple.com/bill,5734,Shopping,Electronics,-20.83,GBP,-100985.56,E-Com,Cupertino,US,1045,user_001,,
354d3043-ad2b-491b-bc1e-6b7da2278007,2028-04-29,2028-05-01,Amazon UK,5942,Shopping,Online Retail,-54.7,GBP,-101040.26,E-Com,London,GB,1045,user_001,,
5ea5e0f4-047b-46ec-823e-1c5209f69aec,2028-04-29,2028-05-01,Waitrose,5411,Groceries,Supermarket,-73.16,GBP,-101113.42,POS,London,GB,2219,user_001,,
7b251133-66ca-40b1-ae44-f0b40c110029,2028-04-29,2028-05-01,Pret A Manger,5814,Food & Drink,Eating Out,-11.96,GBP,-101125.38,POS,London,GB,4488,user_001,,
b39bca0d-5c1e-4612-a632-a35f40cbc347,2028-04-29,2028-05-01,Waitrose,5411,Groceries,Supermarket,-83.05,GBP,-101208.43,POS,London,GB,2219,user_002,,
d56f2e8a-0b96-4164-8639-96bdb32eefa7,2028-04-29,2028-05-01,Waitrose,5411,Groceries,Supermarket,-40.42,GBP,-101248.85,POS,London,GB,2219,user_001,,
eadd0e49-c5bc-4dce-93b0-9ba5b2ad1b16,2028-04-29,2028-05-01,Amazon UK,5942,Shopping,Online Retail,-108.7,GBP,-101357.55,E-Com,London,GB,9074,user_001,,
4e8c73d9-94f7-48a1-b830-1cc7ec2a6583,2028-04-30,2028-05-02,Transport for London,4111,Transport,Transit,-11.33,GBP,-101368.88,POS,London,GB,1045,user_001,,
9bdebbf0-47ce-4ced-bd17-99a5f9ef53e2,2028-04-30,2028-05-01,Amazon UK,5942,Shopping,Online Retail,-98.39,GBP,-101467.27,E-Com,London,GB,2219,user_001,,
be54fe58-c1ae-41fa-b37c-63474f440e90,2028-04-30,2028-05-02,Uber UK,4121,Transport,Ride Hailing,-22.63,GBP,-101489.9,E-Com,London,GB,4488,user_001,,
ce689631-7bcf-40f6-b43d-675004969a47,2028-04-30,2028-05-01,HM Revenue & Customs,9311,Income,Tax Refund,10.08,GBP,-101479.82,Credit,London,GB,1045,user_001,,Refund for Sainsbury's
f5ff7dc2-b46a-4640-bc00-2a4c4787a382,2028-05-01,2028-05-03,Crown Estates Lettings,6513,Housing,Rent,-1535.27,GBP,-103015.09,POS,London,GB,1045,user_001,rec_19f70fbcce,
b3ce2e22-6110-4488-8ce7-c9bfee3ec46c,2028-05-02,2028-05-02,Shell,5541,Transport,Fuel,-74.65,GBP,-103089.74,POS,London,GB,1045,user_002,,
f3962604-2923-454a-a9a4-05491ba11338,2028-05-02,2028-05-03,Tesco,5411,Groceries,Supermarket,-46.3,GBP,-103136.04,POS,London,GB,1045,user_001,,
10413a4e-237a-4e5d-ad08-f98ff3ed7509,2028-05-03,2028-05-05,Uber UK,4121,Transport,Ride Hailing,-8.48,GBP,-103144.52,E-Com,London,GB,4488,user_001,,
d906c3bc-c063-4ed7-9f2e-9308c43e534c,2028-05-04,2028-05-04,Uber UK,4121,Transport,Ride Hailing,-13.74,GBP,-103158.26,E-Com,London,GB,9074,user_001,,
b4dd27b3-61a9-42c1-bbc7-297c15fa21b0,2028-05-05,2028-05-05,Apple.com/bill,5734,Shopping,Electronics,-20.78,GBP,-103179.04,E-Com,Cupertino,US,1045,user_002,,
94a9fdf2-b20c-4f76-b13e-26159a2a8ef4,2028-05-06,2028-05-08,Amazon UK,5942,Shopping,Online Retail,-69.17,GBP,-103248.21,E-Com,London,GB,1045,user_001,,
c1d235c4-4049-4cf9-9230-d47810b0f5f4,2028-05-06,2028-05-08,Deliveroo,5812,Food & Drink,Delivery,-20.87,GBP,-103269.08,E-Com,London,GB,9074,user_001,,
ceb5474c-87b2-490d-a50e-1bafd1129a71,2028-05-06,2028-05-08,Tesco,5411,Groceries,Supermarket,-34.37,GBP,-103303.45,POS,London,GB,9074,user_001,,
22109d0e-bf0b-42c7-82e1-302df94effba,2028-05-07,2028-05-08,Shell,5541,Transport,Fuel,-36.19,GBP,-103339.64,POS,London,GB,2219,user_002,,
43ccb765-00fd-42d3-bc67-d71e4cdaa005,2028-05-07,2028-05-09,Pret A Manger,5814,Food & Drink,Eating Out,-9.69,GBP,-103349.33,POS,London,GB,9074,user_001,,
c3adc98a-4ce6-4446-a359-5645318ae4c4,2028-05-07,2028-05-09,Transport for London,4111,Transport,Transit,-7.06,GBP,-103356.39,POS,London,GB,1045,user_002,,
fa548b4b-3a0a-4db5-ba48-ffd9ba2ce986,2028-05-07,2028-05-09,Tesco,5411,Groceries,Supermarket,-52.17,GBP,-103408.56,POS,London,GB,2219,user_001,,
224fd1fc-dbbc-4aea-bef6-44e9a3cbb4ab,2028-05-08,2028-05-09,Octopus Energy,4900,Utilities,Electricity,-140.59,GBP,-103549.15,Direct Debit,London,GB,4488,user_001,rec_141a4a0666,
878073e1-be3d-4fd9-af64-8092dae9c737,2028-05-08,2028-05-08,Transport for London,4111,Transport,Transit,-4.6,GBP,-103553.75,POS,London,GB,1045,user_001,,
b7e39886-c45e-45b1-b1b1-1e6d05b5a1ba,2028-05-08,2028-05-09,Sainsbury's,5411,Groceries,Supermarket,-54.86,GBP,-103608.61,POS,London,GB,1045,user_001,,
e9ebd2ed-20d0-42a8-92b2-27e4572f23ab,2028-05-08,2028-05-09,Waitrose,5411,Groceries,Supermarket,-49.13,GBP,-103657.74,POS,London,GB,2219,user_001,,
021a2b98-aad0-49ee-8ec1-7a9cbc5450b4,2028-05-09,2028-05-11,Tesco,5411,Groceries,Supermarket,-63.64,GBP,-103721.38,POS,London,GB,9074,user_001,,
0fe2ef32-28fa-4b26-9f9b-d16dbbbe09ab,2028-05-09,2028-05-09,Sainsbury's,5411,Groceries,Supermarket,-34.3,GBP,-103755.68,POS,London,GB,2219,user_001,,
c174722d-32cf-4113-803e-41e589ac5248,2028-05-09,2028-05-10,Tesco,5411,Groceries,Supermarket,-34.42,GBP,-103790.1,POS,London,GB,2219,user_001,,
fea44818-080a-4262-b8e8-c3bdadcc32f7,2028-05-09,2028-05-11,Uber UK,4121,Transport,Ride Hailing,-17.14,GBP,-103807.24,E-Com,London,GB,1045,user_001,,
04ef08a0-d860-4c8a-b514-62b2e157164a,2028-05-10,2028-05-11,Shell,5541,Transport,Fuel,-80.16,GBP,-103887.4,POS,London,GB,1045,user_001,,
6c87a19f-e29a-4e45-9a89-df7223c4c13f,2028-05-10,2028-05-10,Shell,5541,Transport,Fuel,-31.01,GBP,-103918.41,POS,London,GB,4488,user_001,,
7a985943-aec3-42b3-9edd-6367575f47e3,2028-05-10,2028-05-10,Local Market,5499,Groceries,Specialty,-20.91,GBP,-103939.32,POS,London,GB,4488,user_001,,
6b2152c8-3979-4651-a1bb-0c765546add3,2028-05-11,2028-05-11,Uber UK,4121,Transport,Ride Hailing,-10.02,GBP,-103949.34,E-Com,London,GB,1045,user_001,,
a9687145-7a71-47e6-8ac5-e3ea5bca529d,2028-05-11,2028-05-12,Thames Water,4900,Utilities,Water,-40.72,GBP,-103990.06,Direct Debit,Reading,GB,9074,user_001,rec_3a34d62842,
c02262cf-9cf4-435c-8f7e-b83e0bae1741,2028-05-11,2028-05-15,Waitrose,5411,Groceries,Supermarket,-89.53,GBP,-104079.59,POS,London,GB,9074,user_001,,
621caf5d-0deb-4089-aa71-5fd78a49b5de,2028-05-12,2028-05-15,Pret A Manger,5814,Food & Drink,Eating Out,-7.22,GBP,-104086.81,POS,London,GB,9074,user_001,,
2051ee5f-7137-4bdd-ba08-a731b0567cb5,2028-05-13,2028-05-15,Apple.com/bill,5734,Shopping,Electronics,-187.27,USD,-104274.08,E-Com,Cupertino,US,9074,user_001,,FX purchase 242.53 USD @ rate 1.30
3b145b9c-542b-4c0d-a541-abad0efb9f62,2028-05-13,2028-05-15,Pret A Manger,5814,Food & Drink,Eating Out,-9.2,GBP,-104283.28,POS,London,GB,2219,user_001,,
0299673b-49fd-48e5-b293-298638f7b849,2028-05-14,2028-05-15,Sainsbury's,5411,Groceries,Supermarket,-64.71,GBP,-104347.99,POS,London,GB,9074,user_002,,
5c9d967f-2758-4245-a687-30bee04d2309,2028-05-14,2028-05-15,Pret A Manger,5814,Food & Drink,Eating Out,-11.13,GBP,-104359.12,POS,London,GB,1045,user_001,,
e8a0efdc-d67f-4325-9f50-5ef6736e6d55,2028-05-14,2028-05-15,Amazon UK,5942,Shopping,Online Retail,-21.02,GBP,-104380.14,E-Com,London,GB,2219,user_002,,
ae122629-51f4-4ebc-a05c-c61ad7089236,2028-05-15,2028-05-15,O2 UK,4814,Bills,Mobile,-43.55,GBP,-104423.69,Direct Debit,Slough,GB,9074,user_001,rec_95042d8101,
cf3969fb-ca84-4f32-b207-855fef1ea21d,2028-05-15,2028-05-17,City Council Tax,9399,Utilities,Council Tax,-161.5,GBP,-104585.19,Direct Debit,London,GB,4488,user_001,rec_f531495db5,
99cefd59-5bb1-45b5-9a4e-95d476456d77,2028-05-16,2028-05-18,Deliveroo,5812,Food & Drink,Delivery,-12.19,GBP,-104597.38,E-Com,London,GB,4488,user_001,,
48a6412c-37e7-4e05-9eee-bcd21bf58745,2028-05-17,2028-05-19,GymBox,7997,Wellness,Gym,-53.62,GBP,-104651.0,Direct Debit,London,GB,2219,user_001,rec_3906953fd2,
9f211d0d-45cf-4aca-8358-ce8239038f74,2028-05-17,2028-05-19,Shell,5541,Transport,Fuel,-86.26,GBP,-104737.26,POS,London,GB,4488,user_001,,
c849e379-7d04-4ec7-9906-c07872b5ec34,2028-05-18,2028-05-18,Deliveroo,5812,Food & Drink,Delivery,-21.74,GBP,-104759.0,E-Com,London,GB,2219,user_001,,
76cf7737-df03-4ac8-a0da-e04a23d3db80,2028-05-19,2028-05-22,Deliveroo,5812,Food & Drink,Delivery,-17.85,GBP,-104776.85,E-Com,London,GB,2219,user_001,,
c4b94cd7-493f-408e-8db5-3cd6ad772649,2028-05-19,2028-05-22,Apple.com/bill,5734,Shopping,Electronics,-103.16,USD,-104880.01,E-Com,Cupertino,US,4488,user_001,,FX purchase 133.47 USD @ rate 1.29
d77d1200-1b60-44ad-89ec-b15b1a460946,2028-05-19,2028-05-22,Spotify,5735,Entertainment,Subscriptions,-8.65,GBP,-104888.66,E-Com,Stockholm,SE,2219,user_002,rec_34b6e9e33f,
47c16c8a-3e56-449a-9b98-6ff341bec706,2028-05-20,2028-05-22,Apple.com/bill,5734,Shopping,Electronics,-110.51,GBP,-104999.17,E-Com,Cupertino,US,2219,user_001,,
795dbd2a-9f89-49fc-9fd9-cad607338cc3,2028-05-20,2028-05-22,Shell,5541,Transport,Fuel,-94.95,GBP,-105094.12,POS,London,GB,9074,user_001,,
87220719-d84a-4665-94d1-6a71e189df8e,2028-05-21,2028-05-23,Uber UK,4121,Transport,Ride Hailing,-30.34,GBP,-105124.46,E-Com,London,GB,4488,user_001,,
87ec7592-443e-437f-a789-3141284d9e94,2028-05-21,2028-05-22,Waitrose,5411,Groceries,Supermarket,-37.35,GBP,-105161.81,POS,London,GB,4488,user_001,,
bbe101ca-b465-4865-ae91-4ddf6886f089,2028-05-21,2028-05-22,Tesco,5411,Groceries,Supermarket,-47.73,GBP,-105209.54,POS,London,GB,1045,user_002,,
c3dee261-2019-4e58-aff5-df5f3513bc79,2028-05-21,2028-05-23,Sainsbury's,5411,Groceries,Supermarket,-31.99,GBP,-105241.53,POS,London,GB,1045,user_001,,
d9849cbf-4d20-4be1-a588-c7eb5f0573e2,2028-05-21,2028-05-22,Uber UK,4121,Transport,Ride Hailing,-17.7,GBP,-105259.23,E-Com,London,GB,9074,user_001,,
75dfaa3c-c118-4a52-b8ab-3e59f21d1df9,2028-05-22,2028-05-23,Netflix,7841,Entertainment,Subscriptions,-12.31,GBP,-105271.54,E-Com,Los Gatos,US,9074,user_001,rec_1bfe33738d,
9dd629f4-935b-4e3a-8326-b9e05010603f,2028-05-22,2028-05-22,Shell,5541,Transport,Fuel,-59.47,GBP,-105331.01,POS,London,GB,1045,user_001,,
c9da1be3-5099-4607-9d6c-f702ed6e2d1b,2028-05-22,2028-05-23,Tesco,5411,Groceries,Supermarket,-82.19,GBP,-105413.2,POS,London,GB,9074,user_001,,
0da2fb81-e87e-4b9a-b7a7-9a62f3e3fbaa,2028-05-23,2028-05-25,Local Market,5499,Groceries,Specialty,-14.09,GBP,-105427.29,POS,London,GB,9074,user_001,,
46e5bf47-ae8c-4441-b104-44abbfd8b3de,2028-05-23,2028-05-24,Transport for London,4111,Transport,Transit,-4.78,GBP,-105432.07,POS,London,GB,4488,user_001,,
4eb9184b-5e9c-4b3b-90fd-401beda6be6f,2028-05-23,2028-05-24,Amazon UK,5942,Shopping,Online Retail,-47.64,GBP,-105479.71,E-Com,London,GB,4488,user_002,,
70e29c91-9108-43ae-9506-d424379b0e46,2028-05-23,2028-05-25,Apple.com/bill,5734,Shopping,Electronics,-29.98,GBP,-105509.69,E-Com,Cupertino,US,2219,user_001,,
d174a323-9237-4cc0-a2ad-7b9520d9ce8c,2028-05-23,2028-05-24,Pret A Manger,5814,Food & Drink,Eating Out,-5.8,GBP,-105515.49,POS,London,GB,9074,user_001,,
0b6333fd-d0b1-42f9-95fc-15e12bd603a8,2028-05-25,2028-05-25,Amazon UK,5942,Shopping,Online Retail,-42.99,GBP,-105558.48,E-Com,London,GB,9074,user_001,,
23f1ef39-c38f-46f1-90e6-a3b22451a171,2028-05-25,2028-05-29,Uber UK,4121,Transport,Ride Hailing,-35.4,GBP,-105593.88,E-Com,London,GB,1045,user_001,,
459adc9b-74ce-4e6c-b10f-8af7444f0fec,2028-05-25,2028-05-26,Deliveroo,5812,Food & Drink,Delivery,-28.89,GBP,-105622.77,E-Com,London,GB,9074,user_002,,
7bb159de-7223-4c4d-9f15-1467475dfdf5,2028-05-25,2028-05-25,T212 Capital,6011,Income,Salary,3227.49,GBP,-102395.28,Credit,London,GB,4488,user_001,rec_2ff8f778d0,
7eab923b-59f7-4ea5-8541-9775ebcaf298,2028-05-25,2028-05-29,Uber UK,4121,Transport,Ride Hailing,-27.35,GBP,-102422.63,E-Com,London,GB,1045,user_001,,
ae1f2ac6-a376-4754-a365-803ecb694f15,2028-05-26,2028-05-29,ATM Withdrawal,6011,Cash,ATM,-91.13,GBP,-102513.76,ATM,London,GB,4488,user_001,,
c45dbf70-f367-4b84-8a50-49bce7f20f6f,2028-05-26,2028-05-29,Apple.com/bill,5734,Shopping,Electronics,-186.29,GBP,-102700.05,E-Com,Cupertino,US,9074,user_001,,
375f4cbd-0a82-4dfb-ae02-4a600dde7905,2028-05-27,2028-05-29,Uber UK,4121,Transport,Ride Hailing,-30.9,GBP,-102730.95,E-Com,London,GB,1045,user_001,,
1feceefd-771a-4bf3-b76b-b3c74cac8372,2028-05-28,2028-05-30,Uber UK,4121,Transport,Ride Hailing,-26.87,GBP,-102757.82,E-Com,London,GB,9074,user_002,,
d1e35a10-956c-4b5f-8eb3-b5e0722b2561,2028-05-28,2028-05-29,Sainsbury's,5411,Groceries,Supermarket,-55.58,GBP,-102813.4,POS,London,GB,2219,user_002,,
feeb7c32-3c7f-4783-8ad3-57978611633a,2028-05-29,2028-05-30,Sainsbury's,5411,Groceries,Supermarket,-57.63,GBP,-102871.03,POS,London,GB,9074,user_002,,
66a6e70a-edaa-4f31-8342-c04f97b91a06,2028-05-30,2028-05-31,Uber UK,4121,Transport,Ride Hailing,-28.6,GBP,-102899.63,E-Com,London,GB,9074,user_001,,
900b04c1-d31f-44b5-9955-b435c3af8ca7,2028-05-30,2028-06-01,Shell,5541,Transport,Fuel,-73.28,GBP,-102972.91,POS,London,GB,4488,user_001,,
6670b4f8-20e1-42c0-8fad-ac3f3aa3a1e0,2028-05-31,2028-06-02,Apple.com/bill,5734,Shopping,Electronics,-47.87,USD,-103020.78,E-Com,Cupertino,US,4488,user_001,,FX purchase 58.72 USD @ rate 1.23
f767f832-7342-4898-9678-887dcf2e939f,2028-05-31,2028-05-31,Shell,5541,Transport,Fuel,-80.36,GBP,-103101.14,POS,London,GB,1045,user_001,,
3c9548d8-0a1d-4bfc-92ed-66e6138b03fb,2028-06-01,2028-06-02,Crown Estates Lettings,6513,Housing,Rent,-1495.63,GBP,-104596.77,POS,London,GB,1045,user_001,rec_19f70fbcce,
4ad221cd-93c3-4bb3-b946-5376f83e9140,2028-06-01,2028-06-05,Uber UK,4121,Transport,Ride Hailing,-30.49,GBP,-104627.26,E-Com,London,GB,2219,user_001,,
ac23ce0f-05e5-486f-aad4-aa6b10076f62,2028-06-01,2028-06-05,Deliveroo,5812,Food & Drink,Delivery,-19.8,GBP,-104647.06,E-Com,London,GB,4488,user_001,,
a863c438-5944-4e6d-8785-940e626ce4b6,2028-06-02,2028-06-05,Amazon UK,5942,Shopping,Online Retail,-37.62,GBP,-104684.68,E-Com,London,GB,2219,user_002,,
e65f0c94-7b44-48a5-b277-5a92b6cb705a,2028-06-02,2028-06-05,Deliveroo,5812,Food & Drink,Delivery,-29.77,GBP,-104714.45,E-Com,London,GB,4488,user_001,,
1e6fbb76-5a9f-4c37-b97d-20292f8b8e47,2028-06-03,2028-06-05,Pret A Manger,5814,Food & Drink,Eating Out,-10.19,GBP,-104724.64,POS,London,GB,2219,user_001,,
39d92d04-68a5-4844-95b3-aae7f40fe3c0,2028-06-03,2028-06-05,Pret A Manger,5814,Food & Drink,Eating Out,-10.68,GBP,-104735.32,POS,London,GB,4488,user_001,,
65b9a31b-c5a1-413b-a46a-4ee3992c904a,2028-06-03,2028-06-05,Shell,5541,Transport,Fuel,-58.95,GBP,-104794.27,POS,London,GB,4488,user_002,,
9b155436-5526-4acb-bc4d-661f51102b60,2028-06-03,2028-06-05,Uber UK,4121,Transport,Ride Hailing,-19.25,GBP,-104813.52,E-Com,London,GB,4488,user_002,,
a31e4957-6c05-40e7-bfa3-a84287192352,2028-06-03,2028-06-05,Apple.com/bill,5734,Shopping,Electronics,-176.01,USD,-104989.53,E-Com,Cupertino,US,1045,user_002,,FX purchase 226.79 USD @ rate 1.29
ad265a1c-1cc7-4f68-8a03-81cc33e332a6,2028-06-03,2028-06-05,Shell,5541,Transport,Fuel,-34.91,GBP,-105024.44,POS,London,GB,2219,user_001,,
fe368aa9-b901-424f-a34e-03e8ed5125ef,2028-06-03,2028-06-05,Transport for London,4111,Transport,Transit,-7.63,GBP,-105032.07,POS,London,GB,2219,user_001,,
177c8d26-793b-4822-89fb-e5218fcc7e40,2028-06-04,2028-06-05,Waitrose,5411,Groceries,Supermarket,-40.9,GBP,-105072.97,POS,London,GB,2219,user_001,,
9770e9c1-04cc-49d8-b834-0d2769b3d655,2028-06-04,2028-06-05,Tesco,5411,Groceries,Supermarket,-83.37,GBP,-105156.34,POS,London,GB,2219,user_001,,
9b4262b4-1ee2-4cdd-8368-c9ce316d9d8c,2028-06-04,2028-06-06,Waitrose,5411,Groceries,Supermarket,-46.89,GBP,-105203.23,POS,London,GB,1045,user_001,,
de5baf10-7b13-4309-997c-d28ce4ce4363,2028-06-04,2028-06-05,Shell,5541,Transport,Fuel,-57.16,GBP,-105260.39,POS,London,GB,1045,user_001,,
59cebbdb-abc7-4d1b-b723-1b2752f7919d,2028-06-05,2028-06-06,Deliveroo,5812,Food & Drink,Delivery,-20.49,GBP,-105280.88,E-Com,London,GB,4488,user_001,,
db1d6942-d4bd-4121-8158-bed498c2de51,2028-06-05,2028-06-06,Local Market,5499,Groceries,Specialty,-21.63,GBP,-105302.51,POS,London,GB,2219,user_002,,
11637eac-f70b-4188-a7fb-75aa2b39b426,2028-06-06,2028-06-06,Tesco,5411,Groceries,Supermarket,-80.57,GBP,-105383.08,POS,London,GB,1045,user_001,,
23c9c79d-9035-4bd3-977a-9ada173d559d,2028-06-06,2028-06-07,Uber UK,4121,Transport,Ride Hailing,-18.49,GBP,-105401.57,E-Com,London,GB,2219,user_001,,
41aefb74-1414-4de1-8dcc-fae1c88ecf9e,2028-06-06,2028-06-08,Apple.com/bill,5734,Shopping,Electronics,-173.92,GBP,-105575.49,E-Com,Cupertino,US,4488,user_001,,
7a0da850-4feb-4d7c-b7d6-1e5644ca830e,2028-06-07,2028-06-08,Octopus Energy,4900,Utilities,Electricity,-138.86,GBP,-105714.35,Direct Debit,London,GB,1045,user_001,rec_141a4a0666,
9e7be996-1ce4-4ead-858f-9455bd8845ba,2028-06-07,2028-06-07,Transport for London,4111,Transport,Transit,-11.95,GBP,-105726.3,POS,London,GB,1045,user_001,,
fd4b3698-d4f8-4f82-89de-a738914385ce,2028-06-07,2028-06-07,ATM Withdrawal,6011,Cash,ATM,-102.6,GBP,-105828.9,ATM,London,GB,1045,user_001,,
94b0e4ba-b8fe-488a-8476-8c8bb1e307e9,2028-06-08,2028-06-08,Tesco,5411,Groceries,Supermarket,-57.83,GBP,-105886.73,POS,London,GB,2219,user_001,,
4a6cf2a3-09e3-41c9-a658-840f18daa7d4,2028-06-09,2028-06-12,Shell,5541,Transport,Fuel,-60.2,GBP,-105946.93,POS,London,GB,2219,user_001,,
6b53f23d-a75c-4c79-aff2-9651fe72cfd7,2028-06-09,2028-06-12,Uber UK,4121,Transport,Ride Hailing,-8.52,GBP,-105955.45,E-Com,London,GB,4488,user_001,,
ebfacd8f-b505-41d0-9edd-3047ea11c95d,2028-06-09,2028-06-12,Local Market,5499,Groceries,Specialty,-10.23,GBP,-105965.68,POS,London,GB,1045,user_001,,
3b6ed828-5e04-4d74-9b7d-f74ea1845cb5,2028-06-10,2028-06-12,Waitrose,5411,Groceries,Supermarket,-26.01,GBP,-105991.69,POS,London,GB,1045,user_001,,
74d9cf75-2608-460d-9d49-74469569565f,2028-06-10,2028-06-12,Uber UK,4121,Transport,Ride Hailing,-13.44,GBP,-106005.13,E-Com,London,GB,2219,user_001,,
75601b4a-289e-4292-ada8-b33915058b9a,2028-06-10,2028-06-12,Amazon UK,5942,Shopping,Online Retail,-87.12,GBP,-106092.25,E-Com,London,GB,4488,user_002,,
b0aca6f1-446a-4672-a9b7-3d0172d9eb84,2028-06-10,2028-06-12,Waitrose,5411,Groceries,Supermarket,-27.51,GBP,-106119.76,POS,London,GB,1045,user_001,,
b8c16bb9-4135-426c-8f73-c9199b22cb56,2028-06-10,2028-06-12,Apple.com/bill,5734,Shopping,Electronics,-97.22,GBP,-106216.98,E-Com,Cupertino,US,4488,user_001,,
5cdb8961-1a45-4431-985b-46ffeda7e8b6,2028-06-11,2028-06-12,HM Revenue & Customs,9311,Income,Tax Refund,28.28,GBP,-106188.7,Credit,London,GB,4488,user_001,,Refund for Shell
e7db8ea9-5cb6-4a1b-9f8e-f2ccb1746566,2028-06-11,2028-06-12,Sainsbury's,5411,Groceries,Supermarket,-29.01,GBP,-106217.71,POS,London,GB,1045,user_001,,
f15e3a12-ffa3-4c84-beb0-47ba64084d5d,2028-06-11,2028-06-12,Amazon UK,5942,Shopping,Online Retail,-113.44,GBP,-106331.15,E-Com,London,GB,4488,user_001,,
71e70bb6-94e2-49d5-ae65-414e859e8119,2028-06-12,2028-06-12,Thames Water,4900,Utilities,Water,-34.63,GBP,-106365.78,Direct Debit,Reading,GB,4488,user_001,rec_3a34d62842,
2ff264fe-2e0a-4680-a7e6-164f3da85acc,2028-06-13,2028-06-15,Apple.com/bill,5734,Shopping,Electronics,-74.43,USD,-106440.21,E-Com,Cupertino,US,4488,user_001,,FX purchase 92.02 USD @ rate 1.24
faadd0c1-0a3b-423a-86a6-b847969df92c,2028-06-13,2028-06-14,City Council Tax,9399,Utilities,Council Tax,-156.2,GBP,-106596.41,Direct Debit,London,GB,4488,user_001,rec_f531495db5,
005c5553-d618-4d03-ab20-f90bcf13f64f,2028-06-14,2028-06-14,Amazon UK,5942,Shopping,Online Retail,-98.34,GBP,-106694.75,E-Com,London,GB,2219,user_001,,
2c9f57e2-2586-46c7-92dc-2c1cfc3f4fba,2028-06-14,2028-06-14,Tesco,5411,Groceries,Supermarket,-65.81,GBP,-106760.56,POS,London,GB,9074,user_002,,
840792cd-9375-4512-8d46-33c16e275b25,2028-06-14,2028-06-15,Pret A Manger,5814,Food & Drink,Eating Out,-10.12,GBP,-106770.68,POS,London,GB,9074,user_001,,
b439b9fa-edaf-4232-aa6d-1e46eaf6bdbd,2028-06-14,2028-06-15,Apple.com/bill,5734,Shopping,Electronics,-161.43,USD,-106932.11,E-Com,Cupertino,US,2219,user_001,,FX purchase 202.07 USD @ rate 1.25
1fe90891-2334-4def-920e-b422bb9f35d3,2028-06-15,2028-06-15,Waitrose,5411,Groceries,Supermarket,-27.01,GBP,-106959.12,POS,London,GB,9074,user_002,,
a7d4087f-35e9-47c7-b67a-7a10f70f90b9,2028-06-15,2028-06-16,O2 UK,4814,Bills,Mobile,-46.8,GBP,-107005.92,Direct Debit,Slough,GB,2219,user_001,rec_95042d8101,
4a373683-cd0b-4f8c-a30c-96356b5a5b88,2028-06-16,2028-06-19,Transport for London,4111,Transport,Transit,-3.77,GBP,-107009.69,POS,London,GB,9074,user_001,,
5c2b3a3a-e813-4bd8-a466-1537ca5bfa2c,2028-06-17,2028-06-19,Local Market,5499,Groceries,Specialty,-9.91,GBP,-107019.6,POS,London,GB,1045,user_002,,
09b4d38a-b3e5-405a-bfe8-1d4af6e57756,2028-06-18,2028-06-19,Uber UK,4121,Transport,Ride Hailing,-18.01,GBP,-107037.61,E-Com,London,GB,9074,user_001,,
5d94e354-f966-4b72-9cf5-4422af618890,2028-06-18,2028-06-19,Deliveroo,5812,Food & Drink,Delivery,-20.4,GBP,-107058.01,E-Com,London,GB,9074,user_001,,
841c9ead-88d6-4ae0-8433-7ddd89a3dcf1,2028-06-18,2028-06-20,Shell,5541,Transport,Fuel,-54.52,GBP,-107112.53,POS,London,GB,4488,user_001,,
85d5b6a6-37e1-4df3-9597-1cb7acefca2a,2028-06-18,2028-06-19,Local Market,5499,Groceries,Specialty,-10.79,GBP,-107123.32,POS,London,GB,9074,user_001,,
585c647b-b814-4c1d-abdd-c21243b906e8,2028-06-19,2028-06-20,Spotify,5735,Entertainment,Subscriptions,-9.55,GBP,-107132.87,E-Com,Stockholm,SE,2219,user_001,rec_4c746d2c3b,
5f50e141-7e35-4063-8a54-085cae8fad5b,2028-06-19,2028-06-21,GymBox,7997,Wellness,Gym,-56.62,GBP,-107189.49,Direct Debit,London,GB,4488,user_001,rec_3906953fd2,
fbdfdd30-7feb-4cf0-9684-3d8c689b0801,2028-06-19,2028-06-21,Uber UK,4121,Transport,Ride Hailing,-19.37,GBP,-107208.86,E-Com,London,GB,9074,user_001,,
17682687-ad9a-4ef3-ad62-724b4bfafe83,2028-06-21,2028-06-22,Netflix,7841,Entertainment,Subscriptions,-13.45,USD,-107222.31,E-Com,Los Gatos,US,4488,user_001,rec_1bfe33738d,FX purchase 16.5 USD @ rate 1.23
39a1bf36-0a7d-4b81-9080-c93b9d4b3422,2028-06-21,2028-06-21,Tesco,5411,Groceries,Supermarket,-26.57,GBP,-107248.88,POS,London,GB,2219,user_002,,
8aec4147-910a-4392-9eb8-70da1e071ff8,2028-06-21,2028-06-21,Deliveroo,5812,Food & Drink,Delivery,-19.53,GBP,-107268.41,E-Com,London,GB,2219,user_002,,
d572b3f8-41fb-4eda-b607-0cd659a5ad3e,2028-06-22,2028-06-23,Pret A Manger,5814,Food & Drink,Eating Out,-7.51,GBP,-107275.92,POS,London,GB,2219,user_001,,
3f9fe407-6f15-4949-850a-d2be240ca2ac,2028-06-23,2028-06-26,Tesco,5411,Groceries,Supermarket,-47.88,GBP,-107323.8,POS,London,GB,2219,user_001,,
c8515c8f-0e46-4302-8a46-ca778ada48dc,2028-06-23,2028-06-23,T212 Capital,6011,Income,Salary,3375.63,GBP,-103948.17,Credit,London,GB,9074,user_002,rec_c649d24d0f,
3dca9544-9715-46ba-89d1-409704c4939d,2028-06-24,2028-06-26,Uber UK,4121,Transport,Ride Hailing,-24.11,GBP,-103972.28,E-Com,London,GB,4488,user_001,,
4ecfa3ea-b3b7-4fbf-95c2-d3d6120a6679,2028-06-24,2028-06-26,Tesco,5411,Groceries,Supermarket,-38.28,GBP,-104010.56,POS,London,GB,4488,user_001,,
5d53fe3c-e2c8-4436-a8d7-3b5c5b6f0ffa,2028-06-24,2028-06-26,Deliveroo,5812,Food & Drink,Delivery,-13.58,GBP,-104024.14,E-Com,London,GB,2219,user_001,,
9e3f6c7a-7312-404c-8b98-4278461422ea,2028-06-24,2028-06-26,Tesco,5411,Groceries,Supermarket,-18.48,GBP,-104042.62,POS,London,GB,4488,user_001,,
e11e058d-2e7c-483a-bfe0-42ee880dfc3b,2028-06-24,2028-06-26,Waitrose,5411,Groceries,Supermarket,-86.17,GBP,-104128.79,POS,London,GB,2219,user_001,,
0f857609-1876-4d30-b172-04bc69e0620a,2028-06-25,2028-06-26,Shell,5541,Transport,Fuel,-82.97,GBP,-104211.76,POS,London,GB,4488,user_001,,
4e2c12c5-21f3-445e-9d0f-a07ffe3d2a5c,2028-06-25,2028-06-26,Uber UK,4121,Transport,Ride Hailing,-10.18,GBP,-104221.94,E-Com,London,GB,9074,user_002,,
7e57447a-f63d-481e-905c-c36008ffd207,2028-06-25,2028-06-27,Uber UK,4121,Transport,Ride Hailing,-23.62,GBP,-104245.56,E-Com,London,GB,1045,user_001,,
bc62194a-761e-44f5-988f-013a00aae2a2,2028-06-27,2028-06-28,Pret A Manger,5814,Food & Drink,Eating Out,-5.71,GBP,-104251.27,POS,London,GB,1045,user_001,,
11f7ebbf-127c-47bb-b497-d02632426648,2028-06-28,2028-06-28,Uber UK,4121,Transport,Ride Hailing,-8.85,GBP,-104260.12,E-Com,London,GB,4488,user_001,,
cf8e20a0-8b46-4e0c-8b96-f091fed91ec3,2028-06-28,2028-06-28,Pret A Manger,5814,Food & Drink,Eating Out,-7.31,GBP,-104267.43,POS,London,GB,1045,user_001,,
75c1e6e1-ec77-4f55-bbcc-bacbf66ae6c1,2028-06-29,2028-06-29,Pret A Manger,5814,Food & Drink,Eating Out,-6.89,GBP,-104274.32,POS,London,GB,2219,user_001,,
8b09736e-6a55-4c42-a86a-83260dbca15a,2028-06-29,2028-06-30,Deliveroo,5812,Food & Drink,Delivery,-19.09,GBP,-104293.41,E-Com,London,GB,4488,user_002,,
4f4ae602-d7fb-4837-bc6c-2d7949b979a0,2028-06-30,2028-06-30,Tesco,5411,Groceries,Supermarket,-25.89,GBP,-104319.3,POS,London,GB,1045,user_001,,
09e9916d-c1a0-447f-a5dd-36dbfcb69ded,2028-07-01,2028-07-03,Deliveroo,5812,Food & Drink,Delivery,-13.37,GBP,-104332.67,E-Com,London,GB,2219,user_001,,
243c2a47-3c29-4bfd-aa3a-b475e9f4a112,2028-07-01,2028-07-03,Shell,5541,Transport,Fuel,-64.21,GBP,-104396.88,POS,London,GB,9074,user_002,,
be953785-f4b8-4ab5-89cf-b62e275b9acc,2028-07-01,2028-07-03,Deliveroo,5812,Food & Drink,Delivery,-26.62,GBP,-104423.5,E-Com,London,GB,9074,user_001,,
bf43f736-9d31-4bd3-9bad-fe3fefb72ed3,2028-07-01,2028-07-03,Amazon UK,5942,Shopping,Online Retail,-93.28,GBP,-104516.78,E-Com,London,GB,1045,user_001,,
c6ba8eb8-1124-4752-bb22-25138fa01850,2028-07-01,2028-07-03,Deliveroo,5812,Food & Drink,Delivery,-14.26,GBP,-104531.04,E-Com,London,GB,4488,user_001,,
f1097093-26de-44dc-919f-a5e85c39a1a0,2028-07-01,2028-07-03,Airline Refund,4511,Travel,Refund,49.32,GBP,-104481.72,Credit,London,GB,9074,user_001,,Refund for Apple.com/bill
380f5c2e-6d76-40d5-9010-d81d772df315,2028-07-02,2028-07-03,Pret A Manger,5814,Food & Drink,Eating Out,-11.04,GBP,-104492.76,POS,London,GB,2219,user_001,,
769287af-9ad1-4c66-b65f-3c06132e194c,2028-07-02,2028-07-04,Sainsbury's,5411,Groceries,Supermarket,-18.55,GBP,-104511.31,POS,London,GB,2219,user_001,,
89a61e4f-35f4-4c84-9ce4-8176327c180e,2028-07-02,2028-07-03,Pret A Manger,5814,Food & Drink,Eating Out,-8.92,GBP,-104520.23,POS,London,GB,4488,user_001,,
17c82ed1-9e97-4353-bdec-274c9aab7a3a,2028-07-03,2028-07-05,Deliveroo,5812,Food & Drink,Delivery,-25.24,GBP,-104545.47,E-Com,London,GB,1045,user_001,,
ca47306c-ce5d-46e4-88f0-b4e711c2ea1a,2028-07-03,2028-07-04,Crown Estates Lettings,6513,Housing,Rent,-1511.74,GBP,-106057.21,POS,London,GB,9074,user_002,rec_fc2ae06846,
4fa27d14-d3ff-4417-99e1-036064075fea,2028-07-05,2028-07-05,Tesco,5411,Groceries,Supermarket,-27.45,GBP,-106084.66,POS,London,GB,4488,user_001,,
dff074f1-5410-449a-bf28-99d4b1abb554,2028-07-05,2028-07-05,Uber UK,4121,Transport,Ride Hailing,-31.53,GBP,-106116.19,E-Com,London,GB,4488,user_001,,
e5f1e85b-30aa-4d29-aafc-13bdecf07954,2028-07-05,2028-07-05,Amazon UK,5942,Shopping,Online Retail,-118.56,GBP,-106234.75,E-Com,London,GB,4488,user_001,,
7ddd8447-2304-442a-a0a3-39134e11c02c,2028-07-06,2028-07-10,Apple.com/bill,5734,Shopping,Electronics,-85.55,GBP,-106320.3,E-Com,Cupertino,US,2219,user_002,,
bc30a524-11c1-45f2-aa48-adcbee7f74f6,2028-07-06,2028-07-06,Apple.com/bill,5734,Shopping,Electronics,-112.61,USD,-106432.91,E-Com,Cupertino,US,2219,user_001,,FX purchase 143.33 USD @ rate 1.27
d78f54b6-ceff-4280-a4c8-78fc84db251c,2028-07-06,2028-07-07,Deliveroo,5812,Food & Drink,Delivery,-20.42,GBP,-106453.33,E-Com,London,GB,1045,user_001,,
19464073-b516-41ec-b84e-4dafbeda6908,2028-07-07,2028-07-10,Waitrose,5411,Groceries,Supermarket,-63.64,GBP,-106516.97,POS,London,GB,9074,user_001,,
81f080a0-8089-4dce-840f-d579a772aae8,2028-07-07,2028-07-10,Transport for London,4111,Transport,Transit,-4.06,GBP,-106521.03,POS,London,GB,2219,user_002,,
b856f3d9-3708-441b-9189-dc591032045a,2028-07-07,2028-07-10,Octopus Energy,4900,Utilities,Electricity,-138.24,GBP,-106659.27,Direct Debit,London,GB,2219,user_001,rec_141a4a0666,
f6acff2a-3ca6-48e0-b838-e0080a7528f8,2028-07-07,2028-07-07,Uber UK,4121,Transport,Ride Hailing,-17.13,GBP,-106676.4,E-Com,London,GB,1045,user_001,,
03c4c44b-1c9b-4212-910a-2a3b43c86893,2028-07-08,2028-07-10,Apple.com/bill,5734,Shopping,Electronics,-32.92,USD,-106709.32,E-Com,Cupertino,US,4488,user_001,,FX purchase 40.59 USD @ rate 1.23
6df11e81-6e26-4c34-a5a9-dafff15e41d7,2028-07-08,2028-07-10,Transport for London,4111,Transport,Transit,-6.83,GBP,-106716.15,POS,London,GB,4488,user_001,,
8eaa6843-b221-44d3-9a51-ae7924add4cb,2028-07-08,2028-07-10,Shell,5541,Transport,Fuel,-82.71,GBP,-106798.86,POS,London,GB,1045,user_001,,
1068e3fb-bf2f-4e09-944e-d3f317215d57,2028-07-09,2028-07-10,Deliveroo,5812,Food & Drink,Delivery,-20.65,GBP,-106819.51,E-Com,London,GB,4488,user_001,,
71b73cb9-2c24-4b62-a511-22284b8aa135,2028-07-09,2028-07-11,Deliveroo,5812,Food & Drink,Delivery,-19.46,GBP,-106838.97,E-Com,London,GB,9074,user_001,,
9dad597e-b6e5-4d0f-afd0-38bb8bf739e9,2028-07-09,2028-07-11,Deliveroo,5812,Food & Drink,Delivery,-24.09,GBP,-106863.06,E-Com,London,GB,9074,user_001,,
b2fd1d26-e903-4fce-bbd1-e10c952b9ac2,2028-07-09,2028-07-10,Deliveroo,5812,Food & Drink,Delivery,-30.46,GBP,-106893.52,E-Com,London,GB,1045,user_001,,
9d64f9f4-0427-4a92-9463-d608bb5e38e0,2028-07-11,2028-07-11,Thames Water,4900,Utilities,Water,-36.09,GBP,-106929.61,Direct Debit,Reading,GB,4488,user_002,rec_954d02400c,
bdcad009-f317-4a9b-a6d3-4995f89cee2d,2028-07-11,2028-07-11,Waitrose,5411,Groceries,Supermarket,-29.02,GBP,-106958.63,POS,London,GB,1045,user_001,,
f477c19e-830a-4ffb-a518-24f65ec36b39,2028-07-11,2028-07-12,Local Market,5499,Groceries,Specialty,-19.86,GBP,-106978.49,POS,London,GB,2219,user_001,,
049e912c-de64-4436-bef2-cc83939ae9fe,2028-07-12,2028-07-13,Tesco,5411,Groceries,Supermarket,-48.54,GBP,-107027.03,POS,London,GB,9074,user_001,,
979f9c99-59e0-4983-96cd-26cfe00ba6d4,2028-07-12,2028-07-12,Waitrose,5411,Groceries,Supermarket,-89.45,GBP,-107116.48,POS,London,GB,9074,user_001,,
5df0631f-b291-441b-9945-8a15e35ea0cd,2028-07-13,2028-07-14,Sainsbury's,5411,Groceries,Supermarket,-53.86,GBP,-107170.34,POS,London,GB,4488,user_002,,
650f7800-0d57-4d90-be90-3d57381c5322,2028-07-13,2028-07-14,City Council Tax,9399,Utilities,Council Tax,-181.25,GBP,-107351.59,Direct Debit,London,GB,4488,user_001,rec_f531495db5,
73d5d9b4-c0df-47e7-8dce-f2b106b0edd8,2028-07-13,2028-07-13,Tesco,5411,Groceries,Supermarket,-29.88,GBP,-107381.47,POS,London,GB,9074,user_001,,
484c589b-eae0-40ad-b896-7a8340316c3d,2028-07-14,2028-07-17,Transport for London,4111,Transport,Transit,-3.62,GBP,-107385.09,POS,London,GB,9074,user_002,,
6134fce3-a639-4fc0-96ba-8582a326cc4a,2028-07-14,2028-07-17,Shell,5541,Transport,Fuel,-79.42,GBP,-107464.51,POS,London,GB,2219,user_001,,
190c460a-9ea5-45f2-b852-d586046ca772,2028-07-15,2028-07-17,Waitrose,5411,Groceries,Supermarket,-49.83,GBP,-107514.34,POS,London,GB,2219,user_001,,
87d8a3b4-d77d-4a32-9dc6-bafafbedc3a2,2028-07-15,2028-07-17,Pret A Manger,5814,Food & Drink,Eating Out,-5.64,GBP,-107519.98,POS,London,GB,9074,user_001,,
96364948-a48a-497a-9e7e-f0cbfc0987e6,2028-07-15,2028-07-17,Sainsbury's,5411,Groceries,Supermarket,-18.58,GBP,-107538.56,POS,London,GB,4488,user_001,,
07a4169c-fbaa-4441-a251-8f3b04f6c0d0,2028-07-16,2028-07-18,Amazon UK,5942,Shopping,Online Retail,-79.02,GBP,-107617.58,E-Com,London,GB,2219,user_001,,
1d82d0bc-d35c-40b4-b713-2ccb6c3cd042,2028-07-16,2028-07-18,Shell,5541,Transport,Fuel,-39.68,GBP,-107657.26,POS,London,GB,9074,user_001,,
751cf88b-1dbb-45bf-94af-3ea25b91ad58,2028-07-16,2028-07-18,Uber UK,4121,Transport,Ride Hailing,-13.77,GBP,-107671.03,E-Com,London,GB,1045,user_002,,
7607d732-1f54-4535-926e-b18951f7c8d7,2028-07-16,2028-07-17,Pret A Manger,5814,Food & Drink,Eating Out,-11.41,GBP,-107682.44,POS,London,GB,9074,user_001,,
8d6f66ac-66cc-443b-ba68-20609d93ff69,2028-07-16,2028-07-17,Shell,5541,Transport,Fuel,-31.11,GBP,-107713.55,POS,London,GB,9074,user_001,,
c2f4a37f-f012-4472-a507-492b817e4d51,2028-07-16,2028-07-17,Shell,5541,Transport,Fuel,-38.24,GBP,-107751.79,POS,London,GB,9074,user_002,,
cc919520-3a27-4073-9090-17e770586f98,2028-07-16,2028-07-18,Apple.com/bill,5734,Shopping,Electronics,-64.74,USD,-107816.53,E-Com,Cupertino,US,2219,user_001,,FX purchase 83.41 USD @ rate 1.29
ebfe6750-9790-4256-9d26-fa99197015eb,2028-07-16,2028-07-18,Amazon UK,5942,Shopping,Online Retail,-65.76,GBP,-107882.29,E-Com,London,GB,1045,user_001,,
21295815-e4f3-490d-b4ec-c0ed98741ece,2028-07-17,2028-07-18,GymBox,7997,Wellness,Gym,-47.02,GBP,-107929.31,Direct Debit,London,GB,2219,user_001,rec_3906953fd2,
d7035a83-88af-401a-b6b1-180bb5f98f59,2028-07-17,2028-07-19,O2 UK,4814,Bills,Mobile,-39.57,GBP,-107968.88,Direct Debit,Slough,GB,1045,user_001,rec_95042d8101,
e7681226-37b2-4660-b429-372cab6fefda,2028-07-18,2028-07-20,Waitrose,5411,Groceries,Supermarket,-63.15,GBP,-108032.03,POS,London,GB,2219,user_002,,
0bc1b3b4-400c-4b8c-9a1c-4389fac155f5,2028-07-19,2028-07-19,Spotify,5735,Entertainment,Subscriptions,-9.56,GBP,-108041.59,E-Com,Stockholm,SE,9074,user_001,rec_4c746d2c3b,
75ff5100-edf4-4ca8-b24a-6fc7bb8d64d5,2028-07-19,2028-07-19,Transport for London,4111,Transport,Transit,-5.49,GBP,-108047.08,POS,London,GB,2219,user_001,,
7c997e9f-a060-4d61-b2d8-c51fcadd0885,2028-07-19,2028-07-19,Uber UK,4121,Transport,Ride Hailing,-10.12,GBP,-108057.2,E-Com,London,GB,9074,user_002,,
bc6d3017-3bf6-4234-949e-1446f8344835,2028-07-20,2028-07-21,Local Market,5499,Groceries,Specialty,-16.53,GBP,-108073.73,POS,London,GB,4488,user_001,,
f23bb94b-984b-415c-a1e7-a898682f3c21,2028-07-20,2028-07-21,Local Market,5499,Groceries,Specialty,-14.36,GBP,-108088.09,POS,London,GB,4488,user_001,,
4af0c531-17f5-4740-ae53-71f35b959d22,2028-07-21,2028-07-24,Netflix,7841,Entertainment,Subscriptions,-11.34,USD,-108099.43,E-Com,Los Gatos,US,4488,user_001,rec_1bfe33738d,FX purchase 14.59 USD @ rate 1.29
5e228769-da07-41a6-a8d5-84003c25f35f,2028-07-22,2028-07-24,Local Market,5499,Groceries,Specialty,-18.5,GBP,-108117.93,POS,London,GB,9074,user_001,,
635a2bf6-5f68-43ed-ae54-b25cc21fb97c,2028-07-22,2028-07-24,Sainsbury's,5411,Groceries,Supermarket,-34.14,GBP,-108152.07,POS,London,GB,9074,user_001,,
a1960f5c-99e7-436a-aaac-7c49f55be3ca,2028-07-22,2028-07-24,Local Market,5499,Groceries,Specialty,-7.67,GBP,-108159.74,POS,London,GB,9074,user_001,,
1e40c0d6-669a-46da-b1ff-2435286ffbfd,2028-07-23,2028-07-24,Amazon UK,5942,Shopping,Online Retail,-22.03,GBP,-108181.77,E-Com,London,GB,9074,user_002,,
d7185e64-ce1d-4762-afc2-7e14bc83fb18,2028-07-23,2028-07-25,Waitrose,5411,Groceries,Supermarket,-69.77,GBP,-108251.54,POS,London,GB,1045,user_001,,
601307a8-628e-4e9e-bdee-025549fd3148,2028-07-24,2028-07-25,ATM Withdrawal,6011,Cash,ATM,-69.35,GBP,-108320.89,ATM,London,GB,9074,user_001,,
209ee2d4-a256-46e6-bafa-d05bca65316b,2028-07-25,2028-07-25,T212 Capital,6011,Income,Salary,2938.4,GBP,-105382.49,Credit,London,GB,9074,user_002,rec_c649d24d0f,
4494d7c5-d4f1-49dc-bd27-c36833b64d0e,2028-07-25,2028-07-26,Shell,5541,Transport,Fuel,-58.89,GBP,-105441.38,POS,London,GB,4488,user_001,,
19c48ae6-7445-4a3c-97e0-e411860c7582,2028-07-26,2028-07-26,Transport for London,4111,Transport,Transit,-11.68,GBP,-105453.06,POS,London,GB,2219,user_001,,
30959890-d051-4cea-8d4c-ac45bf6b7b9e,2028-07-26,2028-07-27,Waitrose,5411,Groceries,Supermarket,-35.07,GBP,-105488.13,POS,London,GB,1045,user_001,,
a51e47cf-35b2-477f-933e-37caa13c702d,2028-07-26,2028-07-27,Shell,5541,Transport,Fuel,-67.55,GBP,-105555.68,POS,London,GB,2219,user_001,,
b6ec566a-81fa-423c-96f8-246d1f70790d,2028-07-26,2028-07-26,Local Market,5499,Groceries,Specialty,-12.02,GBP,-105567.7,POS,London,GB,1045,user_001,,
e3fe51e2-0dce-4cbf-8bce-7ce35f6e243e,2028-07-26,2028-07-27,Tesco,5411,Groceries,Supermarket,-45.52,GBP,-105613.22,POS,London,GB,9074,user_001,,
700b3a77-dbdb-41e9-9fa0-553b563a84e1,2028-07-27,2028-07-28,Tesco,5411,Groceries,Supermarket,-76.01,GBP,-105689.23,POS,London,GB,9074,user_001,,
be65b60f-1833-4408-8ce1-9cec21d55363,2028-07-27,2028-07-27,Shell,5541,Transport,Fuel,-49.4,GBP,-105738.63,POS,London,GB,4488,user_001,,
e2cf12dc-a416-4b43-a1ca-01af01bce6ba,2028-07-27,2028-07-28,Uber UK,4121,Transport,Ride Hailing,-24.85,GBP,-105763.48,E-Com,London,GB,4488,user_002,,
9bc864b6-742b-484b-a17b-d84131c30ce1,2028-07-28,2028-07-31,Transport for London,4111,Transport,Transit,-9.51,GBP,-105772.99,POS,London,GB,4488,user_001,,
c0d62d09-f098-48b5-a9f4-e29af78bd8c5,2028-07-28,2028-07-28,Transport for London,4111,Transport,Transit,-8.33,GBP,-105781.32,POS,London,GB,1045,user_001,,
0b9e84e7-27d6-4006-8592-8850899f1d6f,2028-07-29,2028-07-31,Waitrose,5411,Groceries,Supermarket,-62.61,GBP,-105843.93,POS,London,GB,2219,user_001,,
9c3b48d3-2162-407a-9e36-a7b299964acd,2028-07-29,2028-07-31,Tesco,5411,Groceries,Supermarket,-71.51,GBP,-105915.44,POS,London,GB,4488,user_001,,
b127f136-bfd9-46d1-ba65-5ba6e633bf34,2028-07-29,2028-07-31,Transport for London,4111,Transport,Transit,-11.59,GBP,-105927.03,POS,London,GB,2219,user_001,,
d46b8c1d-9403-4b8c-8d62-f558421314e2,2028-07-29,2028-07-31,Tesco,5411,Groceries,Supermarket,-26.79,GBP,-105953.82,POS,London,GB,4488,user_001,,
e60cdcee-ad5d-45e6-9086-95e8cac11416,2028-07-29,2028-07-31,Transport for London,4111,Transport,Transit,-4.65,GBP,-105958.47,POS,London,GB,2219,user_001,,
4bfde001-6687-4300-b3c3-7c9f8edf1ea4,2028-07-30,2028-07-31,Shell,5541,Transport,Fuel,-66.43,GBP,-106024.9,POS,London,GB,1045,user_001,,
5582dc88-2f10-4537-84c9-804f6d4137f9,2028-07-30,2028-08-01,Transport for London,4111,Transport,Transit,-7.42,GBP,-106032.32,POS,London,GB,2219,user_001,,
df165066-3afb-422a-aed1-b6db9706c13d,2028-07-30,2028-07-31,Amazon UK,5942,Shopping,Online Retail,-71.79,GBP,-106104.11,E-Com,London,GB,4488,user_001,,
47f2c65d-ffde-42bf-bc65-cbb78221726b,2028-07-31,2028-07-31,Pret A Manger,5814,Food & Drink,Eating Out,-9.74,GBP,-106113.85,POS,London,GB,4488,user_001,,
e7bea6e6-99ec-4e7f-bb05-910bbec508bf,2028-07-31,2028-08-01,Uber UK,4121,Transport,Ride Hailing,-29.55,GBP,-106143.4,E-Com,London,GB,9074,user_002,,
0769e86e-4cc7-42c5-8e6d-e7ec38e580a1,2028-08-01,2028-08-01,Crown Estates Lettings,6513,Housing,Rent,-1573.78,GBP,-107717.18,POS,London,GB,4488,user_001,rec_19f70fbcce,
4889c422-0bb7-4a46-a2ed-7aa701d518cb,2028-08-01,2028-08-01,Waitrose,5411,Groceries,Supermarket,-87.79,GBP,-107804.97,POS,London,GB,4488,user_002,,
18bbaaed-7262-4ff7-9c6f-e9a14ada3bfc,2028-08-03,2028-08-03,Deliveroo,5812,Food & Drink,Delivery,-13.29,GBP,-107818.26,E-Com,London,GB,1045,user_001,,
c269eade-0bb0-4311-b545-2d59d8921f68,2028-08-03,2028-08-03,Local Market,5499,Groceries,Specialty,-10.22,GBP,-107828.48,POS,London,GB,4488,user_001,,
fdff8ddd-ce90-429c-84f1-9761a85ef98e,2028-08-04,2028-08-04,Uber UK,4121,Transport,Ride Hailing,-17.37,GBP,-107845.85,E-Com,London,GB,4488,user_001,,
3943b785-85c9-414c-89bc-156eb8a756df,2028-08-05,2028-08-07,Transport for London,4111,Transport,Transit,-9.29,GBP,-107855.14,POS,London,GB,9074,user_001,,
6481aef1-ec46-4ee2-ab26-3993a1820657,2028-08-05,2028-08-07,Local Market,5499,Groceries,Specialty,-16.22,GBP,-107871.36,POS,London,GB,9074,user_001,,
8f602b49-90ec-4c75-9325-8802580db148,2028-08-05,2028-08-07,Local Market,5499,Groceries,Specialty,-13.85,GBP,-107885.21,POS,London,GB,2219,user_001,,
516b63e6-503b-43d3-a973-8e6f00cde948,2028-08-06,2028-08-08,Local Market,5499,Groceries,Specialty,-21.64,GBP,-107906.85,POS,London,GB,9074,user_001,,
eaa457ff-046c-4ec3-a44c-c98aebeeacb4,2028-08-06,2028-08-08,Uber UK,4121,Transport,Ride Hailing,-24.68,GBP,-107931.53,E-Com,London,GB,9074,user_001,,
66a5ef70-189d-4dd0-90e5-1d7f4c4ba144,2028-08-07,2028-08-09,Octopus Energy,4900,Utilities,Electricity,-113.27,GBP,-108044.8,Direct Debit,London,GB,1045,user_001,rec_141a4a0666,
a302e096-01d0-47f0-ab14-718a1c24b3bb,2028-08-07,2028-08-09,Deliveroo,5812,Food & Drink,Delivery,-23.09,GBP,-108067.89,E-Com,London,GB,9074,user_002,,
f81ca632-b83f-443f-9143-d1b6d122da24,2028-08-07,2028-08-07,Tesco,5411,Groceries,Supermarket,-36.17,GBP,-108104.06,POS,London,GB,9074,user_001,,
a84ebb86-364c-45c4-b27f-3a30f0de8058,2028-08-08,2028-08-08,Airline Refund,4511,Travel,Refund,36.54,GBP,-108067.52,Credit,London,GB,2219,user_001,,Refund for Tesco
fd03ff95-8a65-4c10-9111-9cdd71189714,2028-08-08,2028-08-08,Shell,5541,Transport,Fuel,-86.15,GBP,-108153.67,POS,London,GB,1045,user_001,,
515fe69e-4bba-4321-b73c-3505733ae48c,2028-08-09,2028-08-10,Uber UK,4121,Transport,Ride Hailing,-13.53,GBP,-108167.2,E-Com,London,GB,4488,user_001,,
c7589d86-4230-4b45-a85b-da503cb727e5,2028-08-10,2028-08-11,Transport for London,4111,Transport,Transit,-9.79,GBP,-108176.99,POS,London,GB,2219,user_001,,
e2a890b5-312e-43a8-a57b-e4f4bcece646,2028-08-10,2028-08-10,Transport for London,4111,Transport,Transit,-8.43,GBP,-108185.42,POS,London,GB,4488,user_001,,
ffb14bfd-e7a2-4a3c-bab7-ea3142187ecb,2028-08-10,2028-08-11,Amazon UK,5942,Shopping,Online Retail,-91.57,GBP,-108276.99,E-Com,London,GB,4488,user_001,,
377e7ca9-103e-4da0-a587-ee1bcbdf420d,2028-08-11,2028-08-11,Thames Water,4900,Utilities,Water,-36.5,GBP,-108313.49,Direct Debit,Reading,GB,4488,user_001,rec_3a34d62842,
87f322f0-b7d7-464e-808f-8a86022848b6,2028-08-11,2028-08-14,Amazon UK,5942,Shopping,Online Retail,-93.31,GBP,-108406.8,E-Com,London,GB,9074,user_001,,
c23769af-3bf2-421e-8a40-5ebbf95de8f0,2028-08-11,2028-08-11,HM Revenue & Customs,9311,Income,Tax Refund,47.79,GBP,-108359.01,Credit,London,GB,2219,user_001,,Refund for ATM Withdrawal
2761e8cf-85df-4243-b0d8-9b63c68f3b4e,2028-08-12,2028-08-14,Local Market,5499,Groceries,Specialty,-15.56,GBP,-108374.57,POS,London,GB,1045,user_001,,
611e3042-9020-4d5b-8a08-5cbc8bdc3357,2028-08-12,2028-08-14,Tesco,5411,Groceries,Supermarket,-64.95,GBP,-108439.52,POS,London,GB,1045,user_001,,
6f8e1785-3edb-4ad4-883a-2fa070e0df59,2028-08-12,2028-08-14,Transport for London,4111,Transport,Transit,-6.9,GBP,-108446.42,POS,London,GB,9074,user_001,,
ba948f8b-4e65-4535-83b0-a731b6a1c81e,2028-08-12,2028-08-14,Transport for London,4111,Transport,Transit,-6.95,GBP,-108453.37,POS,London,GB,2219,user_002,,
71fccf39-f192-4e9d-b252-2cb89777f50f,2028-08-13,2028-08-14,Waitrose,5411,Groceries,Supermarket,-68.42,GBP,-108521.79,POS,London,GB,1045,user_002,,
8801d6d8-6868-4bc7-abd7-56290f4d1ed3,2028-08-13,2028-08-14,Sainsbury's,5411,Groceries,Supermarket,-53.75,GBP,-108575.54,POS,London,GB,9074,user_001,,
e20cba98-17b2-4fa2-99ce-7ae1f72d977d,2028-08-13,2028-08-14,Tesco,5411,Groceries,Supermarket,-59.19,GBP,-108634.73,POS,London,GB,4488,user_001,,
360e9cfc-bd8b-4c6f-a5d9-d6784a93b087,2028-08-14,2028-08-16,Apple.com/bill,5734,Shopping,Electronics,-158.33,USD,-108793.06,E-Com,Cupertino,US,2219,user_001,,FX purchase 187.3 USD @ rate 1.18
b6f492d9-4ed1-4760-958e-3e1bce0e61b9,2028-08-14,2028-08-14,City Council Tax,9399,Utilities,Council Tax,-158.66,GBP,-108951.72,Direct Debit,London,GB,9074,user_002,rec_6feaa5d43f,
842316bb-5bca-4e34-b511-b85c50486aeb,2028-08-15,2028-08-17,Apple.com/bill,5734,Shopping,Electronics,-158.74,USD,-109110.46,E-Com,Cupertino,US,4488,user_001,,FX purchase 202.82 USD @ rate 1.28
9c11f310-4ac2-45b5-b07c-cc9b32fa9221,2028-08-15,2028-08-15,Shell,5541,Transport,Fuel,-60.26,GBP,-109170.72,POS,London,GB,1045,user_001,,
c0a95f21-c947-4557-b281-87c2e30b4d26,2028-08-15,2028-08-15,ATM Withdrawal,6011,Cash,ATM,-114.68,GBP,-109285.4,ATM,London,GB,4488,user_001,,
cf699500-d186-4919-b466-7f333ee281d6,2028-08-15,2028-08-16,O2 UK,4814,Bills,Mobile,-39.44,GBP,-109324.84,Direct Debit,Slough,GB,9074,user_001,rec_95042d8101,
e10dda8e-6a0c-4e50-b15c-801fdf03ac0a,2028-08-15,2028-08-17,Deliveroo,5812,Food & Drink,Delivery,-25.09,GBP,-109349.93,E-Com,London,GB,9074,user_001,,
8442f6c8-aba5-407b-ab77-e1989c2c8c70,2028-08-16,2028-08-18,Deliveroo,5812,Food & Drink,Delivery,-26.81,GBP,-109376.74,E-Com,London,GB,2219,user_001,,
7fee1489-5df0-4b00-8456-cf227a799191,2028-08-17,2028-08-18,GymBox,7997,Wellness,Gym,-55.21,GBP,-109431.95,Direct Debit,London,GB,1045,user_001,rec_3906953fd2,
848f91b9-b530-4fe3-ba74-49e3481376f5,2028-08-17,2028-08-18,Local Market,5499,Groceries,Specialty,-21.33,GBP,-109453.28,POS,London,GB,1045,user_001,,
a2d2bf98-350c-4495-8143-2d40966ea543,2028-08-17,2028-08-17,Waitrose,5411,Groceries,Supermarket,-80.48,GBP,-109533.76,POS,London,GB,1045,user_002,,
c48ad6dc-9b37-4a0c-ad7b-dbb97fba1ee0,2028-08-17,2028-08-17,ATM Withdrawal,6011,Cash,ATM,-88.64,GBP,-109622.4,ATM,London,GB,4488,user_001,,
e766e9cc-d296-49bb-86e6-f9824ab12c3e,2028-08-18,2028-08-21,Amazon UK,5942,Shopping,Online Retail,-114.96,GBP,-109737.36,E-Com,London,GB,2219,user_001,,
b7f0fcdc-f2e2-4216-b94d-1290196bb243,2028-08-19,2028-08-21,HM Revenue & Customs,9311,Income,Tax Refund,17.93,GBP,-109719.43,Credit,London,GB,4488,user_001,,Refund for Uber UK
c2b9ad98-08f1-4f67-8560-eb402eb4d6b4,2028-08-19,2028-08-21,Uber UK,4121,Transport,Ride Hailing,-18.78,GBP,-109738.21,E-Com,London,GB,2219,user_002,,
ff5d4e16-affc-4c65-bddf-4db13940e62c,2028-08-19,2028-08-21,Sainsbury's,5411,Groceries,Supermarket,-30.0,GBP,-109768.21,POS,London,GB,4488,user_001,,
b1140c3d-2dd1-47e6-9569-b41948c5448b,2028-08-20,2028-08-22,Apple.com/bill,5734,Shopping,Electronics,-49.24,USD,-109817.45,E-Com,Cupertino,US,9074,user_001,,FX purchase 62.64 USD @ rate 1.27
b2d77020-7491-4409-9ca7-e226bac701ca,2028-08-20,2028-08-21,Local Market,5499,Groceries,Specialty,-14.57,GBP,-109832.02,POS,London,GB,1045,user_001,,
be5cc0c1-3a66-4b62-84a1-1b096c5354e8,2028-08-20,2028-08-22,Waitrose,5411,Groceries,Supermarket,-57.51,GBP,-109889.53,POS,London,GB,9074,user_001,,
c0841d73-7e06-44d3-b651-76e6fdcd804c,2028-08-20,2028-08-21,Local Market,5499,Groceries,Specialty,-12.33,GBP,-109901.86,POS,London,GB,4488,user_001,,
33130b52-8dfc-4b9e-87a9-58ea8ad69556,2028-08-21,2028-08-22,Spotify,5735,Entertainment,Subscriptions,-9.3,GBP,-109911.16,E-Com,Stockholm,SE,2219,user_002,rec_34b6e9e33f,
39ab4a8c-e8fb-4815-a617-477b348164d9,2028-08-21,2028-08-22,Sainsbury's,5411,Groceries,Supermarket,-52.8,GBP,-109963.96,POS,London,GB,2219,user_001,,
d0111e1e-1ce9-4c66-bc32-12e8aab85168,2028-08-21,2028-08-21,Transport for London,4111,Transport,Transit,-4.57,GBP,-109968.53,POS,London,GB,9074,user_002,,
e4e86e12-10d6-4695-8a38-e4ae58f98360,2028-08-21,2028-08-23,Pret A Manger,5814,Food & Drink,Eating Out,-5.51,GBP,-109974.04,POS,London,GB,9074,user_001,,
ed73ab94-4af9-4cf8-91ed-1fb6c853c0c2,2028-08-21,2028-08-23,Netflix,7841,Entertainment,Subscriptions,-15.03,GBP,-109989.07,E-Com,Los Gatos,US,9074,user_001,rec_1bfe33738d,
0329a324-4a98-4ace-b9b0-7341a9b05857,2028-08-22,2028-08-23,Local Market,5499,Groceries,Specialty,-19.58,GBP,-110008.65,POS,London,GB,1045,user_001,,
3fb3a72a-f465-4806-830b-5dea5901a31f,2028-08-23,2028-08-23,Waitrose,5411,Groceries,Supermarket,-38.04,GBP,-110046.69,POS,London,GB,9074,user_001,,
40bce551-21fc-4a5c-95b9-102f274ebda4,2028-08-23,2028-08-24,Shell,5541,Transport,Fuel,-75.47,GBP,-110122.16,POS,London,GB,9074,user_001,,
66a10bdb-5dba-4492-9715-ca6b61ab94fd,2028-08-23,2028-08-23,Airline Refund,4511,Travel,Refund,57.23,GBP,-110064.93,Credit,London,GB,1045,user_001,,Refund for Tesco
2c4704df-59a8-4d9d-aecd-6c66b31f2c8f,2028-08-25,2028-08-25,Deliveroo,5812,Food & Drink,Delivery,-24.31,GBP,-110089.24,E-Com,London,GB,9074,user_002,,
61dc0993-fbe2-4f07-a94a-4cbbac30b42c,2028-08-25,2028-08-28,Pret A Manger,5814,Food & Drink,Eating Out,-6.47,GBP,-110095.71,POS,London,GB,4488,user_001,,
67902a44-31dd-4a7e-b477-6e5bf65d5947,2028-08-25,2028-08-25,HM Revenue & Customs,9311,Income,Tax Refund,28.32,GBP,-110067.39,Credit,London,GB,4488,user_001,,Refund for Tesco
e406b4ce-8162-435c-8645-098914b78d21,2028-08-25,2028-08-28,Uber UK,4121,Transport,Ride Hailing,-8.66,GBP,-110076.05,E-Com,London,GB,1045,user_001,,
f094a8c5-2d63-45ae-b57c-a955bbd2f53e,2028-08-25,2028-08-25,T212 Capital,6011,Income,Salary,3143.93,GBP,-106932.12,Credit,London,GB,1045,user_001,rec_2ff8f778d0,
361375d8-f042-41fd-b10f-afc082cd8c60,2028-08-26,2028-08-28,Amazon UK,5942,Shopping,Online Retail,-117.49,GBP,-107049.61,E-Com,London,GB,4488,user_002,,
cb4e10d9-d3b0-4930-a616-28c2a14554a8,2028-08-26,2028-08-28,Tesco,5411,Groceries,Supermarket,-76.68,GBP,-107126.29,POS,London,GB,1045,user_001,,
d6f51673-4c19-474d-bec1-fb8f207b987f,2028-08-26,2028-08-28,Transport for London,4111,Transport,Transit,-9.77,GBP,-107136.06,POS,London,GB,4488,user_001,,
f9d65d5d-e4b5-45b2-b5df-523853fc459f,2028-08-26,2028-08-28,Shell,5541,Transport,Fuel,-93.97,GBP,-107230.03,POS,London,GB,4488,user_001,,
035dfa2d-211a-4dbb-afb5-391d4878a40c,2028-08-27,2028-08-28,Shell,5541,Transport,Fuel,-71.78,GBP,-107301.81,POS,London,GB,4488,user_002,,
1c3d58c8-f17c-4c30-8622-a8e3aa824245,2028-08-27,2028-08-29,Pret A Manger,5814,Food & Drink,Eating Out,-10.14,GBP,-107311.95,POS,London,GB,1045,user_001,,
2c310a84-44d8-4647-9719-309136b4479e,2028-08-27,2028-08-28,ATM Withdrawal,6011,Cash,ATM,-94.14,GBP,-107406.09,ATM,London,GB,4488,user_001,,
4abb55e0-fa01-4d7a-8f49-55a1b7296abc,2028-08-27,2028-08-29,Shell,5541,Transport,Fuel,-88.51,GBP,-107494.6,POS,London,GB,1045,user_001,,
74f59f1e-7299-417d-b065-b3c6f82c90e4,2028-08-27,2028-08-29,Uber UK,4121,Transport,Ride Hailing,-32.87,GBP,-107527.47,E-Com,London,GB,1045,user_001,,
7b930bf5-ce71-45d4-b353-d3b77282fa32,2028-08-27,2028-08-28,Tesco,5411,Groceries,Supermarket,-72.67,GBP,-107600.14,POS,London,GB,1045,user_001,,
09b550e8-922c-4a2e-879a-9998c04794d2,2028-08-28,2028-08-28,Transport for London,4111,Transport,Transit,-11.9,GBP,-107612.04,POS,London,GB,4488,user_001,,
12361a2c-5146-44ab-bc8b-09183f8d01a3,2028-08-28,2028-08-29,Amazon UK,5942,Shopping,Online Retail,-10.92,GBP,-107622.96,E-Com,London,GB,1045,user_001,,
7d910d35-a1c3-4f78-8322-09c632a6042a,2028-08-28,2028-08-30,Tesco,5411,Groceries,Supermarket,-52.52,GBP,-107675.48,POS,London,GB,9074,user_001,,
814a24fe-3c4f-43db-a745-224a95cae4dd,2028-08-28,2028-08-30,Waitrose,5411,Groceries,Supermarket,-54.9,GBP,-107730.38,POS,London,GB,1045,user_002,,
83e6d906-650f-46e8-bbfc-fb5e290d1144,2028-08-28,2028-08-29,Shell,5541,Transport,Fuel,-79.85,GBP,-107810.23,POS,London,GB,1045,user_001,,
e53be258-ced2-4a49-8bd9-3bacb11740cb,2028-08-28,2028-08-29,Deliveroo,5812,Food & Drink,Delivery,-18.57,GBP,-107828.8,E-Com,London,GB,2219,user_001,,
ef33bf4a-fbdc-41e7-9568-ffad54e929f7,2028-08-28,2028-08-30,Deliveroo,5812,Food & Drink,Delivery,-27.3,GBP,-107856.1,E-Com,London,GB,1045,user_001,,
64f841e1-ee11-4f03-9279-e8ff33217cab,2028-08-29,2028-08-31,Deliveroo,5812,Food & Drink,Delivery,-14.04,GBP,-107870.14,E-Com,London,GB,4488,user_001,,
77c39766-95d5-401d-aff0-2abe8bf6d948,2028-08-29,2028-08-31,Transport for London,4111,Transport,Transit,-4.49,GBP,-107874.63,POS,London,GB,1045,user_001,,
218929cd-7f8d-4dcc-9629-521abc99bda3,2028-08-30,2028-08-30,Pret A Manger,5814,Food & Drink,Eating Out,-8.69,GBP,-107883.32,POS,London,GB,1045,user_002,,
a62fa956-bb1a-4969-a25c-32bf8807f3a7,2028-08-30,2028-09-01,Amazon UK,5942,Shopping,Online Retail,-28.72,GBP,-107912.04,E-Com,London,GB,4488,user_001,,
def730dc-9187-45f5-a9d9-b6d4f20412d4,2028-08-30,2028-08-30,Waitrose,5411,Groceries,Supermarket,-63.03,GBP,-107975.07,POS,London,GB,9074,user_002,,
76965065-debf-4233-9d21-fb06465fdbc1,2028-09-01,2028-09-04,Crown Estates Lettings,6513,Housing,Rent,-1485.52,GBP,-109460.59,POS,London,GB,2219,user_001,rec_19f70fbcce,
b4353c31-47c5-4118-a956-1ccd4a6c6ad3,2028-09-01,2028-09-01,Uber UK,4121,Transport,Ride Hailing,-33.96,GBP,-109494.55,E-Com,London,GB,9074,user_002,,
abf95e7c-96fa-488d-9ca1-ab3b38d081d4,2028-09-02,2028-09-04,Waitrose,5411,Groceries,Supermarket,-27.65,GBP,-109522.2,POS,London,GB,4488,user_001,,
c4f23d37-bbeb-4f08-8a5f-f6f669c5d147,2028-09-02,2028-09-04,Waitrose,5411,Groceries,Supermarket,-61.33,GBP,-109583.53,POS,London,GB,4488,user_002,,
cb73c97c-f370-4ab2-8701-630100c9aa72,2028-09-02,2028-09-04,Amazon UK,5942,Shopping,Online Retail,-37.28,GBP,-109620.81,E-Com,London,GB,9074,user_001,,
d3683bf8-2639-4247-a7cb-af3a826b9db5,2028-09-02,2028-09-04,Uber UK,4121,Transport,Ride Hailing,-13.66,GBP,-109634.47,E-Com,London,GB,1045,user_001,,
109d6835-c488-4724-982a-895276ab045c,2028-09-03,2028-09-04,Uber UK,4121,Transport,Ride Hailing,-34.11,GBP,-109668.58,E-Com,London,GB,2219,user_001,,
1e3e5436-ca8b-4764-a858-2ab0d187cf76,2028-09-03,2028-09-04,Pret A Manger,5814,Food & Drink,Eating Out,-8.49,GBP,-109677.07,POS,London,GB,4488,user_001,,
21652152-f444-41d9-9669-d684d4f259fc,2028-09-04,2028-09-05,Apple.com/bill,5734,Shopping,Electronics,-100.5,GBP,-109777.57,E-Com,Cupertino,US,4488,user_001,,
26164912-58e3-495e-83d7-6dfabec57732,2028-09-05,2028-09-06,Amazon UK,5942,Shopping,Online Retail,-12.53,GBP,-109790.1,E-Com,London,GB,1045,user_001,,
2f5bab82-64cc-4ea0-a186-675b19782b56,2028-09-07,2028-09-11,Sainsbury's,5411,Groceries,Supermarket,-57.76,GBP,-109847.86,POS,London,GB,4488,user_001,,
39a88a3c-6647-48da-be15-633771fdd94a,2028-09-07,2028-09-11,Octopus Energy,4900,Utilities,Electricity,-143.25,GBP,-109991.11,Direct Debit,London,GB,1045,user_001,rec_141a4a0666,
99db2f08-244d-4196-88d2-5ec6d7a6cfea,2028-09-07,2028-09-11,Local Market,5499,Groceries,Specialty,-7.68,GBP,-109998.79,POS,London,GB,4488,user_001,,
e635943a-2076-4e29-9bef-4de50e947181,2028-09-07,2028-09-08,Waitrose,5411,Groceries,Supermarket,-35.05,GBP,-110033.84,POS,London,GB,2219,user_001,,
40e04680-3ca8-4d16-aedd-4147d7ce68c2,2028-09-08,2028-09-11,Waitrose,5411,Groceries,Supermarket,-39.66,GBP,-110073.5,POS,London,GB,9074,user_002,,
96f4bea2-8303-41f1-b89b-28ba6e591f50,2028-09-08,2028-09-11,Sainsbury's,5411,Groceries,Supermarket,-39.73,GBP,-110113.23,POS,London,GB,2219,user_001,,
d930ef65-a86b-42f9-be32-f76690bc02a6,2028-09-08,2028-09-11,Sainsbury's,5411,Groceries,Supermarket,-24.46,GBP,-110137.69,POS,London,GB,2219,user_001,,
fc9a5463-59a4-41f9-9585-aa7f7fe2ecf9,2028-09-08,2028-09-11,Uber UK,4121,Transport,Ride Hailing,-28.63,GBP,-110166.32,E-Com,London,GB,2219,user_001,,
80bc990d-6407-42eb-ba83-2b325e13f843,2028-09-09,2028-09-11,Transport for London,4111,Transport,Transit,-8.92,GBP,-110175.24,POS,London,GB,1045,user_001,,
ee8e10b9-bbc5-4bb8-84ee-91fdf02bffb9,2028-09-09,2028-09-11,Tesco,5411,Groceries,Supermarket,-31.27,GBP,-110206.51,POS,London,GB,4488,user_001,,
153bb13c-75e6-4c27-aa08-259a4bb51e21,2028-09-10,2028-09-12,Pret A Manger,5814,Food & Drink,Eating Out,-9.59,GBP,-110216.1,POS,London,GB,4488,user_002,,
4794dd30-a27f-4483-b50f-23137d5441a4,2028-09-10,2028-09-12,Sainsbury's,5411,Groceries,Supermarket,-27.99,GBP,-110244.09,POS,London,GB,4488,user_001,,
bdcf2fb4-a800-4982-8c6e-46300aee1997,2028-09-10,2028-09-12,Shell,5541,Transport,Fuel,-61.88,GBP,-110305.97,POS,London,GB,4488,user_001,,
e81199c2-c47e-4854-a857-f7db889ce5a4,2028-09-11,2028-09-12,Thames Water,4900,Utilities,Water,-44.39,GBP,-110350.36,Direct Debit,Reading,GB,9074,user_002,rec_954d02400c,
780e6174-d920-4494-b947-6833e292d106,2028-09-12,2028-09-13,Amazon UK,5942,Shopping,Online Retail,-106.22,GBP,-110456.58,E-Com,London,GB,9074,user_001,,
b09a433e-7fa7-4f8e-86d8-8228a11f13fe,2028-09-12,2028-09-13,Waitrose,5411,Groceries,Supermarket,-73.25,GBP,-110529.83,POS,London,GB,4488,user_001,,
0d274b98-6a4c-4f0b-8608-c8db8405fe58,2028-09-13,2028-09-13,City Council Tax,9399,Utilities,Council Tax,-174.95,GBP,-110704.78,Direct Debit,London,GB,9074,user_001,rec_f531495db5,
23fc051f-fa33-40db-8997-7179ff606490,2028-09-13,2028-09-13,Apple.com/bill,5734,Shopping,Electronics,-191.96,USD,-110896.74,E-Com,Cupertino,US,1045,user_002,,FX purchase 235.95 USD @ rate 1.23
2af6f247-c655-454c-abe4-00d233e561a6,2028-09-13,2028-09-15,Apple.com/bill,5734,Shopping,Electronics,-80.26,GBP,-110977.0,E-Com,Cupertino,US,1045,user_001,,
e5054016-7328-4e10-8756-8ba7e9a918a4,2028-09-13,2028-09-15,Apple.com/bill,5734,Shopping,Electronics,-136.09,GBP,-111113.09,E-Com,Cupertino,US,9074,user_001,,
f953eddd-e55b-4c4b-8bef-b695423e14a2,2028-09-13,2028-09-14,Tesco,5411,Groceries,Supermarket,-66.88,GBP,-111179.97,POS,London,GB,1045,user_001,,
275e0ccd-7b85-4b30-a23f-1cf2ddf1a08b,2028-09-14,2028-09-18,Apple.com/bill,5734,Shopping,Electronics,-55.05,GBP,-111235.02,E-Com,Cupertino,US,1045,user_002,,
2e9713be-feac-434e-a006-8fe091625176,2028-09-14,2028-09-15,Pret A Manger,5814,Food & Drink,Eating Out,-6.05,GBP,-111241.07,POS,London,GB,1045,user_001,,
46e10881-9203-4dec-a965-247a44764038,2028-09-14,2028-09-18,Local Market,5499,Groceries,Specialty,-17.38,GBP,-111258.45,POS,London,GB,2219,user_001,,
64b90c56-e9e9-4f1a-a99f-85393f6f3957,2028-09-14,2028-09-18,Tesco,5411,Groceries,Supermarket,-22.92,GBP,-111281.37,POS,London,GB,4488,user_001,,
6b69cd68-eb3d-4b46-968f-bbddc2ae2825,2028-09-14,2028-09-18,Amazon UK,5942,Shopping,Online Retail,-29.26,GBP,-111310.63,E-Com,London,GB,2219,user_001,,
b0529148-1a9a-461f-9479-f5db8a63a9ed,2028-09-15,2028-09-18,O2 UK,4814,Bills,Mobile,-38.07,GBP,-111348.7,Direct Debit,Slough,GB,4488,user_002,rec_d2dce4c42f,
e01131e1-67e7-4dc0-b102-c23271f02278,2028-09-15,2028-09-18,Deliveroo,5812,Food & Drink,Delivery,-26.66,GBP,-111375.36,E-Com,London,GB,4488,user_001,,
3c65ee40-2f57-4129-8702-6e4246f2d109,2028-09-16,2028-09-18,Deliveroo,5812,Food & Drink,Delivery,-30.99,GBP,-111406.35,E-Com,London,GB,1045,user_001,,
86bdd06a-59a2-477b-bfb0-898708e67163,2028-09-16,2028-09-18,Pret A Manger,5814,Food & Drink,Eating Out,-6.97,GBP,-111413.32,POS,London,GB,4488,user_001,,
31d24b59-4aa1-4e6b-bd4d-589427769554,2028-09-17,2028-09-18,Transport for London,4111,Transport,Transit,-3.97,GBP,-111417.29,POS,London,GB,4488,user_001,,
3d12954c-2f9d-4bd6-80fc-300215434baf,2028-09-17,2028-09-18,Amazon UK,5942,Shopping,Online Retail,-54.17,GBP,-111471.46,E-Com,London,GB,9074,user_001,,
7bd42947-5ac4-4db2-a409-2c60da0c3108,2028-09-17,2028-09-18,British Airways,4511,Travel,Flights,-257.28,GBP,-111728.74,E-Com,London,GB,4488,user_001,,Holiday booking
91d47561-b15a-4633-bb4f-0328aa3f01d1,2028-09-18,2028-09-18,GymBox,7997,Wellness,Gym,-45.24,GBP,-111773.98,Direct Debit,London,GB,4488,user_001,rec_3906953fd2,
5793ed31-c3ce-4878-b9f5-3745bdb178a7,2028-09-19,2028-09-19,Deliveroo,5812,Food & Drink,Delivery,-26.0,GBP,-111799.98,E-Com,London,GB,4488,user_001,,
b86729e7-6d85-4ac4-8037-46c934bf592b,2028-09-19,2028-09-20,Spotify,5735,Entertainment,Subscriptions,-8.24,GBP,-111808.22,E-Com,Stockholm,SE,9074,user_001,rec_4c746d2c3b,
db551eeb-2c26-4407-8469-3bcc964a35a5,2028-09-19,2028-09-21,ATM Withdrawal,6011,Cash,ATM,-90.3,GBP,-111898.52,ATM,London,GB,9074,user_001,,
f09b3697-a534-4f2c-81a9-2c5409ed36ea,2028-09-19,2028-09-21,Apple.com/bill,5734,Shopping,Electronics,-56.03,GBP,-111954.55,E-Com,Cupertino,US,2219,user_002,,
41497d39-d147-48b3-93b6-53168ed1e89a,2028-09-21,2028-09-22,Netflix,7841,Entertainment,Subscriptions,-15.38,GBP,-111969.93,E-Com,Los Gatos,US,9074,user_001,rec_1bfe33738d,
059085c0-0e67-4787-8c1e-d056d66b403e,2028-09-23,2028-09-25,Local Market,5499,Groceries,Specialty,-11.07,GBP,-111981.0,POS,London,GB,9074,user_001,,
166855f3-68b6-435b-bf92-ae52136db2bd,2028-09-23,2028-09-25,Local Market,5499,Groceries,Specialty,-18.94,GBP,-111999.94,POS,London,GB,2219,user_001,,
6301c058-4900-4dc9-bee7-e38b4ad65314,2028-09-23,2028-09-25,Apple.com/bill,5734,Shopping,Electronics,-114.83,USD,-112114.77,E-Com,Cupertino,US,2219,user_001,,FX purchase 144.73 USD @ rate 1.26
7f242eb3-817a-442b-a740-73feb10dee4f,2028-09-23,2028-09-25,Uber UK,4121,Transport,Ride Hailing,-21.72,GBP,-112136.49,E-Com,London,GB,4488,user_001,,
c0707c63-9b2c-47ac-8ea8-26d9d6a4b140,2028-09-23,2028-09-25,Amazon UK,5942,Shopping,Online Retail,-48.34,GBP,-112184.83,E-Com,London,GB,4488,user_002,,
c16271e3-c799-4c31-807b-04b29b8119aa,2028-09-23,2028-09-25,Tesco,5411,Groceries,Supermarket,-51.11,GBP,-112235.94,POS,London,GB,2219,user_002,,
723efd52-3148-406f-b4b3-6b0abd146c81,2028-09-24,2028-09-25,Tesco,5411,Groceries,Supermarket,-33.95,GBP,-112269.89,POS,London,GB,1045,user_001,,
0a679953-db22-4fe6-b3f3-6fb7e2b121fd,2028-09-25,2028-09-25,Sainsbury's,5411,Groceries,Supermarket,-39.98,GBP,-112309.87,POS,London,GB,1045,user_001,,
46e17f01-89c8-40df-a0da-c6d69e3f3424,2028-09-25,2028-09-25,T212 Capital,6011,Income,Salary,3385.17,GBP,-108924.7,Credit,London,GB,2219,user_001,rec_2ff8f778d0,
49b53950-ad2e-4aac-8496-67958867e97e,2028-09-25,2028-09-27,Amazon UK,5942,Shopping,Online Retail,-57.17,GBP,-108981.87,E-Com,London,GB,2219,user_001,,
61b6a89f-3e84-471a-b931-b0fe9dd6bf17,2028-09-25,2028-09-27,Local Market,5499,Groceries,Specialty,-10.6,GBP,-108992.47,POS,London,GB,2219,user_001,,
0a27caf1-62dd-48d0-90f5-808d793fba41,2028-09-26,2028-09-26,Airline Refund,4511,Travel,Refund,3.67,GBP,-108988.8,Credit,London,GB,1045,user_001,,Refund for Pret A Manger
1006a137-8974-4d87-94fa-9dd84853d387,2028-09-26,2028-09-27,Deliveroo,5812,Food & Drink,Delivery,-31.09,GBP,-109019.89,E-Com,London,GB,9074,user_002,,
8fd1ffa9-6513-4c82-b6ef-630db98056cc,2028-09-26,2028-09-27,Apple.com/bill,5734,Shopping,Electronics,-58.9,GBP,-109078.79,E-Com,Cupertino,US,9074,user_001,,
072d3971-3c86-4ff0-9cf9-fb270a53c858,2028-09-28,2028-09-29,Apple.com/bill,5734,Shopping,Electronics,-147.95,GBP,-109226.74,E-Com,Cupertino,US,1045,user_001,,
5cbb7e40-d26b-4412-9d72-96f82d276bad,2028-09-28,2028-10-02,Amazon UK,5942,Shopping,Online Retail,-104.24,GBP,-109330.98,E-Com,London,GB,1045,user_002,,
1d59d7cc-b8e8-47bd-9ec7-363f43a3fc98,2028-09-29,2028-10-02,Amazon UK,5942,Shopping,Online Retail,-12.63,GBP,-109343.61,E-Com,London,GB,2219,user_002,,
1d78a3d2-4731-4bd8-842f-6eb6bcd8c4b8,2028-09-29,2028-10-02,Apple.com/bill,5734,Shopping,Electronics,-124.99,GBP,-109468.6,E-Com,Cupertino,US,2219,user_001,,
89110933-b7fe-41de-bead-770dfffc091f,2028-09-29,2028-10-02,Local Market,5499,Groceries,Specialty,-11.81,GBP,-109480.41,POS,London,GB,2219,user_002,,
12b773ca-c4b7-4847-9f79-4dcf187e5058,2028-09-30,2028-10-02,Apple.com/bill,5734,Shopping,Electronics,-188.54,USD,-109668.95,E-Com,Cupertino,US,9074,user_001,,FX purchase 241.05 USD @ rate 1.28
1b9e8cd2-5058-4c76-baca-25a6d372a12f,2028-09-30,2028-10-02,Tesco,5411,Groceries,Supermarket,-23.95,GBP,-109692.9,POS,London,GB,9074,user_001,,
48ab681c-3499-4679-ae4f-90b67ea2515f,2028-09-30,2028-10-02,Tesco,5411,Groceries,Supermarket,-49.7,GBP,-109742.6,POS,London,GB,9074,user_001,,
ccb83b43-901d-4ab0-ab53-b326b00065dc,2028-09-30,2028-10-02,Deliveroo,5812,Food & Drink,Delivery,-12.06,GBP,-109754.66,E-Com,London,GB,9074,user_001,,
42d34d6b-3e78-4317-be11-0aa8988bc78d,2028-10-01,2028-10-03,Deliveroo,5812,Food & Drink,Delivery,-30.35,GBP,-109785.01,E-Com,London,GB,9074,user_001,,
77b6dae5-ca36-46a8-acc3-a377847b3efb,2028-10-01,2028-10-02,HM Revenue & Customs,9311,Income,Tax Refund,19.69,GBP,-109765.32,Credit,London,GB,4488,user_002,,Refund for Amazon UK
d4d3f887-4a02-4aaa-b08b-6b0edc4ee762,2028-10-01,2028-10-02,Shell,5541,Transport,Fuel,-31.93,GBP,-109797.25,POS,London,GB,4488,user_001,,
f537a56e-58e2-4b25-a245-8d87647b2c9e,2028-10-01,2028-10-02,Transport for London,4111,Transport,Transit,-7.92,GBP,-109805.17,POS,London,GB,4488,user_001,,
2f36fd25-bf75-46fe-b526-520fc464dd8c,2028-10-02,2028-10-04,Crown Estates Lettings,6513,Housing,Rent,-1472.26,GBP,-111277.43,POS,London,GB,1045,user_001,rec_19f70fbcce,
51bb289a-fde3-4301-9005-a7f1eab6538b,2028-10-02,2028-10-04,Local Market,5499,Groceries,Specialty,-15.75,GBP,-111293.18,POS,London,GB,2219,user_002,,
b665b59d-ce8c-47c8-b06f-8d032711c9e0,2028-10-02,2028-10-03,Local Market,5499,Groceries,Specialty,-16.57,GBP,-111309.75,POS,London,GB,4488,user_001,,
9e9bbc07-2b56-4912-b5fb-e5d96b4096ce,2028-10-03,2028-10-03,Local Market,5499,Groceries,Specialty,-6.83,GBP,-111316.58,POS,London,GB,1045,user_001,,
121dab0e-3c49-482b-87af-79ca37f0ed54,2028-10-04,2028-10-04,Uber UK,4121,Transport,Ride Hailing,-34.39,GBP,-111350.97,E-Com,London,GB,9074,user_001,,
47175265-7383-4abe-92b3-456795310a9e,2028-10-04,2028-10-04,Tesco,5411,Groceries,Supermarket,-77.53,GBP,-111428.5,POS,London,GB,9074,user_001,,
4e144473-1ffd-4200-ae7f-745f07ff7534,2028-10-04,2028-10-05,Tesco,5411,Groceries,Supermarket,-37.73,GBP,-111466.23,POS,London,GB,1045,user_001,,
93675583-b959-4d16-ae1b-ea5984182b20,2028-10-04,2028-10-04,Local Market,5499,Groceries,Specialty,-9.33,GBP,-111475.56,POS,London,GB,4488,user_001,,
9bb11796-a069-4e27-89fb-6f929c50acd7,2028-10-04,2028-10-05,Shell,5541,Transport,Fuel,-62.74,GBP,-111538.3,POS,London,GB,2219,user_001,,
a4f51af1-8126-44f8-bffa-2d26011280e9,2028-10-04,2028-10-06,Apple.com/bill,5734,Shopping,Electronics,-204.22,USD,-111742.52,E-Com,Cupertino,US,4488,user_001,,FX purchase 249.52 USD @ rate 1.22
e7405df7-6e38-42f8-b25d-ac2f6b2c1717,2028-10-04,2028-10-04,Tesco,5411,Groceries,Supermarket,-68.07,GBP,-111810.59,POS,London,GB,2219,user_002,,
60a5c60c-f68e-4a95-b564-213250e2db23,2028-10-05,2028-10-09,Waitrose,5411,Groceries,Supermarket,-27.78,GBP,-111838.37,POS,London,GB,2219,user_002,,
67bb14b1-8d6d-4a09-9dc1-d721d8d920f3,2028-10-05,2028-10-06,Tesco,5411,Groceries,Supermarket,-63.53,GBP,-111901.9,POS,London,GB,2219,user_001,,
d2ed1cf2-557a-4798-a81c-fa5b0d53f36b,2028-10-05,2028-10-05,Pret A Manger,5814,Food & Drink,Eating Out,-10.88,GBP,-111912.78,POS,London,GB,9074,user_002,,
3442e1fd-e9c6-4890-83d8-0cb9b5b32e2c,2028-10-06,2028-10-06,HM Revenue & Customs,9311,Income,Tax Refund,65.63,GBP,-111847.15,Credit,London,GB,9074,user_001,,Refund for Apple.com/bill
4033c81c-0091-4aff-bb3d-7e6c50eebefe,2028-10-06,2028-10-09,Shell,5541,Transport,Fuel,-73.04,GBP,-111920.19,POS,London,GB,9074,user_001,,
1c849ce4-cd3b-4069-ad69-5620a93aa238,2028-10-07,2028-10-09,Pret A Manger,5814,Food & Drink,Eating Out,-8.77,GBP,-111928.96,POS,London,GB,4488,user_002,,
557ae432-6197-458c-b14a-156dab2bd357,2028-10-07,2028-10-09,Shell,5541,Transport,Fuel,-43.27,GBP,-111972.23,POS,London,GB,4488,user_001,,
ad1d05b5-311e-4589-b8ac-ae466d91d79d,2028-10-07,2028-10-09,Amazon UK,5942,Shopping,Online Retail,-74.52,GBP,-112046.75,E-Com,London,GB,4488,user_002,,
d61a3d41-94a7-4df3-99f8-d5c723ba42cf,2028-10-07,2028-10-09,Uber UK,4121,Transport,Ride Hailing,-8.06,GBP,-112054.81,E-Com,London,GB,4488,user_001,,
e49b10aa-3000-4ee4-9af8-a01b22282a7f,2028-10-07,2028-10-09,Uber UK,4121,Transport,Ride Hailing,-16.04,GBP,-112070.85,E-Com,London,GB,4488,user_001,,
13e1737b-af61-4ac7-9012-25015cc1cc87,2028-10-08,2028-10-09,Uber UK,4121,Transport,Ride Hailing,-8.12,GBP,-112078.97,E-Com,London,GB,9074,user_002,,
33974991-d104-4463-8db7-edfc53d40515,2028-10-08,2028-10-09,Deliveroo,5812,Food & Drink,Delivery,-24.7,GBP,-112103.67,E-Com,London,GB,2219,user_001,,
81bd43b8-8ea3-4a22-bf36-b99add0f9dec,2028-10-08,2028-10-10,Sainsbury's,5411,Groceries,Supermarket,-60.54,GBP,-112164.21,POS,London,GB,1045,user_001,,
a8633391-9e82-4f0a-88ef-77ebaec9e751,2028-10-08,2028-10-09,Deliveroo,5812,Food & Drink,Delivery,-20.2,GBP,-112184.41,E-Com,London,GB,9074,user_001,,
dd4dc82c-a959-45cd-9e87-366789a5cfd5,2028-10-08,2028-10-10,Deliveroo,5812,Food & Drink,Delivery,-13.7,GBP,-112198.11,E-Com,London,GB,1045,user_001,,
28819728-e615-4be8-a9b1-f5e1c70ebdc0,2028-10-09,2028-10-11,Octopus Energy,4900,Utilities,Electricity,-135.09,GBP,-112333.2,Direct Debit,London,GB,2219,user_002,rec_09c3f12b18,
70629d07-46e9-4a79-90e8-0ebf9f92594c,2028-10-09,2028-10-10,Local Market,5499,Groceries,Specialty,-8.38,GBP,-112341.58,POS,London,GB,1045,user_001,,
fca0c873-5fd7-4a0e-a71c-2da741abf42d,2028-10-09,2028-10-11,Local Market,5499,Groceries,Specialty,-13.04,GBP,-112354.62,POS,London,GB,2219,user_001,,
643808c4-668a-4d1b-86de-8a34316a8564,2028-10-11,2028-10-12,Thames Water,4900,Utilities,Water,-36.79,GBP,-112391.41,Direct Debit,Reading,GB,1045,user_001,rec_3a34d62842,
105245ab-02db-41c2-82d0-6e3298562428,2028-10-13,2028-10-16,Deliveroo,5812,Food & Drink,Delivery,-15.59,GBP,-112407.0,E-Com,London,GB,9074,user_001,,
21f0a06a-631a-47bf-b8cf-229ff83cff68,2028-10-13,2028-10-16,City Council Tax,9399,Utilities,Council Tax,-166.42,GBP,-112573.42,Direct Debit,London,GB,4488,user_001,rec_f531495db5,
80fdeba7-82a2-4393-9af9-cbbe954c69aa,2028-10-14,2028-10-16,Transport for London,4111,Transport,Transit,-7.2,GBP,-112580.62,POS,London,GB,4488,user_002,,
cee6aa6c-576c-44e0-a87d-46364b19d89a,2028-10-14,2028-10-16,Amazon UK,5942,Shopping,Online Retail,-110.81,GBP,-112691.43,E-Com,London,GB,1045,user_001,,
744804ae-7072-4c02-bbcc-f1fef8970072,2028-10-15,2028-10-16,Tesco,5411,Groceries,Supermarket,-33.39,GBP,-112724.82,POS,London,GB,1045,user_002,,
80e974f4-991f-47d3-b277-97c56a4cf01e,2028-10-15,2028-10-17,Tesco,5411,Groceries,Supermarket,-59.13,GBP,-112783.95,POS,London,GB,1045,user_001,,
bca56c51-e022-4eed-9478-221ac0e30292,2028-10-15,2028-10-16,Waitrose,5411,Groceries,Supermarket,-25.04,GBP,-112808.99,POS,London,GB,4488,user_001,,
01d9dfb8-1bdd-47a2-bcc8-6607ffb0a1af,2028-10-16,2028-10-16,Deliveroo,5812,Food & Drink,Delivery,-28.08,GBP,-112837.07,E-Com,London,GB,2219,user_001,,
16005edd-bc71-4a74-845d-4fc368da75ef,2028-10-16,2028-10-18,O2 UK,4814,Bills,Mobile,-52.27,GBP,-112889.34,Direct Debit,Slough,GB,2219,user_001,rec_95042d8101,
a877d19f-d268-4372-8532-dd60cc5aeb7f,2028-10-16,2028-10-18,Local Market,5499,Groceries,Specialty,-15.42,GBP,-112904.76,POS,London,GB,9074,user_002,,
2c52fda1-5089-438f-a134-249bc73bd5b5,2028-10-17,2028-10-18,GymBox,7997,Wellness,Gym,-55.6,GBP,-112960.36,Direct Debit,London,GB,1045,user_001,rec_3906953fd2,
c97114e4-989d-4775-8d43-b94472cd65f9,2028-10-17,2028-10-17,Apple.com/bill,5734,Shopping,Electronics,-89.64,GBP,-113050.0,E-Com,Cupertino,US,4488,user_001,,
cf9194ce-98d6-4669-922f-12b710583af8,2028-10-17,2028-10-19,Apple.com/bill,5734,Shopping,Electronics,-205.6,GBP,-113255.6,E-Com,Cupertino,US,9074,user_001,,
df5c01b4-6858-4682-b03d-a2209d24fb76,2028-10-17,2028-10-19,ATM Withdrawal,6011,Cash,ATM,-82.74,GBP,-113338.34,ATM,London,GB,9074,user_001,,
a9e632e5-d5c3-4ead-b1f1-842edf5ed361,2028-10-18,2028-10-20,Pret A Manger,5814,Food & Drink,Eating Out,-11.2,GBP,-113349.54,POS,London,GB,4488,user_001,,
2c1dd684-ec5a-438e-9b91-e9e1a51d25d7,2028-10-19,2028-10-23,Uber UK,4121,Transport,Ride Hailing,-10.61,GBP,-113360.15,E-Com,London,GB,2219,user_001,,
c923d6d2-c52d-49c9-9c10-b847cf92973b,2028-10-19,2028-10-23,Tesco,5411,Groceries,Supermarket,-63.65,GBP,-113423.8,POS,London,GB,2219,user_001,,
cc36152c-302f-47fc-a0bd-eb18d6d38462,2028-10-19,2028-10-20,Spotify,5735,Entertainment,Subscriptions,-9.18,EUR,-113432.98,E-Com,Stockholm,SE,4488,user_002,rec_34b6e9e33f,FX purchase 9.91 EUR @ rate 1.08
29ffe46b-32b3-4c21-89e1-d93f91842d3f,2028-10-20,2028-10-23,Deliveroo,5812,Food & Drink,Delivery,-33.54,GBP,-113466.52,E-Com,London,GB,9074,user_001,,
dbe76b9b-6849-429a-8603-bef2605c9bcd,2028-10-20,2028-10-23,Apple.com/bill,5734,Shopping,Electronics,-27.37,USD,-113493.89,E-Com,Cupertino,US,1045,user_001,,FX purchase 34.13 USD @ rate 1.25
f749fda8-8602-4389-919e-d91a69c087f3,2028-10-20,2028-10-23,Tesco,5411,Groceries,Supermarket,-29.3,GBP,-113523.19,POS,London,GB,2219,user_001,,
754864a1-60a3-49fa-a17e-7a5eec05d66c,2028-10-21,2028-10-23,Apple.com/bill,5734,Shopping,Electronics,-131.5,USD,-113654.69,E-Com,Cupertino,US,9074,user_002,,FX purchase 155.94 USD @ rate 1.19
772b8356-6d07-4693-b026-f012e93cfa94,2028-10-21,2028-10-23,Sainsbury's,5411,Groceries,Supermarket,-65.48,GBP,-113720.17,POS,London,GB,4488,user_001,,
cad4b36b-9c12-4b6e-957b-8913d3866772,2028-10-21,2028-10-23,Apple.com/bill,5734,Shopping,Electronics,-193.97,GBP,-113914.14,E-Com,Cupertino,US,9074,user_001,,
da9913d6-a290-46fc-ae98-7fb465a78983,2028-10-21,2028-10-23,Transport for London,4111,Transport,Transit,-11.65,GBP,-113925.79,POS,London,GB,1045,user_002,,
2aa19d88-c30f-4658-a127-1469d93d0fac,2028-10-22,2028-10-23,Sainsbury's,5411,Groceries,Supermarket,-45.36,GBP,-113971.15,POS,London,GB,2219,user_001,,
5d106045-79d0-431a-8f9e-155ce7d2ec21,2028-10-22,2028-10-23,Waitrose,5411,Groceries,Supermarket,-43.6,GBP,-114014.75,POS,London,GB,1045,user_001,,
6dfe0c3c-6072-43f6-bf7d-2fab9cac9be4,2028-10-22,2028-10-23,Waitrose,5411,Groceries,Supermarket,-56.96,GBP,-114071.71,POS,London,GB,4488,user_001,,
8da9467e-6b08-49ca-9b20-3d1c2b72eebf,2028-10-22,2028-10-23,ATM Withdrawal,6011,Cash,ATM,-94.57,GBP,-114166.28,ATM,London,GB,1045,user_002,,
52f87fe0-61f2-4163-9d5f-4a5199a28680,2028-10-23,2028-10-23,Uber UK,4121,Transport,Ride Hailing,-22.8,GBP,-114189.08,E-Com,London,GB,1045,user_001,,
944400b0-5b19-42ee-8964-cf1413ed9cb1,2028-10-23,2028-10-24,Netflix,7841,Entertainment,Subscriptions,-11.44,GBP,-114200.52,E-Com,Los Gatos,US,2219,user_002,rec_d9322c1382,
ce9127e0-bfc8-4517-84d7-fbe5b7ff71fc,2028-10-24,2028-10-25,Tesco,5411,Groceries,Supermarket,-61.43,GBP,-114261.95,POS,London,GB,1045,user_002,,
e5f65abc-88ac-4e2c-a6d3-13ad8b6a63c2,2028-10-24,2028-10-25,Shell,5541,Transport,Fuel,-69.61,GBP,-114331.56,POS,London,GB,2219,user_001,,
2e8dbb5f-7c86-4bbe-9c1a-0a44a3c97ca1,2028-10-25,2028-10-26,Tesco,5411,Groceries,Supermarket,-31.89,GBP,-114363.45,POS,London,GB,1045,user_001,,
8e7ed01c-5589-4f2f-ab7f-3101fefbc43f,2028-10-25,2028-10-25,T212 Capital,6011,Income,Salary,3363.45,GBP,-111000.0,Credit,London,GB,2219,user_001,rec_2ff8f778d0,
c1a6a911-0dd9-426f-9c3f-f1b200a30e07,2028-10-25,2028-10-26,Apple.com/bill,5734,Shopping,Electronics,-132.3,USD,-111132.3,E-Com,Cupertino,US,1045,user_001,,FX purchase 165.75 USD @ rate 1.25
d54eff87-198d-450d-b011-0026eb71a75d,2028-10-26,2028-10-30,Uber UK,4121,Transport,Ride Hailing,-16.01,GBP,-111148.31,E-Com,London,GB,4488,user_001,,
1b03e22e-1f55-4f81-8c4a-722b7d03d55b,2028-10-27,2028-10-27,Sainsbury's,5411,Groceries,Supermarket,-35.01,GBP,-111183.32,POS,London,GB,9074,user_001,,
204c8267-70da-4458-b8c1-baca6778c59e,2028-10-27,2028-10-30,Pret A Manger,5814,Food & Drink,Eating Out,-8.48,GBP,-111191.8,POS,London,GB,9074,user_001,,
405df0af-d9ec-4961-ae76-186b86a3eb6e,2028-10-27,2028-10-30,Local Market,5499,Groceries,Specialty,-6.32,GBP,-111198.12,POS,London,GB,4488,user_001,,
08bf49af-3287-4da9-8891-eeaf7447219a,2028-10-28,2028-10-30,Local Market,5499,Groceries,Specialty,-9.5,GBP,-111207.62,POS,London,GB,2219,user_001,,
551aaacd-1823-4566-9c9b-783fd561b101,2028-10-28,2028-10-30,Deliveroo,5812,Food & Drink,Delivery,-14.2,GBP,-111221.82,E-Com,London,GB,9074,user_002,,
9e0785e7-5fe2-40f6-9b10-abe39eb81237,2028-10-28,2028-10-30,Apple.com/bill,5734,Shopping,Electronics,-113.98,GBP,-111335.8,E-Com,Cupertino,US,9074,user_001,,
d622c916-7875-447a-8c5b-58a3d406c4dc,2028-10-28,2028-10-30,Apple.com/bill,5734,Shopping,Electronics,-21.23,GBP,-111357.03,E-Com,Cupertino,US,2219,user_001,,
eeb38427-03ec-401c-9545-c4d945dd865d,2028-10-28,2028-10-30,Tesco,5411,Groceries,Supermarket,-63.51,GBP,-111420.54,POS,London,GB,1045,user_001,,
028c22be-2cf5-4f36-afef-d38c65eae29c,2028-10-29,2028-10-30,Deliveroo,5812,Food & Drink,Delivery,-26.78,GBP,-111447.32,E-Com,London,GB,4488,user_001,,
6541d712-d9ab-4d0e-a1e5-8084ca4a9e53,2028-10-29,2028-10-31,Transport for London,4111,Transport,Transit,-9.11,GBP,-111456.43,POS,London,GB,2219,user_001,,
cde5db37-c620-462b-b8fb-755f845cc483,2028-10-29,2028-10-30,Sainsbury's,5411,Groceries,Supermarket,-56.79,GBP,-111513.22,POS,London,GB,4488,user_001,,
1d5545ec-1c9f-4898-97cf-617d14cedfda,2028-10-30,2028-10-31,Amazon UK,5942,Shopping,Online Retail,-82.74,GBP,-111595.96,E-Com,London,GB,9074,user_001,,
85c536c7-f38e-4768-ac84-b1cd39a14379,2028-10-30,2028-10-31,Apple.com/bill,5734,Shopping,Electronics,-179.22,GBP,-111775.18,E-Com,Cupertino,US,4488,user_001,,
5643546e-e3bf-4efa-aecc-2bb9df97bcb2,2028-11-01,2028-11-01,ATM Withdrawal,6011,Cash,ATM,-91.1,GBP,-111866.28,ATM,London,GB,1045,user_001,,
795c817a-3fd2-4da9-a667-23b20dff87c6,2028-11-01,2028-11-01,Amazon UK,5942,Shopping,Online Retail,-18.03,GBP,-111884.31,E-Com,London,GB,4488,user_001,,
8ed1d6a4-9289-4daa-bff2-3d731c6368c3,2028-11-01,2028-11-01,Crown Estates Lettings,6513,Housing,Rent,-1538.61,GBP,-113422.92,POS,London,GB,2219,user_001,rec_19f70fbcce,
f60241da-7aef-4416-951c-6a5df0c9ef19,2028-11-01,2028-11-02,Amazon UK,5942,Shopping,Online Retail,-47.79,GBP,-113470.71,E-Com,London,GB,9074,user_001,,
5ab9a801-0a05-40c9-be33-3ef12954684f,2028-11-03,2028-11-06,Tesco,5411,Groceries,Supermarket,-26.23,GBP,-113496.94,POS,London,GB,2219,user_001,,
64b1f10e-e254-4db1-98a7-76bff27d7d4d,2028-11-03,2028-11-03,Transport for London,4111,Transport,Transit,-9.29,GBP,-113506.23,POS,London,GB,1045,user_001,,
a6eb8936-7d23-4bfb-916f-ea261ce4f92c,2028-11-03,2028-11-06,Transport for London,4111,Transport,Transit,-10.81,GBP,-113517.04,POS,London,GB,1045,user_001,,
234b0df5-6fcd-4e72-98e0-697e85b6d33e,2028-11-04,2028-11-06,Deliveroo,5812,Food & Drink,Delivery,-12.44,GBP,-113529.48,E-Com,London,GB,9074,user_001,,
78ae9606-4884-46d5-8e34-c381d41fb607,2028-11-04,2028-11-06,Amazon UK,5942,Shopping,Online Retail,-64.43,GBP,-113593.91,E-Com,London,GB,4488,user_001,,
97a9dd2a-defb-4e8f-bfcb-2b545038ad96,2028-11-04,2028-11-06,Sainsbury's,5411,Groceries,Supermarket,-39.47,GBP,-113633.38,POS,London,GB,1045,user_001,,
12580b7d-5d86-414a-bf20-082530315184,2028-11-05,2028-11-07,Local Market,5499,Groceries,Specialty,-10.46,GBP,-113643.84,POS,London,GB,1045,user_001,,
532a4634-7b33-41b4-b15a-5fba4c05990e,2028-11-05,2028-11-06,Shell,5541,Transport,Fuel,-73.03,GBP,-113716.87,POS,London,GB,4488,user_001,,
840a277e-ff08-4ab4-bc4d-b3dfbfe3e71d,2028-11-05,2028-11-06,Local Market,5499,Groceries,Specialty,-17.63,GBP,-113734.5,POS,London,GB,4488,user_001,,
a72037c9-e2c7-40c7-8aba-74acc739e519,2028-11-05,2028-11-06,Amazon UK,5942,Shopping,Online Retail,-14.44,GBP,-113748.94,E-Com,London,GB,1045,user_002,,
ba6f6db2-fbb2-46b8-93a2-495598fbae73,2028-11-05,2028-11-06,Apple.com/bill,5734,Shopping,Electronics,-77.96,GBP,-113826.9,E-Com,Cupertino,US,4488,user_001,,
07f90eed-45ab-4e23-9e01-6518481d764f,2028-11-06,2028-11-07,British Airways,4511,Travel,Flights,-189.82,USD,-114016.72,E-Com,London,GB,2219,user_001,,Holiday booking
566151b2-aaf1-475b-92c7-5573da9b64b4,2028-11-06,2028-11-06,Sainsbury's,5411,Groceries,Supermarket,-50.01,GBP,-114066.73,POS,London,GB,1045,user_002,,
753b25f8-87d6-45e1-a534-7c3b33a70ead,2028-11-06,2028-11-06,Amazon UK,5942,Shopping,Online Retail,-79.7,GBP,-114146.43,E-Com,London,GB,1045,user_001,,
81a5759e-85a1-4f09-ac17-688eca48a2ae,2028-11-06,2028-11-08,Tesco,5411,Groceries,Supermarket,-74.64,GBP,-114221.07,POS,London,GB,2219,user_002,,
946eda80-b24d-47b5-84e4-86340570dcad,2028-11-06,2028-11-07,Tesco,5411,Groceries,Supermarket,-24.68,GBP,-114245.75,POS,London,GB,1045,user_001,,
4c19f708-8a2a-4a78-96f6-3a0674c1e521,2028-11-07,2028-11-07,Octopus Energy,4900,Utilities,Electricity,-136.98,GBP,-114382.73,Direct Debit,London,GB,4488,user_001,rec_141a4a0666,
60df24ef-2f83-49c2-af37-aed2cb6afa27,2028-11-07,2028-11-08,Tesco,5411,Groceries,Supermarket,-42.16,GBP,-114424.89,POS,London,GB,2219,user_001,,
5a91a81b-b7d9-4682-a561-80b525aed0fa,2028-11-08,2028-11-10,Waitrose,5411,Groceries,Supermarket,-84.42,GBP,-114509.31,POS,London,GB,1045,user_001,,
7c51debf-8f9c-4e5a-ae1a-70a20dc62338,2028-11-08,2028-11-08,Waitrose,5411,Groceries,Supermarket,-25.84,GBP,-114535.15,POS,London,GB,9074,user_001,,
7feeb7b7-fd26-4471-82d4-984d1711b2b8,2028-11-09,2028-11-10,Local Market,5499,Groceries,Specialty,-17.98,GBP,-114553.13,POS,London,GB,2219,user_001,,
f0bd30a0-f485-4bf3-b66a-7a6afcc86d07,2028-11-09,2028-11-10,Shell,5541,Transport,Fuel,-88.49,GBP,-114641.62,POS,London,GB,4488,user_001,,
efea8a12-6283-4e01-b012-1fc03c1a46ab,2028-11-10,2028-11-13,ATM Withdrawal,6011,Cash,ATM,-112.98,GBP,-114754.6,ATM,London,GB,9074,user_001,,
1a19f753-5857-4361-90f5-805d5aa4bc7c,2028-11-11,2028-11-13,Transport for London,4111,Transport,Transit,-3.96,GBP,-114758.56,POS,London,GB,4488,user_001,,
350d2d0b-3606-4e29-8f8e-62e9abfd58dc,2028-11-11,2028-11-13,Waitrose,5411,Groceries,Supermarket,-47.3,GBP,-114805.86,POS,London,GB,9074,user_001,,
36e77e88-51cd-4188-9cfc-c70a42cc6fec,2028-11-11,2028-11-13,Waitrose,5411,Groceries,Supermarket,-71.11,GBP,-114876.97,POS,London,GB,4488,user_002,,
380d0bec-293c-4a22-af1c-30b8b21c1d93,2028-11-11,2028-11-13,Shell,5541,Transport,Fuel,-40.86,GBP,-114917.83,POS,London,GB,2219,user_001,,
495ca50d-10b8-4d84-8d64-4ec8f70f25ed,2028-11-11,2028-11-13,Transport for London,4111,Transport,Transit,-7.42,GBP,-114925.25,POS,London,GB,1045,user_001,,
e537f85f-228f-4a34-bb1a-783058a64dcc,2028-11-11,2028-11-13,Deliveroo,5812,Food & Drink,Delivery,-31.83,GBP,-114957.08,E-Com,London,GB,9074,user_002,,
8caa7043-103c-4554-a951-337bfbfa0eba,2028-11-12,2028-11-13,Sainsbury's,5411,Groceries,Supermarket,-35.16,GBP,-114992.24,POS,London,GB,1045,user_002,,
e57de9c2-80cc-460c-a4a9-8cbfb5ba6a87,2028-11-12,2028-11-14,Shell,5541,Transport,Fuel,-41.14,GBP,-115033.38,POS,London,GB,2219,user_001,,
69144445-769a-4ec9-9d2d-4b8f81b01878,2028-11-13,2028-11-14,Thames Water,4900,Utilities,Water,-37.47,GBP,-115070.85,Direct Debit,Reading,GB,4488,user_001,rec_3a34d62842,
cd280797-5e41-4056-87cc-27ab347423ce,2028-11-13,2028-11-13,Apple.com/bill,5734,Shopping,Electronics,-5.49,GBP,-115076.34,E-Com,Cupertino,US,9074,user_001,,
fc112ecd-65ee-432a-bab0-e182c00b2830,2028-11-13,2028-11-13,City Council Tax,9399,Utilities,Council Tax,-179.89,GBP,-115256.23,Direct Debit,London,GB,4488,user_001,rec_f531495db5,
4b1d5803-df27-448a-9982-17cf2f9b26bc,2028-11-15,2028-11-17,O2 UK,4814,Bills,Mobile,-35.1,GBP,-115291.33,Direct Debit,Slough,GB,4488,user_002,rec_d2dce4c42f,
ab41757d-c6a7-41c8-9b31-5ac30c48464b,2028-11-15,2028-11-16,Amazon UK,5942,Shopping,Online Retail,-27.74,GBP,-115319.07,E-Com,London,GB,4488,user_002,,
bb3de985-30e3-4828-9c51-68a5434ac663,2028-11-15,2028-11-16,Waitrose,5411,Groceries,Supermarket,-28.46,GBP,-115347.53,POS,London,GB,9074,user_001,,
f5dfe2ec-0590-4f03-8531-6adc60a659b1,2028-11-15,2028-11-16,ATM Withdrawal,6011,Cash,ATM,-82.15,GBP,-115429.68,ATM,London,GB,1045,user_001,,
e5e0a319-8779-4103-abf4-0c827a542d4a,2028-11-16,2028-11-20,Shell,5541,Transport,Fuel,-50.57,GBP,-115480.25,POS,London,GB,4488,user_001,,
fb061cbb-46d7-401e-851b-f7d199358612,2028-11-16,2028-11-17,Transport for London,4111,Transport,Transit,-11.07,GBP,-115491.32,POS,London,GB,2219,user_002,,
082d7a16-d022-440f-8e5a-a9820dcfdae5,2028-11-17,2028-11-17,Transport for London,4111,Transport,Transit,-10.6,GBP,-115501.92,POS,London,GB,1045,user_001,,
3858d260-f07d-492b-92d2-9a23895d2b83,2028-11-17,2028-11-20,GymBox,7997,Wellness,Gym,-51.82,GBP,-115553.74,Direct Debit,London,GB,4488,user_001,rec_3906953fd2,
c2658a3c-ac1f-466d-bfae-a47bce7932dd,2028-11-17,2028-11-17,Sainsbury's,5411,Groceries,Supermarket,-34.21,GBP,-115587.95,POS,London,GB,9074,user_001,,
cea0412e-13d5-4d9a-b008-1b7924e52aab,2028-11-17,2028-11-20,Apple.com/bill,5734,Shopping,Electronics,-106.01,USD,-115693.96,E-Com,Cupertino,US,4488,user_001,,FX purchase 128.52 USD @ rate 1.21
9ac2fb82-a0fd-438a-b2de-5c7d710c0b1c,2028-11-18,2028-11-20,Local Market,5499,Groceries,Specialty,-11.53,GBP,-115705.49,POS,London,GB,9074,user_001,,
a3f7b803-b89b-41ea-96dc-e9f4dd3832bb,2028-11-18,2028-11-20,Sainsbury's,5411,Groceries,Supermarket,-44.09,GBP,-115749.58,POS,London,GB,2219,user_001,,
624148a2-93fb-4b22-8818-9ed61fd78b8a,2028-11-19,2028-11-20,Waitrose,5411,Groceries,Supermarket,-27.98,GBP,-115777.56,POS,London,GB,9074,user_001,,
6a2eae2e-f8ae-456d-b109-5d4cee237cc4,2028-11-19,2028-11-20,Apple.com/bill,5734,Shopping,Electronics,-103.12,GBP,-115880.68,E-Com,Cupertino,US,2219,user_001,,
f4301bc9-f080-4b0a-837f-5bd4a6561a2f,2028-11-19,2028-11-20,Transport for London,4111,Transport,Transit,-8.88,GBP,-115889.56,POS,London,GB,1045,user_001,,
a2835402-117e-417d-91f5-8dee159e22e1,2028-11-20,2028-11-21,Spotify,5735,Entertainment,Subscriptions,-9.03,GBP,-115898.59,E-Com,Stockholm,SE,9074,user_001,rec_4c746d2c3b,
e7c9d139-8890-4de4-b574-811e51a291cf,2028-11-20,2028-11-21,Deliveroo,5812,Food & Drink,Delivery,-23.93,GBP,-115922.52,E-Com,London,GB,1045,user_001,,
35cd01f8-a5f3-4209-b89f-79bfcd60b168,2028-11-21,2028-11-22,Netflix,7841,Entertainment,Subscriptions,-11.75,GBP,-115934.27,E-Com,Los Gatos,US,1045,user_002,rec_d9322c1382,
88e6e670-ef11-4650-a785-2ad7f32dff1f,2028-11-21,2028-11-22,Pret A Manger,5814,Food & Drink,Eating Out,-9.39,GBP,-115943.66,POS,London,GB,9074,user_001,,
cde14515-f15d-43bf-bf56-901ab0470172,2028-11-21,2028-11-22,Transport for London,4111,Transport,Transit,-5.9,GBP,-115949.56,POS,London,GB,2219,user_001,,
2f5fed59-1d01-4b47-9a34-174e8d222b60,2028-11-22,2028-11-23,Sainsbury's,5411,Groceries,Supermarket,-52.91,GBP,-116002.47,POS,London,GB,4488,user_002,,
becb125d-cc4b-43ae-8dab-cd92ab562dd4,2028-11-22,2028-11-22,Pret A Manger,5814,Food & Drink,Eating Out,-10.47,GBP,-116012.94,POS,London,GB,4488,user_001,,
c236b5b5-36ca-4836-b158-755dbc63fc35,2028-11-22,2028-11-22,Local Market,5499,Groceries,Specialty,-20.6,GBP,-116033.54,POS,London,GB,4488,user_001,,
c7cbb11c-f6a2-4c12-8122-0368cf511b05,2028-11-22,2028-11-22,Sainsbury's,5411,Groceries,Supermarket,-43.44,GBP,-116076.98,POS,London,GB,9074,user_002,,
1cbbda6b-1b7e-44df-8d37-1cd74c064346,2028-11-23,2028-11-23,ATM Withdrawal,6011,Cash,ATM,-80.88,GBP,-116157.86,ATM,London,GB,4488,user_001,,
3e28f0b1-321a-4593-baec-3ee8a60b07d4,2028-11-23,2028-11-23,Transport for London,4111,Transport,Transit,-9.22,GBP,-116167.08,POS,London,GB,2219,user_001,,
495b1bbc-bf9a-4c21-8424-baa06e0e8eec,2028-11-23,2028-11-27,Transport for London,4111,Transport,Transit,-8.57,GBP,-116175.65,POS,London,GB,1045,user_001,,
6a82d028-498a-4fa7-83b5-2c0b096179e1,2028-11-23,2028-11-27,Tesco,5411,Groceries,Supermarket,-77.34,GBP,-116252.99,POS,London,GB,9074,user_001,,
9ab2b676-b30b-4551-8db8-e778bb63a5a1,2028-11-23,2028-11-23,Sainsbury's,5411,Groceries,Supermarket,-34.08,GBP,-116287.07,POS,London,GB,9074,user_001,,
1013cd5c-bea7-4fe6-9bd3-fa7168014be3,2028-11-24,2028-11-27,Shell,5541,Transport,Fuel,-63.73,GBP,-116350.8,POS,London,GB,1045,user_001,,
b3a664ad-9fed-4755-b660-e3a6f472d154,2028-11-24,2028-11-24,T212 Capital,6011,Income,Salary,3244.72,GBP,-113106.08,Credit,London,GB,4488,user_001,rec_2ff8f778d0,
07bc3276-6830-4caa-9fca-876c3816992a,2028-11-25,2028-11-27,Shell,5541,Transport,Fuel,-40.73,GBP,-113146.81,POS,London,GB,1045,user_001,,
36041fce-e3b6-408d-bb80-3ca0ef8a7986,2028-11-25,2028-11-27,Apple.com/bill,5734,Shopping,Electronics,-106.04,USD,-113252.85,E-Com,Cupertino,US,9074,user_001,,FX purchase 130.92 USD @ rate 1.23
6bdaf59c-b5de-4369-875a-2a016a30e86f,2028-11-25,2028-11-27,Shell,5541,Transport,Fuel,-33.87,GBP,-113286.72,POS,London,GB,4488,user_001,,
73f0930c-514e-47f0-ad72-312be2d949cf,2028-11-25,2028-11-27,Sainsbury's,5411,Groceries,Supermarket,-64.97,GBP,-113351.69,POS,London,GB,9074,user_001,,
b882a03c-b9c1-4a43-9a4a-956ac5611175,2028-11-25,2028-11-27,Pret A Manger,5814,Food & Drink,Eating Out,-6.63,GBP,-113358.32,POS,London,GB,1045,user_001,,
e65a72c6-0e98-492a-8569-6624295bdd12,2028-11-25,2028-11-27,Sainsbury's,5411,Groceries,Supermarket,-41.3,GBP,-113399.62,POS,London,GB,9074,user_002,,
0c92049a-2bc4-47ed-b0dc-c1b8faa482d1,2028-11-26,2028-11-28,Amazon UK,5942,Shopping,Online Retail,-50.59,GBP,-113450.21,E-Com,London,GB,9074,user_002,,
9120c997-bf0b-4fb9-82e0-b8b22b9ede04,2028-11-26,2028-11-27,Shell,5541,Transport,Fuel,-73.64,GBP,-113523.85,POS,London,GB,2219,user_002,,
be8ec66f-571d-4dc1-9e26-d85a86553281,2028-11-26,2028-11-27,Sainsbury's,5411,Groceries,Supermarket,-61.09,GBP,-113584.94,POS,London,GB,9074,user_001,,
e1c183b2-fb97-44f6-9434-e51689a2da74,2028-11-26,2028-11-28,Uber UK,4121,Transport,Ride Hailing,-22.38,GBP,-113607.32,E-Com,London,GB,9074,user_001,,
18a7e75d-20b0-4602-a48f-cedf0077a735,2028-11-27,2028-11-29,Uber UK,4121,Transport,Ride Hailing,-27.21,GBP,-113634.53,E-Com,London,GB,4488,user_001,,
6f498165-7422-4d9d-b3bd-966bdb0b50b4,2028-11-28,2028-11-29,Uber UK,4121,Transport,Ride Hailing,-22.49,GBP,-113657.02,E-Com,London,GB,2219,user_001,,
0d94b920-d5d8-42c0-8492-0bc3ebdf2f7f,2028-11-29,2028-11-29,Local Market,5499,Groceries,Specialty,-9.45,GBP,-113666.47,POS,London,GB,9074,user_001,,
4e30ec27-8727-48e1-8bc5-b7b00b572617,2028-11-29,2028-12-01,Sainsbury's,5411,Groceries,Supermarket,-36.39,GBP,-113702.86,POS,London,GB,4488,user_001,,
00198507-807a-42a0-be37-f19f2e444f00,2028-11-30,2028-12-01,Deliveroo,5812,Food & Drink,Delivery,-12.23,GBP,-113715.09,E-Com,London,GB,4488,user_001,,
1c3fd391-a829-4fc3-b3e6-20d6d7d0511d,2028-11-30,2028-11-30,Sainsbury's,5411,Groceries,Supermarket,-30.86,GBP,-113745.95,POS,London,GB,9074,user_001,,
b44d21c6-8a96-4c76-81c2-ed3b3c7e276a,2028-11-30,2028-12-01,ATM Withdrawal,6011,Cash,ATM,-98.02,GBP,-113843.97,ATM,London,GB,4488,user_001,,
2c1f81e0-104c-4bb6-9e90-1d23db27fa23,2028-12-01,2028-12-04,Shell,5541,Transport,Fuel,-89.29,GBP,-113933.26,POS,London,GB,1045,user_002,,
3e5eda8d-7aac-4cc3-aeea-384192517bcf,2028-12-01,2028-12-04,Sainsbury's,5411,Groceries,Supermarket,-28.13,GBP,-113961.39,POS,London,GB,4488,user_001,,
3f2f86cd-1aab-4526-b4b9-cb9deff0bd70,2028-12-01,2028-12-01,Tesco,5411,Groceries,Supermarket,-43.47,GBP,-114004.86,POS,London,GB,4488,user_001,,
80cac098-d834-4fbb-9151-12dd8e4cf8cb,2028-12-01,2028-12-04,Crown Estates Lettings,6513,Housing,Rent,-1561.57,GBP,-115566.43,POS,London,GB,4488,user_001,rec_19f70fbcce,
9fd8d3f5-1ec6-4210-abe0-6df098151059,2028-12-01,2028-12-01,Local Market,5499,Groceries,Specialty,-19.23,GBP,-115585.66,POS,London,GB,2219,user_001,,
b1deedb0-4fe7-4db7-9008-4639cd97febc,2028-12-01,2028-12-04,Pret A Manger,5814,Food & Drink,Eating Out,-6.28,GBP,-115591.94,POS,London,GB,9074,user_001,,
46c5e563-4881-42f9-a6a6-87cda486de6c,2028-12-02,2028-12-04,Waitrose,5411,Groceries,Supermarket,-52.34,GBP,-115644.28,POS,London,GB,9074,user_001,,
57b41c45-62b2-45e7-b96f-3cc2506da9c7,2028-12-02,2028-12-04,Sainsbury's,5411,Groceries,Supermarket,-23.58,GBP,-115667.86,POS,London,GB,4488,user_001,,
186fa8d5-879d-4def-95e4-1347961f5eb7,2028-12-03,2028-12-04,Waitrose,5411,Groceries,Supermarket,-74.61,GBP,-115742.47,POS,London,GB,1045,user_001,,
41c260de-41c7-4bb6-b01d-5763e7d7a26a,2028-12-03,2028-12-04,Uber UK,4121,Transport,Ride Hailing,-9.9,GBP,-115752.37,E-Com,London,GB,4488,user_001,,
4c1e013c-9c99-473e-bac6-84041c5cb81c,2028-12-03,2028-12-05,Waitrose,5411,Groceries,Supermarket,-50.95,GBP,-115803.32,POS,London,GB,4488,user_001,,
74ddc789-9b5d-4d84-9280-ba8d284e9322,2028-12-03,2028-12-04,Apple.com/bill,5734,Shopping,Electronics,-85.2,GBP,-115888.52,E-Com,Cupertino,US,2219,user_001,,
a067e87d-4cc0-4621-8b48-edf35363235b,2028-12-03,2028-12-04,Local Market,5499,Groceries,Specialty,-9.66,GBP,-115898.18,POS,London,GB,9074,user_001,,
c862c356-a15a-4479-92f6-02cd158b9d8c,2028-12-03,2028-12-04,Amazon UK,5942,Shopping,Online Retail,-64.11,GBP,-115962.29,E-Com,London,GB,2219,user_001,,
d1dce55a-3ca9-49b4-84b3-76ccd1aba4a9,2028-12-03,2028-12-04,Local Market,5499,Groceries,Specialty,-11.1,GBP,-115973.39,POS,London,GB,9074,user_001,,
023e2390-80f5-4ce0-8882-79e153d5756e,2028-12-05,2028-12-05,Deliveroo,5812,Food & Drink,Delivery,-24.61,GBP,-115998.0,E-Com,London,GB,1045,user_001,,
37ffae22-3927-49df-837a-a5b7f5a0c8cd,2028-12-05,2028-12-05,Transport for London,4111,Transport,Transit,-5.75,GBP,-116003.75,POS,London,GB,1045,user_001,,
d9b22344-afd3-405f-b496-799fbbf467b4,2028-12-05,2028-12-07,Apple.com/bill,5734,Shopping,Electronics,-91.6,GBP,-116095.35,E-Com,Cupertino,US,1045,user_001,,
72e3e179-a596-4ee5-a8f7-0bf3e676f371,2028-12-06,2028-12-06,Local Market,5499,Groceries,Specialty,-16.43,GBP,-116111.78,POS,London,GB,9074,user_001,,
f95171de-504e-4b16-90a0-611eeac336e0,2028-12-06,2028-12-07,Deliveroo,5812,Food & Drink,Delivery,-13.97,GBP,-116125.75,E-Com,London,GB,4488,user_001,,
7da19671-896a-42ae-adb1-afb3f5583a5d,2028-12-07,2028-12-07,Octopus Energy,4900,Utilities,Electricity,-112.46,GBP,-116238.21,Direct Debit,London,GB,4488,user_001,rec_141a4a0666,
c20ce9cb-8fb1-4889-8d4d-f54ad8b2f369,2028-12-07,2028-12-08,Tesco,5411,Groceries,Supermarket,-20.39,GBP,-116258.6,POS,London,GB,4488,user_002,,
fc6eeb27-ebd1-4c0f-b5ca-2e56df44e38a,2028-12-07,2028-12-07,Deliveroo,5812,Food & Drink,Delivery,-27.04,GBP,-116285.64,E-Com,London,GB,4488,user_002,,
015d20e2-7808-459c-8e1f-5db2b086fa75,2028-12-08,2028-12-11,Pret A Manger,5814,Food & Drink,Eating Out,-6.29,GBP,-116291.93,POS,London,GB,4488,user_001,,
47c391d0-4381-4804-a165-0b24c55b15f9,2028-12-08,2028-12-11,Waitrose,5411,Groceries,Supermarket,-48.37,GBP,-116340.3,POS,London,GB,2219,user_001,,
d7f8815d-c988-4592-a32d-315f214072aa,2028-12-08,2028-12-11,Deliveroo,5812,Food & Drink,Delivery,-27.56,GBP,-116367.86,E-Com,London,GB,2219,user_001,,
43187cde-d1a1-46b0-8354-21aad899cf15,2028-12-09,2028-12-11,Transport for London,4111,Transport,Transit,-4.8,GBP,-116372.66,POS,London,GB,1045,user_001,,
b0b37913-d8a6-4549-898e-807aa1bd9ad6,2028-12-09,2028-12-11,Apple.com/bill,5734,Shopping,Electronics,-90.23,GBP,-116462.89,E-Com,Cupertino,US,2219,user_001,,
eb86d47e-e7cd-4149-a14e-fcbc314fcaad,2028-12-10,2028-12-11,Sainsbury's,5411,Groceries,Supermarket,-29.06,GBP,-116491.95,POS,London,GB,9074,user_001,,
32658814-8e29-4837-b45b-4a2c826ba993,2028-12-11,2028-12-13,Uber UK,4121,Transport,Ride Hailing,-11.9,GBP,-116503.85,E-Com,London,GB,2219,user_001,,
7026d74e-9197-48d1-8af4-51beae0b0456,2028-12-11,2028-12-12,Thames Water,4900,Utilities,Water,-37.04,GBP,-116540.89,Direct Debit,Reading,GB,4488,user_002,rec_954d02400c,
9f8d18a4-c792-4f14-a3e1-fb725598fdc6,2028-12-11,2028-12-11,Pret A Manger,5814,Food & Drink,Eating Out,-5.68,GBP,-116546.57,POS,London,GB,1045,user_001,,
524d846d-b678-40fc-8d6e-a3d248646b0d,2028-12-12,2028-12-14,Pret A Manger,5814,Food & Drink,Eating Out,-10.42,GBP,-116556.99,POS,London,GB,9074,user_002,,
872d7431-5ef6-4201-82a6-9658254a5543,2028-12-12,2028-12-12,Deliveroo,5812,Food & Drink,Delivery,-23.29,GBP,-116580.28,E-Com,London,GB,4488,user_001,,
5d6924e1-86cb-4c53-a316-ba961bae004f,2028-12-13,2028-12-15,Apple.com/bill,5734,Shopping,Electronics,-141.72,USD,-116722.0,E-Com,Cupertino,US,1045,user_002,,FX purchase 172.4 USD @ rate 1.22
5e637061-a9d9-462a-8e35-ae68223e9128,2028-12-13,2028-12-14,Tesco,5411,Groceries,Supermarket,-74.81,GBP,-116796.81,POS,London,GB,1045,user_001,,
f0ad0aae-0d80-4a5d-9ba6-960184937f56,2028-12-13,2028-12-13,Amazon UK,5942,Shopping,Online Retail,-110.95,GBP,-116907.76,E-Com,London,GB,9074,user_001,,
fee04977-dc2c-498f-bc1d-4c4f0f12217e,2028-12-13,2028-12-15,City Council Tax,9399,Utilities,Council Tax,-173.02,GBP,-117080.78,Direct Debit,London,GB,4488,user_001,rec_f531495db5,
17c66d1c-1ef4-4414-9bc0-a4734f8c527b,2028-12-14,2028-12-14,Amazon UK,5942,Shopping,Online Retail,-117.03,GBP,-117197.81,E-Com,London,GB,4488,user_001,,
86cdee70-9a78-494d-b8a6-6180c8624a63,2028-12-14,2028-12-18,Amazon UK,5942,Shopping,Online Retail,-41.81,GBP,-117239.62,E-Com,London,GB,9074,user_002,,
e913d27a-8704-4c6f-badc-6248fd1c6981,2028-12-14,2028-12-15,Deliveroo,5812,Food & Drink,Delivery,-17.46,GBP,-117257.08,E-Com,London,GB,1045,user_001,,
48218072-d82e-43fc-9fda-e1b8934d5629,2028-12-15,2028-12-18,Sainsbury's,5411,Groceries,Supermarket,-56.05,GBP,-117313.13,POS,London,GB,1045,user_001,,
8e33b66a-123f-4844-9065-9e0c052a4d29,2028-12-15,2028-12-18,Waitrose,5411,Groceries,Supermarket,-57.47,GBP,-117370.6,POS,London,GB,4488,user_001,,
9c9694e4-a103-4d6e-8fdb-58d49e5c144f,2028-12-15,2028-12-18,Pret A Manger,5814,Food & Drink,Eating Out,-11.19,GBP,-117381.79,POS,London,GB,1045,user_002,,
ecfabdc1-fe12-4716-a667-fafe69fa8c7e,2028-12-15,2028-12-15,O2 UK,4814,Bills,Mobile,-47.61,GBP,-117429.4,Direct Debit,Slough,GB,1045,user_001,rec_95042d8101,
753d3cde-0fd5-426a-a321-a4984d5f4577,2028-12-16,2028-12-18,Deliveroo,5812,Food & Drink,Delivery,-14.05,GBP,-117443.45,E-Com,London,GB,9074,user_002,,
837c7c06-7b70-415c-b7ef-903e92ca568f,2028-12-16,2028-12-18,Waitrose,5411,Groceries,Supermarket,-80.91,GBP,-117524.36,POS,London,GB,2219,user_001,,
a3378d2f-61c1-4f19-a732-f786d99dd072,2028-12-16,2028-12-18,Pret A Manger,5814,Food & Drink,Eating Out,-5.88,GBP,-117530.24,POS,London,GB,2219,user_002,,
b0657569-091c-43ea-a7e3-7e22f4495b48,2028-12-16,2028-12-18,Uber UK,4121,Transport,Ride Hailing,-19.72,GBP,-117549.96,E-Com,London,GB,2219,user_001,,
b7b50ffd-2279-40b7-9c91-50ca84a30340,2028-12-16,2028-12-18,Shell,5541,Transport,Fuel,-92.88,GBP,-117642.84,POS,London,GB,4488,user_001,,
d90b7003-13d3-4740-9e6c-4940f98dfeb5,2028-12-16,2028-12-18,Amazon UK,5942,Shopping,Online Retail,-87.78,GBP,-117730.62,E-Com,London,GB,4488,user_002,,
e2a6f3af-4eee-4c55-99d5-f3ad625fb9f6,2028-12-16,2028-12-18,Amazon UK,5942,Shopping,Online Retail,-94.07,GBP,-117824.69,E-Com,London,GB,9074,user_001,,
5ef9ce60-64aa-47f2-9438-20dcba0bc962,2028-12-17,2028-12-18,Sainsbury's,5411,Groceries,Supermarket,-51.6,GBP,-117876.29,POS,London,GB,1045,user_001,,
7b749d93-c16e-4c52-8c67-51fc763213d4,2028-12-17,2028-12-18,Amazon UK,5942,Shopping,Online Retail,-106.47,GBP,-117982.76,E-Com,London,GB,9074,user_001,,
b654cb3b-f233-49f1-beb3-384aafbe3c2c,2028-12-17,2028-12-18,Amazon UK,5942,Shopping,Online Retail,-35.84,GBP,-118018.6,E-Com,London,GB,1045,user_001,,
1a304a9a-85f2-4f00-a542-b6950d986d32,2028-12-18,2028-12-19,GymBox,7997,Wellness,Gym,-62.87,GBP,-118081.47,Direct Debit,London,GB,9074,user_001,rec_3906953fd2,
9cec4357-edc0-4b96-a1a7-17bb0cd3315a,2028-12-18,2028-12-19,Sainsbury's,5411,Groceries,Supermarket,-62.18,GBP,-118143.65,POS,London,GB,4488,user_001,,
d40c161f-48ee-4474-8d11-78fbe451b696,2028-12-18,2028-12-18,Shell,5541,Transport,Fuel,-86.72,GBP,-118230.37,POS,London,GB,4488,user_001,,
4dc8ab5a-1775-46f9-a0af-64caa8cbf543,2028-12-19,2028-12-21,Uber UK,4121,Transport,Ride Hailing,-20.67,GBP,-118251.04,E-Com,London,GB,1045,user_001,,
6f51c524-7683-43b3-978a-8636131d6427,2028-12-19,2028-12-21,Shell,5541,Transport,Fuel,-72.56,GBP,-118323.6,POS,London,GB,1045,user_001,,
9f8cb4f9-cb77-48b5-bf6f-f46a015d95f4,2028-12-19,2028-12-21,Spotify,5735,Entertainment,Subscriptions,-8.33,GBP,-118331.93,E-Com,Stockholm,SE,4488,user_002,rec_34b6e9e33f,
d519b9e6-73c8-4386-817f-d220e7fd83ba,2028-12-19,2028-12-19,Tesco,5411,Groceries,Supermarket,-21.05,GBP,-118352.98,POS,London,GB,1045,user_001,,
5b785f51-8a06-45a8-ab64-ac6f065df420,2028-12-20,2028-12-20,Amazon UK,5942,Shopping,Online Retail,-107.79,GBP,-118460.77,E-Com,London,GB,4488,user_001,,
111d0132-6751-4514-98c7-f46dde1c1789,2028-12-21,2028-12-25,Netflix,7841,Entertainment,Subscriptions,-15.21,USD,-118475.98,E-Com,Los Gatos,US,9074,user_001,rec_1bfe33738d,FX purchase 18.85 USD @ rate 1.24
207d69da-d9ca-44db-a16c-30d5efa58aed,2028-12-21,2028-12-21,Shell,5541,Transport,Fuel,-88.2,GBP,-118564.18,POS,London,GB,1045,user_001,,
96718d7e-b9c7-402d-bc21-720dba2dcc65,2028-12-21,2028-12-25,Sainsbury's,5411,Groceries,Supermarket,-24.24,GBP,-118588.42,POS,London,GB,2219,user_001,,
ad60a8f3-4d5e-4fde-ade7-648ef19b58e6,2028-12-21,2028-12-22,Apple.com/bill,5734,Shopping,Electronics,-162.36,GBP,-118750.78,E-Com,Cupertino,US,9074,user_001,,
dd20ac31-14d1-4dc4-b519-24c5f6dcbe1b,2028-12-21,2028-12-21,HM Revenue & Customs,9311,Income,Tax Refund,14.05,GBP,-118736.73,Credit,London,GB,1045,user_002,,Refund for Tesco
3b130c60-ce5c-495a-99f8-9f65e8974258,2028-12-22,2028-12-25,Local Market,5499,Groceries,Specialty,-21.37,GBP,-118758.1,POS,London,GB,9074,user_001,,
c8147358-6d4d-4d4a-b1b1-b7a1e7132754,2028-12-22,2028-12-25,Transport for London,4111,Transport,Transit,-11.87,GBP,-118769.97,POS,London,GB,9074,user_001,,
d9939f2a-c849-43a2-85d0-b39f897dbf3d,2028-12-22,2028-12-22,Uber UK,4121,Transport,Ride Hailing,-34.54,GBP,-118804.51,E-Com,London,GB,2219,user_002,,
eec34d0c-005e-40db-837a-ba0bd9828546,2028-12-22,2028-12-25,Waitrose,5411,Groceries,Supermarket,-53.22,GBP,-118857.73,POS,London,GB,9074,user_001,,
10fbe121-8f34-465d-9ff7-57dfbe0a6076,2028-12-23,2028-12-25,Amazon UK,5942,Shopping,Online Retail,-83.64,GBP,-118941.37,E-Com,London,GB,9074,user_002,,
3f636555-451f-4508-b9a9-e9a496e55308,2028-12-23,2028-12-25,Uber UK,4121,Transport,Ride Hailing,-25.69,GBP,-118967.06,E-Com,London,GB,1045,user_001,,
bd29d20c-146d-4b8b-a3d0-2232b59f53f1,2028-12-23,2028-12-25,Apple.com/bill,5734,Shopping,Electronics,-32.8,GBP,-118999.86,E-Com,Cupertino,US,1045,user_001,,
232c821f-1e15-4f88-b06f-9d8bdf9a6244,2028-12-24,2028-12-26,Transport for London,4111,Transport,Transit,-6.57,GBP,-119006.43,POS,London,GB,4488,user_001,,
b4a30947-1457-42af-bc2d-d5d42f15c391,2028-12-24,2028-12-25,Amazon UK,5942,Shopping,Online Retail,-98.6,GBP,-119105.03,E-Com,London,GB,2219,user_001,,
d389c5fc-d911-45df-acd9-248302a1f832,2028-12-24,2028-12-25,Waitrose,5411,Groceries,Supermarket,-55.21,GBP,-119160.24,POS,London,GB,1045,user_001,,
b7930516-e816-4ff2-87bb-6ff2ba8ea76c,2028-12-25,2028-12-26,Apple.com/bill,5734,Shopping,Electronics,-167.65,GBP,-119327.89,E-Com,Cupertino,US,2219,user_002,,
d880ab2c-b4b4-4d42-99b3-5d20e36463dc,2028-12-25,2028-12-27,Waitrose,5411,Groceries,Supermarket,-79.05,GBP,-119406.94,POS,London,GB,1045,user_001,,
dbb60944-2ac0-418d-b544-bb21747ed381,2028-12-25,2028-12-25,T212 Capital,6011,Income,Salary,3134.64,GBP,-116272.3,Credit,London,GB,4488,user_002,rec_c649d24d0f,
1ce24095-8e5d-4848-ba6f-e86458af69b7,2028-12-26,2028-12-26,HM Revenue & Customs,9311,Income,Tax Refund,21.12,GBP,-116251.18,Credit,London,GB,1045,user_001,,Refund for Sainsbury's
6255dc15-3404-459b-a492-e720a89fcd6b,2028-12-26,2028-12-28,Deliveroo,5812,Food & Drink,Delivery,-33.01,GBP,-116284.19,E-Com,London,GB,1045,user_001,,
0532bc58-44fc-41ae-9369-defbeb49eb5c,2028-12-27,2028-12-29,ATM Withdrawal,6011,Cash,ATM,-97.97,GBP,-116382.16,ATM,London,GB,9074,user_001,,
43a00de8-53b0-4d4a-bc7f-21c19124a0f9,2028-12-27,2028-12-28,Apple.com/bill,5734,Shopping,Electronics,-32.97,USD,-116415.13,E-Com,Cupertino,US,1045,user_002,,FX purchase 42.24 USD @ rate 1.28
e4d1db4c-93b7-437f-bf99-c492573e6577,2028-12-27,2028-12-28,Waitrose,5411,Groceries,Supermarket,-30.27,GBP,-116445.4,POS,London,GB,1045,user_001,,
3e948d40-564f-482c-9b09-48f4b5359428,2028-12-28,2028-12-29,Waitrose,5411,Groceries,Supermarket,-21.17,GBP,-116466.57,POS,London,GB,2219,user_001,,
6379623c-a52b-4fb0-bcae-3752f5df311e,2028-12-28,2028-12-29,Apple.com/bill,5734,Shopping,Electronics,-133.25,GBP,-116599.82,E-Com,Cupertino,US,4488,user_002,,
d940c6f1-ef83-4943-92e1-029c93e1a65d,2028-12-28,2029-01-01,Shell,5541,Transport,Fuel,-56.02,GBP,-116655.84,POS,London,GB,4488,user_001,,
976b421e-ab24-44e8-89ed-e382a7ae9497,2028-12-29,2029-01-01,Local Market,5499,Groceries,Specialty,-11.62,GBP,-116667.46,POS,London,GB,2219,user_002,,
0eb3dbc9-c91d-495f-a1e3-8520277b9a89,2028-12-30,2029-01-01,Deliveroo,5812,Food & Drink,Delivery,-28.6,GBP,-116696.06,E-Com,London,GB,2219,user_001,,
2b331851-e932-4b28-97d3-2aa7487ef549,2028-12-30,2029-01-01,Transport for London,4111,Transport,Transit,-11.72,GBP,-116707.78,POS,London,GB,1045,user_002,,
57c7cc3e-34b4-4914-bedd-84fabb9624b9,2028-12-30,2029-01-01,Pret A Manger,5814,Food & Drink,Eating Out,-7.76,GBP,-116715.54,POS,London,GB,4488,user_002,,
86714e12-28f4-4a96-85ab-b5ce36f53d08,2028-12-30,2029-01-01,Transport for London,4111,Transport,Transit,-3.81,GBP,-116719.35,POS,London,GB,2219,user_001,,
ac1ec13f-c9af-416d-ad9d-f6080ab24fd5,2028-12-30,2029-01-01,Apple.com/bill,5734,Shopping,Electronics,-39.23,USD,-116758.58,E-Com,Cupertino,US,2219,user_001,,FX purchase 48.72 USD @ rate 1.24
5c4a1047-fbd7-47e9-831c-e05b3ac21236,2028-12-31,2029-01-01,Tesco,5411,Groceries,Supermarket,-52.31,GBP,-116810.89,POS,London,GB,9074,user_001,,
90589e8b-49b6-46ba-8239-d0588c2dd4d5,2028-12-31,2029-01-01,Transport for London,4111,Transport,Transit,-8.68,GBP,-116819.57,POS,London,GB,4488,user_001,,
c3bb4810-2aeb-40f1-a057-af4235cd5c15,2028-12-31,2029-01-02,Pret A Manger,5814,Food & Drink,Eating Out,-11.38,GBP,-116830.95,POS,London,GB,9074,user_001,,
d4a90556-0cc5-4c9a-9876-8b6138c87345,2028-12-31,2029-01-02,Pret A Manger,5814,Food & Drink,Eating Out,-10.04,GBP,-116840.99,POS,London,GB,2219,user_001,,
4c0dcfa8-098e-4bb3-b231-85a92093c4c3,2029-01-01,2029-01-01,Apple.com/bill,5734,Shopping,Electronics,-197.53,USD,-117038.52,E-Com,Cupertino,US,1045,user_001,,FX purchase 243.68 USD @ rate 1.23
903af048-9fc5-40f5-8eb1-12e3a40f7982,2029-01-01,2029-01-03,Tesco,5411,Groceries,Supermarket,-52.05,GBP,-117090.57,POS,London,GB,2219,user_001,,
c8483410-8d39-4061-ac1b-840ac5e81353,2029-01-01,2029-01-01,Crown Estates Lettings,6513,Housing,Rent,-1470.95,GBP,-118561.52,POS,London,GB,2219,user_001,rec_19f70fbcce,
f9941c6b-eee7-4c19-9313-da5657415ae7,2029-01-02,2029-01-03,Local Market,5499,Groceries,Specialty,-15.32,GBP,-118576.84,POS,London,GB,1045,user_002,,
07b03631-a0b9-49ca-94b7-2c2d047e46a6,2029-01-03,2029-01-03,Shell,5541,Transport,Fuel,-93.9,GBP,-118670.74,POS,London,GB,2219,user_001,,
c62191ae-a543-4391-ace0-fbc371701940,2029-01-03,2029-01-03,Deliveroo,5812,Food & Drink,Delivery,-21.77,GBP,-118692.51,E-Com,London,GB,4488,user_001,,
4bb19c92-ef05-4990-80f8-16abc5b691ee,2029-01-04,2029-01-08,Deliveroo,5812,Food & Drink,Delivery,-13.02,GBP,-118705.53,E-Com,London,GB,1045,user_001,,
c309f736-173f-42c8-aab9-e24d2c02d651,2029-01-04,2029-01-04,ATM Withdrawal,6011,Cash,ATM,-60.62,GBP,-118766.15,ATM,London,GB,4488,user_001,,
d6307db9-df3e-4e97-a285-c111a0c83f5f,2029-01-04,2029-01-04,Shell,5541,Transport,Fuel,-60.66,GBP,-118826.81,POS,London,GB,1045,user_002,,
f94dfedc-45f4-4c46-b3d1-386372a70a92,2029-01-04,2029-01-04,Shell,5541,Transport,Fuel,-46.29,GBP,-118873.1,POS,London,GB,4488,user_001,,
c5882969-9459-4cef-89bf-73b9992f32fb,2029-01-06,2029-01-08,Apple.com/bill,5734,Shopping,Electronics,-125.55,USD,-118998.65,E-Com,Cupertino,US,1045,user_001,,FX purchase 159.31 USD @ rate 1.27
ca9234d6-9264-42b9-af5a-5f1022403e82,2029-01-06,2029-01-08,Sainsbury's,5411,Groceries,Supermarket,-38.04,GBP,-119036.69,POS,London,GB,2219,user_001,,
3498aab4-fbbd-4e78-aa71-1f7f82c2b7fd,2029-01-07,2029-01-08,Transport for London,4111,Transport,Transit,-8.38,GBP,-119045.07,POS,London,GB,1045,user_001,,
3c368add-f098-49bd-ae2b-56ec2131b6e3,2029-01-07,2029-01-09,Sainsbury's,5411,Groceries,Supermarket,-18.56,GBP,-119063.63,POS,London,GB,9074,user_001,,
69f4bc3f-4d90-43fc-8d92-59e7f51132c0,2029-01-07,2029-01-08,Sainsbury's,5411,Groceries,Supermarket,-58.21,GBP,-119121.84,POS,London,GB,1045,user_001,,
6b974259-2efd-42de-99e7-8200f5de2c90,2029-01-07,2029-01-08,Tesco,5411,Groceries,Supermarket,-37.54,GBP,-119159.38,POS,London,GB,1045,user_001,,
9203a41b-9865-4775-8d09-a3cbfa8cc71a,2029-01-07,2029-01-08,Apple.com/bill,5734,Shopping,Electronics,-16.67,GBP,-119176.05,E-Com,Cupertino,US,2219,user_001,,
9e5b9d54-c6cd-4394-a5dd-249cd2e0a8dc,2029-01-07,2029-01-09,Transport for London,4111,Transport,Transit,-11.01,GBP,-119187.06,POS,London,GB,4488,user_001,,
cd0a1442-7022-49bd-9fc3-e9034e68fb3e,2029-01-07,2029-01-08,Local Market,5499,Groceries,Specialty,-17.95,GBP,-119205.01,POS,London,GB,4488,user_001,,
f728e5c3-7ec7-4bbc-88aa-df83554eb6f0,2029-01-07,2029-01-08,Uber UK,4121,Transport,Ride Hailing,-31.8,GBP,-119236.81,E-Com,London,GB,1045,user_001,,
1116a32c-9aef-4590-9747-c1d96df74ffc,2029-01-08,2029-01-08,Octopus Energy,4900,Utilities,Electricity,-132.7,GBP,-119369.51,Direct Debit,London,GB,9074,user_001,rec_141a4a0666,
92d5b1be-15dc-4f31-9062-a67e306f2316,2029-01-08,2029-01-10,Shell,5541,Transport,Fuel,-45.44,GBP,-119414.95,POS,London,GB,9074,user_001,,
8c60b913-65f3-4257-bd81-ba97af1f0e16,2029-01-09,2029-01-10,Pret A Manger,5814,Food & Drink,Eating Out,-8.67,GBP,-119423.62,POS,London,GB,1045,user_001,,
1fe2d53f-6991-4468-9412-02da6383f597,2029-01-10,2029-01-10,Sainsbury's,5411,Groceries,Supermarket,-32.14,GBP,-119455.76,POS,London,GB,4488,user_001,,
33ce9163-d6cb-4d30-a13b-fc5e133046cf,2029-01-11,2029-01-15,Thames Water,4900,Utilities,Water,-36.46,GBP,-119492.22,Direct Debit,Reading,GB,4488,user_001,rec_3a34d62842,
acfe5d71-4f82-4723-99a2-04ed922e1e5e,2029-01-11,2029-01-11,Amazon UK,5942,Shopping,Online Retail,-10.08,GBP,-119502.3,E-Com,London,GB,4488,user_001,,
bb61e0da-f435-46c0-a299-af363b551ba2,2029-01-11,2029-01-15,Local Market,5499,Groceries,Specialty,-20.25,GBP,-119522.55,POS,London,GB,2219,user_001,,
438cbf66-f1f4-4735-b46a-497ffcb0eb7a,2029-01-12,2029-01-12,Local Market,5499,Groceries,Specialty,-16.02,GBP,-119538.57,POS,London,GB,2219,user_001,,
4be3b8ff-0010-4a07-8e62-bb939e171196,2029-01-12,2029-01-12,Apple.com/bill,5734,Shopping,Electronics,-95.91,USD,-119634.48,E-Com,Cupertino,US,1045,user_001,,FX purchase 121.68 USD @ rate 1.27
bae6ffc5-a4ad-4004-9a68-6ee27ec18efc,2029-01-12,2029-01-15,Apple.com/bill,5734,Shopping,Electronics,-39.01,GBP,-119673.49,E-Com,Cupertino,US,2219,user_001,,
48007302-ad9a-4cca-aa25-b3130abbef98,2029-01-13,2029-01-15,Deliveroo,5812,Food & Drink,Delivery,-28.71,GBP,-119702.2,E-Com,London,GB,9074,user_001,,
6648255e-900c-4fb2-9176-f07b4d9275cd,2029-01-13,2029-01-15,Uber UK,4121,Transport,Ride Hailing,-32.44,GBP,-119734.64,E-Com,London,GB,9074,user_001,,
740e3e79-5764-4cfc-bf04-6707b4cbdb23,2029-01-13,2029-01-15,Transport for London,4111,Transport,Transit,-6.51,GBP,-119741.15,POS,London,GB,9074,user_001,,
848522fa-f8e0-4e76-a5a2-95a3dc2cfab6,2029-01-13,2029-01-15,Sainsbury's,5411,Groceries,Supermarket,-63.88,GBP,-119805.03,POS,London,GB,1045,user_001,,
ad62c5f3-2db9-4d50-ba0c-b0a54861cf82,2029-01-13,2029-01-15,Local Market,5499,Groceries,Specialty,-20.81,GBP,-119825.84,POS,London,GB,1045,user_001,,
c0ff11f3-0362-4c8d-bf85-6fb86bf620d7,2029-01-13,2029-01-15,Local Market,5499,Groceries,Specialty,-15.79,GBP,-119841.63,POS,London,GB,2219,user_001,,
6dd709e4-db3e-495f-8c36-d086ac8f8aa9,2029-01-14,2029-01-16,Uber UK,4121,Transport,Ride Hailing,-24.11,GBP,-119865.74,E-Com,London,GB,4488,user_001,,
a8797c62-5cb6-4c03-a6bf-f1fe67bb4eb6,2029-01-14,2029-01-15,Deliveroo,5812,Food & Drink,Delivery,-22.07,GBP,-119887.81,E-Com,London,GB,4488,user_002,,
c99d3f33-858b-4078-b45c-ee7a4816eba3,2029-01-14,2029-01-16,Sainsbury's,5411,Groceries,Supermarket,-28.0,GBP,-119915.81,POS,London,GB,1045,user_001,,
d60d93be-f3c6-44e4-8281-1a363a6c40d0,2029-01-14,2029-01-15,Deliveroo,5812,Food & Drink,Delivery,-14.7,GBP,-119930.51,E-Com,London,GB,2219,user_001,,
d7782087-d9f8-40f2-94e8-b794815a864f,2029-01-14,2029-01-16,Pret A Manger,5814,Food & Drink,Eating Out,-11.17,GBP,-119941.68,POS,London,GB,1045,user_001,,
0ddf66aa-65ab-4367-9107-a1ac81ace3da,2029-01-15,2029-01-17,Shell,5541,Transport,Fuel,-78.75,GBP,-120020.43,POS,London,GB,1045,user_001,,
1996f689-1707-4685-a7b1-b6ca4a5a7e87,2029-01-15,2029-01-16,Local Market,5499,Groceries,Specialty,-17.89,GBP,-120038.32,POS,London,GB,2219,user_001,,
3f1b97dd-0505-4353-a5bf-bcc1a1e4f775,2029-01-15,2029-01-15,Transport for London,4111,Transport,Transit,-7.21,GBP,-120045.53,POS,London,GB,2219,user_001,,
6e644a27-3bd2-48f3-ae01-20b598fd6a82,2029-01-15,2029-01-17,Amazon UK,5942,Shopping,Online Retail,-76.92,GBP,-120122.45,E-Com,London,GB,1045,user_001,,
803546ca-780a-4d78-80a3-c346a85c4b8f,2029-01-15,2029-01-16,O2 UK,4814,Bills,Mobile,-43.52,GBP,-120165.97,Direct Debit,Slough,GB,9074,user_001,rec_95042d8101,
81fa3f87-e28e-41ec-b794-4924563245f1,2029-01-15,2029-01-15,City Council Tax,9399,Utilities,Council Tax,-151.64,GBP,-120317.61,Direct Debit,London,GB,9074,user_001,rec_f531495db5,
98b41859-446e-4282-b94c-6df4087a166a,2029-01-15,2029-01-17,Waitrose,5411,Groceries,Supermarket,-88.62,GBP,-120406.23,POS,London,GB,9074,user_002,,
bb301019-bf77-4355-8a75-45c25b906b49,2029-01-15,2029-01-17,Amazon UK,5942,Shopping,Online Retail,-70.89,GBP,-120477.12,E-Com,London,GB,1045,user_001,,
d93f5987-8a1d-4455-b011-6f8ad8bc8146,2029-01-15,2029-01-16,ATM Withdrawal,6011,Cash,ATM,-116.28,GBP,-120593.4,ATM,London,GB,9074,user_001,,
e0102b75-082a-4a26-a57e-eed3acd7e6fc,2029-01-15,2029-01-15,Transport for London,4111,Transport,Transit,-6.84,GBP,-120600.24,POS,London,GB,2219,user_002,,
8abc0825-7916-4199-9406-f6bbe79b4483,2029-01-16,2029-01-17,Waitrose,5411,Groceries,Supermarket,-24.85,GBP,-120625.09,POS,London,GB,4488,user_001,,
f13d1ffb-34c8-48f6-aabc-7dab443ec30d,2029-01-16,2029-01-16,Tesco,5411,Groceries,Supermarket,-82.43,GBP,-120707.52,POS,London,GB,9074,user_002,,
9f34fb7b-bac5-45f8-a5bd-b8e86d979968,2029-01-17,2029-01-18,GymBox,7997,Wellness,Gym,-54.25,GBP,-120761.77,Direct Debit,London,GB,9074,user_001,rec_3906953fd2,
ae9d12f6-a33a-4278-80f6-0b09691bf87c,2029-01-18,2029-01-18,HM Revenue & Customs,9311,Income,Tax Refund,10.12,GBP,-120751.65,Credit,London,GB,4488,user_002,,Refund for Transport for London
7c774601-78a7-42a8-9f47-532f31f11f96,2029-01-19,2029-01-22,Pret A Manger,5814,Food & Drink,Eating Out,-6.97,GBP,-120758.62,POS,London,GB,1045,user_001,,
8ef81e5d-3d0a-40b9-8182-4f9e3f08c969,2029-01-19,2029-01-19,Local Market,5499,Groceries,Specialty,-15.66,GBP,-120774.28,POS,London,GB,9074,user_001,,
e9a35216-b7c4-4e23-ae20-17c7d1bcae74,2029-01-19,2029-01-19,Spotify,5735,Entertainment,Subscriptions,-8.47,GBP,-120782.75,E-Com,Stockholm,SE,1045,user_002,rec_34b6e9e33f,
8806ae83-a405-4714-b41f-86e368e03aa8,2029-01-20,2029-01-22,Tesco,5411,Groceries,Supermarket,-69.38,GBP,-120852.13,POS,London,GB,9074,user_001,,
0edd4665-508d-44d8-a7aa-9ca897e88c6d,2029-01-21,2029-01-22,Deliveroo,5812,Food & Drink,Delivery,-14.44,GBP,-120866.57,E-Com,London,GB,2219,user_001,,
296dc3b9-9ce6-4202-9b79-e8e8ff92c65a,2029-01-21,2029-01-23,Pret A Manger,5814,Food & Drink,Eating Out,-11.98,GBP,-120878.55,POS,London,GB,2219,user_001,,
df47fb44-7635-436c-ae4b-0345a70fb184,2029-01-21,2029-01-23,Amazon UK,5942,Shopping,Online Retail,-35.05,GBP,-120913.6,E-Com,London,GB,4488,user_002,,
203a2e10-0b85-4b86-8c66-4b783c4bdb51,2029-01-22,2029-01-23,Apple.com/bill,5734,Shopping,Electronics,-21.1,USD,-120934.7,E-Com,Cupertino,US,1045,user_001,,FX purchase 25.2 USD @ rate 1.19
98000167-780e-428a-b941-b389b5fdbc01,2029-01-22,2029-01-23,Netflix,7841,Entertainment,Subscriptions,-13.69,GBP,-120948.39,E-Com,Los Gatos,US,4488,user_001,rec_1bfe33738d,
9841764c-2c81-469a-8881-1a0fc4aee8ed,2029-01-22,2029-01-24,Apple.com/bill,5734,Shopping,Electronics,-122.34,GBP,-121070.73,E-Com,Cupertino,US,1045,user_001,,
c798692c-ab92-4056-b631-f80b211ca958,2029-01-22,2029-01-22,Airline Refund,4511,Travel,Refund,75.72,GBP,-120995.01,Credit,London,GB,2219,user_001,,Refund for City Council Tax
5fec1783-b697-4b77-a3f0-f621b12e38e1,2029-01-24,2029-01-25,Local Market,5499,Groceries,Specialty,-7.85,GBP,-121002.86,POS,London,GB,2219,user_001,,
74be05fb-aceb-4191-b6fd-95d08dffb6dc,2029-01-24,2029-01-24,Shell,5541,Transport,Fuel,-44.09,GBP,-121046.95,POS,London,GB,9074,user_001,,
f36bfecd-6706-4533-8f31-e623348b893c,2029-01-24,2029-01-26,Tesco,5411,Groceries,Supermarket,-48.91,GBP,-121095.86,POS,London,GB,9074,user_001,,
46bf89e9-ae55-4300-9265-8d2355fd8524,2029-01-25,2029-01-25,Airline Refund,4511,Travel,Refund,26.43,GBP,-121069.43,Credit,London,GB,1045,user_001,,Refund for Sainsbury's
4cce0d95-ba40-4482-b19c-bfe81b87ad90,2029-01-25,2029-01-25,Waitrose,5411,Groceries,Supermarket,-61.41,GBP,-121130.84,POS,London,GB,9074,user_001,,
af297e75-2524-424b-a33d-1ce93f036cd8,2029-01-25,2029-01-25,T212 Capital,6011,Income,Salary,2914.23,GBP,-118216.61,Credit,London,GB,2219,user_001,rec_2ff8f778d0,
ff04ea57-23b5-4ce1-8784-6996606e383d,2029-01-25,2029-01-29,Tesco,5411,Groceries,Supermarket,-23.78,GBP,-118240.39,POS,London,GB,2219,user_001,,
07bc698c-2e26-4216-9b9e-2801fef8a9c5,2029-01-26,2029-01-29,Waitrose,5411,Groceries,Supermarket,-66.89,GBP,-118307.28,POS,London,GB,1045,user_001,,
98c4ac61-6b26-4802-b155-9a024ddb2805,2029-01-27,2029-01-29,Local Market,5499,Groceries,Specialty,-7.45,GBP,-118314.73,POS,London,GB,9074,user_001,,
bc683e49-5927-4a54-aa50-e74461f355d0,2029-01-27,2029-01-29,Waitrose,5411,Groceries,Supermarket,-74.93,GBP,-118389.66,POS,London,GB,4488,user_001,,
29d3f5a7-0c9d-42d3-9f8c-74ee5aa064aa,2029-01-28,2029-01-30,Transport for London,4111,Transport,Transit,-8.39,GBP,-118398.05,POS,London,GB,9074,user_002,,
848109f5-2a50-44e2-9b4c-b53220f06328,2029-01-29,2029-01-29,Sainsbury's,5411,Groceries,Supermarket,-51.87,GBP,-118449.92,POS,London,GB,1045,user_002,,
04bf0800-ef3a-4827-853f-b5530a00e702,2029-01-30,2029-01-30,Apple.com/bill,5734,Shopping,Electronics,-50.39,GBP,-118500.31,E-Com,Cupertino,US,9074,user_001,,
6bebd7ed-f500-4b02-bc82-40e2787e49b7,2029-01-31,2029-01-31,Uber UK,4121,Transport,Ride Hailing,-14.98,GBP,-118515.29,E-Com,London,GB,2219,user_001,,
b2f399a7-46b4-4568-ad8e-09af36dedffb,2029-01-31,2029-02-02,Apple.com/bill,5734,Shopping,Electronics,-117.28,GBP,-118632.57,E-Com,Cupertino,US,9074,user_001,,
3bf6cc75-baed-48cf-9b27-1e0cf54d5073,2029-02-01,2029-02-02,Crown Estates Lettings,6513,Housing,Rent,-1597.76,GBP,-120230.33,POS,London,GB,9074,user_001,rec_19f70fbcce,
9ae11d9b-3550-40a4-8788-8c597d3037db,2029-02-01,2029-02-02,Local Market,5499,Groceries,Specialty,-20.81,GBP,-120251.14,POS,London,GB,2219,user_001,,
1461e3e0-194e-41bc-b8cf-fca0cd24bbd5,2029-02-02,2029-02-02,ATM Withdrawal,6011,Cash,ATM,-115.62,GBP,-120366.76,ATM,London,GB,9074,user_002,,
791cddef-4cb6-4d73-b4a8-5b017b67b495,2029-02-02,2029-02-05,Deliveroo,5812,Food & Drink,Delivery,-19.39,GBP,-120386.15,E-Com,London,GB,2219,user_001,,
9b3e908d-ee30-4eef-a0f3-9e52a0f42054,2029-02-02,2029-02-05,Shell,5541,Transport,Fuel,-73.72,GBP,-120459.87,POS,London,GB,2219,user_001,,
1ee2fae3-bc4c-4ae4-ac6d-d0191c9de7d9,2029-02-03,2029-02-05,Sainsbury's,5411,Groceries,Supermarket,-27.14,GBP,-120487.01,POS,London,GB,2219,user_001,,
2d69c628-3f3f-44ef-a20e-b37e03df5ce8,2029-02-03,2029-02-05,Waitrose,5411,Groceries,Supermarket,-42.24,GBP,-120529.25,POS,London,GB,2219,user_001,,
d9d53a4d-dd96-4f8d-b248-3613e770c6fc,2029-02-03,2029-02-05,Tesco,5411,Groceries,Supermarket,-33.27,GBP,-120562.52,POS,London,GB,2219,user_002,,
ebe7039c-3278-46cb-bd9b-9c425983d9fe,2029-02-03,2029-02-05,Transport for London,4111,Transport,Transit,-4.46,GBP,-120566.98,POS,London,GB,1045,user_001,,
00fb2edd-9588-42fe-8efa-b97cc5a074f4,2029-02-04,2029-02-05,Shell,5541,Transport,Fuel,-76.11,GBP,-120643.09,POS,London,GB,2219,user_002,,
10341d4e-15ac-4ab2-a368-47b39eb13a2b,2029-02-04,2029-02-06,Deliveroo,5812,Food & Drink,Delivery,-12.28,GBP,-120655.37,E-Com,London,GB,9074,user_001,,
bd97e9a0-c3f5-4013-85fb-d9455dd5d6ef,2029-02-04,2029-02-05,Airline Refund,4511,Travel,Refund,29.64,GBP,-120625.73,Credit,London,GB,2219,user_001,,Refund for Amazon UK
dc11ee4e-6074-43ed-aefe-ef29e1ca1a70,2029-02-04,2029-02-05,Transport for London,4111,Transport,Transit,-10.85,GBP,-120636.58,POS,London,GB,9074,user_001,,
fee72d32-fdcf-49b2-a4c0-8611fa0b2160,2029-02-04,2029-02-05,Deliveroo,5812,Food & Drink,Delivery,-24.07,GBP,-120660.65,E-Com,London,GB,1045,user_001,,
276a66d4-24d5-4bd0-a80c-914c5e266c67,2029-02-05,2029-02-05,Waitrose,5411,Groceries,Supermarket,-49.34,GBP,-120709.99,POS,London,GB,4488,user_001,,
68fcf0a2-5c61-4ee6-9db4-e1fed7116e67,2029-02-05,2029-02-05,Amazon UK,5942,Shopping,Online Retail,-20.14,GBP,-120730.13,E-Com,London,GB,4488,user_001,,
9ac2092f-ca87-459a-ae3e-50bf6f70d8c7,2029-02-05,2029-02-05,Uber UK,4121,Transport,Ride Hailing,-28.57,GBP,-120758.7,E-Com,London,GB,9074,user_001,,
34283025-d0e3-4407-bc42-2a411ac2ad4e,2029-02-06,2029-02-07,Apple.com/bill,5734,Shopping,Electronics,-83.18,GBP,-120841.88,E-Com,Cupertino,US,2219,user_001,,
48110505-01ca-48fb-836f-c07a641c18ac,2029-02-06,2029-02-07,Deliveroo,5812,Food & Drink,Delivery,-29.21,GBP,-120871.09,E-Com,London,GB,9074,user_001,,
ae7fff44-aacf-4b82-8e6e-e874f88e0138,2029-02-06,2029-02-07,Local Market,5499,Groceries,Specialty,-19.69,GBP,-120890.78,POS,London,GB,9074,user_002,,
f1ba1dbf-b703-427d-877e-9d51b285eece,2029-02-07,2029-02-07,Octopus Energy,4900,Utilities,Electricity,-140.72,GBP,-121031.5,Direct Debit,London,GB,4488,user_001,rec_141a4a0666,
130d1f1e-08f2-44a5-ac80-3c074aa6270a,2029-02-08,2029-02-12,Local Market,5499,Groceries,Specialty,-7.57,GBP,-121039.07,POS,London,GB,1045,user_001,,
5a27e1f9-c946-4888-9264-cdb48377277e,2029-02-10,2029-02-12,Local Market,5499,Groceries,Specialty,-13.98,GBP,-121053.05,POS,London,GB,4488,user_001,,
69ab9208-e3c6-4265-8784-d161c857aaff,2029-02-10,2029-02-12,Sainsbury's,5411,Groceries,Supermarket,-68.92,GBP,-121121.97,POS,London,GB,2219,user_001,,
8cc7e1b6-8b8f-4566-bd68-307e4bde5d67,2029-02-10,2029-02-12,Amazon UK,5942,Shopping,Online Retail,-95.92,GBP,-121217.89,E-Com,London,GB,9074,user_001,,
b8473e7b-0046-4ec0-a73c-0782bb6bdb65,2029-02-10,2029-02-12,Tesco,5411,Groceries,Supermarket,-24.89,GBP,-121242.78,POS,London,GB,1045,user_001,,
be764795-bda7-489e-a555-c54de68300e3,2029-02-10,2029-02-12,Tesco,5411,Groceries,Supermarket,-49.34,GBP,-121292.12,POS,London,GB,9074,user_001,,
2957fb44-3c5c-48bd-b9f6-7eec28105e6c,2029-02-11,2029-02-12,Sainsbury's,5411,Groceries,Supermarket,-55.12,GBP,-121347.24,POS,London,GB,9074,user_001,,
36980c02-6c50-470c-bf15-7aa803cc9582,2029-02-11,2029-02-12,Deliveroo,5812,Food & Drink,Delivery,-25.0,GBP,-121372.24,E-Com,London,GB,2219,user_001,,
9a63c351-4a8f-4007-bd6e-3f8c0e2cec9f,2029-02-11,2029-02-12,Tesco,5411,Groceries,Supermarket,-65.92,GBP,-121438.16,POS,London,GB,9074,user_001,,
fa9e6525-50ab-4f08-97ea-1886d016cb4b,2029-02-11,2029-02-12,Apple.com/bill,5734,Shopping,Electronics,-22.79,USD,-121460.95,E-Com,Cupertino,US,2219,user_001,,FX purchase 28.36 USD @ rate 1.24
1f0c690e-aa98-4593-aaa6-ea4b1f8765a6,2029-02-12,2029-02-13,Uber UK,4121,Transport,Ride Hailing,-10.33,GBP,-121471.28,E-Com,London,GB,9074,user_001,,
4157c649-99bb-437d-b9ce-566128376aec,2029-02-12,2029-02-13,Amazon UK,5942,Shopping,Online Retail,-47.27,GBP,-121518.55,E-Com,London,GB,9074,user_001,,
ad056039-29b6-43e0-8202-c1a04dda5042,2029-02-12,2029-02-13,Amazon UK,5942,Shopping,Online Retail,-112.47,GBP,-121631.02,E-Com,London,GB,4488,user_001,,
e37daf0e-798f-4c26-931e-c3bd43d21020,2029-02-12,2029-02-14,Thames Water,4900,Utilities,Water,-39.85,GBP,-121670.87,Direct Debit,Reading,GB,1045,user_002,rec_954d02400c,
08bc95c4-3220-45fd-a40d-27b9877260b4,2029-02-13,2029-02-14,City Council Tax,9399,Utilities,Council Tax,-158.15,GBP,-121829.02,Direct Debit,London,GB,9074,user_001,rec_f531495db5,
79fc084d-052e-47fa-bf77-59772b5b11c8,2029-02-13,2029-02-15,Uber UK,4121,Transport,Ride Hailing,-28.08,GBP,-121857.1,E-Com,London,GB,1045,user_001,,
930aac50-1f66-4373-845b-784e3334b3e5,2029-02-13,2029-02-13,Waitrose,5411,Groceries,Supermarket,-38.2,GBP,-121895.3,POS,London,GB,9074,user_002,,
fdbe3f26-3b6d-401a-bbb1-23891d3d6e61,2029-02-13,2029-02-13,Amazon UK,5942,Shopping,Online Retail,-47.81,GBP,-121943.11,E-Com,London,GB,9074,user_002,,
1540e013-4928-4712-aefc-52a44e281860,2029-02-14,2029-02-15,Sainsbury's,5411,Groceries,Supermarket,-66.33,GBP,-122009.44,POS,London,GB,9074,user_001,,
1aca9fd2-17e6-477e-a555-5e92ab256e36,2029-02-14,2029-02-14,Deliveroo,5812,Food & Drink,Delivery,-21.37,GBP,-122030.81,E-Com,London,GB,4488,user_001,,
b386a058-bd3e-4086-a790-8bb9b21d7ae3,2029-02-14,2029-02-15,ATM Withdrawal,6011,Cash,ATM,-117.2,GBP,-122148.01,ATM,London,GB,4488,user_001,,
b081e6f3-cc38-42c2-8511-d4359cc60668,2029-02-15,2029-02-15,Deliveroo,5812,Food & Drink,Delivery,-27.32,GBP,-122175.33,E-Com,London,GB,1045,user_001,,
d9987ea0-33aa-4be2-ae48-05a55f86bb00,2029-02-15,2029-02-15,O2 UK,4814,Bills,Mobile,-50.83,GBP,-122226.16,Direct Debit,Slough,GB,9074,user_001,rec_95042d8101,
f74a54a1-8c44-4a58-8d70-3bd45fd736fc,2029-02-15,2029-02-15,Deliveroo,5812,Food & Drink,Delivery,-20.81,GBP,-122246.97,E-Com,London,GB,2219,user_001,,
87519a51-6881-4e08-901f-05aa558f7bd5,2029-02-16,2029-02-16,Tesco,5411,Groceries,Supermarket,-66.93,GBP,-122313.9,POS,London,GB,1045,user_001,,
d1b1fa20-884e-48cd-beb7-d1f3c6ad3931,2029-02-16,2029-02-19,Local Market,5499,Groceries,Specialty,-11.78,GBP,-122325.68,POS,London,GB,1045,user_002,,
295e31b7-02d2-412b-9ec1-98acb9518f4f,2029-02-17,2029-02-19,Pret A Manger,5814,Food & Drink,Eating Out,-5.67,GBP,-122331.35,POS,London,GB,9074,user_001,,
a9146f88-2c21-4cf3-8754-002cf3bba95a,2029-02-17,2029-02-19,Amazon UK,5942,Shopping,Online Retail,-104.56,GBP,-122435.91,E-Com,London,GB,1045,user_001,,
b7d45645-0796-4735-8c04-66ec0b50eaed,2029-02-17,2029-02-19,Tesco,5411,Groceries,Supermarket,-54.14,GBP,-122490.05,POS,London,GB,2219,user_002,,
f58d516f-70bc-4a8b-8a64-f49409c38dd4,2029-02-17,2029-02-19,Local Market,5499,Groceries,Specialty,-7.17,GBP,-122497.22,POS,London,GB,9074,user_001,,
3281c691-216c-4b22-b271-6fe33964432f,2029-02-18,2029-02-19,British Airways,4511,Travel,Flights,-302.83,GBP,-122800.05,E-Com,London,GB,2219,user_002,,Holiday booking
4b3df768-acde-47a0-bf2e-a864934d391f,2029-02-18,2029-02-20,Apple.com/bill,5734,Shopping,Electronics,-16.37,GBP,-122816.42,E-Com,Cupertino,US,2219,user_001,,
80e42a2c-644f-4fb5-9093-62a5f67f8c9a,2029-02-18,2029-02-19,Apple.com/bill,5734,Shopping,Electronics,-188.89,GBP,-123005.31,E-Com,Cupertino,US,9074,user_001,,
baf9d836-51bc-451b-a5eb-585326104e0b,2029-02-18,2029-02-19,Pret A Manger,5814,Food & Drink,Eating Out,-6.46,GBP,-123011.77,POS,London,GB,1045,user_001,,
f691067f-1b7a-4eff-9ff4-119ce1759df3,2029-02-18,2029-02-20,Shell,5541,Transport,Fuel,-85.2,GBP,-123096.97,POS,London,GB,4488,user_001,,
4617eba6-7630-40cc-9fc7-5d2708b2a8a8,2029-02-19,2029-02-20,GymBox,7997,Wellness,Gym,-45.97,GBP,-123142.94,Direct Debit,London,GB,1045,user_001,rec_3906953fd2,
a816d5db-6400-455d-83f4-6c8828f6be81,2029-02-19,2029-02-19,Spotify,5735,Entertainment,Subscriptions,-8.72,EUR,-123151.66,E-Com,Stockholm,SE,1045,user_001,rec_4c746d2c3b,FX purchase 9.26 EUR @ rate 1.06
c910e0f1-f27b-493b-aa87-50bd057aa190,2029-02-19,2029-02-21,Uber UK,4121,Transport,Ride Hailing,-23.5,GBP,-123175.16,E-Com,London,GB,2219,user_001,,
cdb8ad9c-ec9e-4a02-80c8-30cce3ce0835,2029-02-19,2029-02-20,Apple.com/bill,5734,Shopping,Electronics,-133.11,GBP,-123308.27,E-Com,Cupertino,US,9074,user_001,,
015cc1fb-ef8a-428a-8dcc-0bac408bf52e,2029-02-20,2029-02-20,Local Market,5499,Groceries,Specialty,-10.33,GBP,-123318.6,POS,London,GB,1045,user_001,,
63d27a27-6832-4ae2-9b62-ea348225ec41,2029-02-20,2029-02-21,Apple.com/bill,5734,Shopping,Electronics,-74.17,USD,-123392.77,E-Com,Cupertino,US,2219,user_001,,FX purchase 93.48 USD @ rate 1.26
7156ae6a-5ed3-46bf-99c2-06011e8090b0,2029-02-20,2029-02-20,Uber UK,4121,Transport,Ride Hailing,-32.35,GBP,-123425.12,E-Com,London,GB,1045,user_001,,
8a95db39-a6d6-45e2-93f6-7322928d045a,2029-02-20,2029-02-21,Apple.com/bill,5734,Shopping,Electronics,-146.02,USD,-123571.14,E-Com,Cupertino,US,1045,user_002,,FX purchase 181.45 USD @ rate 1.24
354b49d7-d92f-48a9-a3c8-5219c3a5b18f,2029-02-21,2029-02-21,ATM Withdrawal,6011,Cash,ATM,-87.71,GBP,-123658.85,ATM,London,GB,1045,user_001,,
46b5b598-b516-44ed-8e9e-fe9e35b6f5ed,2029-02-21,2029-02-22,Local Market,5499,Groceries,Specialty,-11.08,GBP,-123669.93,POS,London,GB,9074,user_002,,
4714fb3a-54b6-4ff6-90b7-f84db14b8ba8,2029-02-21,2029-02-23,Local Market,5499,Groceries,Specialty,-18.2,GBP,-123688.13,POS,London,GB,9074,user_001,,
8ceb45b7-263c-4a7d-ba3e-e160d2bd79b5,2029-02-21,2029-02-21,Waitrose,5411,Groceries,Supermarket,-53.57,GBP,-123741.7,POS,London,GB,2219,user_001,,
d5ac8c3e-c2f8-47f5-8a83-1097aae193c8,2029-02-21,2029-02-22,Netflix,7841,Entertainment,Subscriptions,-15.37,GBP,-123757.07,E-Com,Los Gatos,US,9074,user_001,rec_1bfe33738d,
db2a7ff3-3e05-44c8-b40a-99b5497bfb18,2029-02-21,2029-02-23,Uber UK,4121,Transport,Ride Hailing,-24.2,GBP,-123781.27,E-Com,London,GB,2219,user_001,,
aaecd2bb-f224-46a1-8471-97f8e7f1751d,2029-02-23,2029-02-23,T212 Capital,6011,Income,Salary,2879.47,GBP,-120901.8,Credit,London,GB,4488,user_001,rec_2ff8f778d0,
cebd5e49-bce2-4dea-961e-74eed9930f82,2029-02-23,2029-02-26,Shell,5541,Transport,Fuel,-90.57,GBP,-120992.37,POS,London,GB,9074,user_001,,
23afaeec-6b90-4fd4-b312-0a41033a1459,2029-02-24,2029-02-26,Apple.com/bill,5734,Shopping,Electronics,-101.21,USD,-121093.58,E-Com,Cupertino,US,9074,user_001,,FX purchase 126.04 USD @ rate 1.25
b39f4bc6-d460-479b-9515-5eda1ac38e4c,2029-02-24,2029-02-26,Apple.com/bill,5734,Shopping,Electronics,-132.92,USD,-121226.5,E-Com,Cupertino,US,2219,user_001,,FX purchase 160.96 USD @ rate 1.21
ffd53755-65c5-4164-b111-872223dcde58,2029-02-24,2029-02-26,Deliveroo,5812,Food & Drink,Delivery,-30.11,GBP,-121256.61,E-Com,London,GB,9074,user_002,,
56a52bd5-a9db-4bab-bad7-5d3472809f86,2029-02-25,2029-02-26,Uber UK,4121,Transport,Ride Hailing,-20.38,GBP,-121276.99,E-Com,London,GB,9074,user_002,,
f9409ea3-2090-4a9e-8a37-f55abacb0c83,2029-02-25,2029-02-26,Shell,5541,Transport,Fuel,-88.24,GBP,-121365.23,POS,London,GB,9074,user_001,,
8da64397-321e-41b2-8ef7-7ecbbd3f6852,2029-02-26,2029-02-28,Amazon UK,5942,Shopping,Online Retail,-116.28,GBP,-121481.51,E-Com,London,GB,9074,user_001,,
c006690f-f4c9-4ad3-b36f-767eee4d7763,2029-02-26,2029-02-26,Uber UK,4121,Transport,Ride Hailing,-15.41,GBP,-121496.92,E-Com,London,GB,4488,user_001,,
ead4859c-15b0-469d-9860-a2ae2ce730bc,2029-02-26,2029-02-27,Sainsbury's,5411,Groceries,Supermarket,-37.95,GBP,-121534.87,POS,London,GB,2219,user_001,,
dcb70e17-f1d1-4c91-b815-d04d31e1cf1a,2029-02-27,2029-03-01,Uber UK,4121,Transport,Ride Hailing,-11.02,GBP,-121545.89,E-Com,London,GB,4488,user_001,,
5085ed50-0302-4db8-9c18-d51299e52ad8,2029-02-28,2029-03-01,Amazon UK,5942,Shopping,Online Retail,-61.58,GBP,-121607.47,E-Com,London,GB,4488,user_001,,
b5418b62-2916-4b6d-9a6d-e2cc198182e4,2029-02-28,2029-02-28,Apple.com/bill,5734,Shopping,Electronics,-85.5,GBP,-121692.97,E-Com,Cupertino,US,1045,user_001,,
bc12a9a4-da46-4ad4-973e-2157f3f9c209,2029-02-28,2029-03-01,Local Market,5499,Groceries,Specialty,-20.24,GBP,-121713.21,POS,London,GB,4488,user_001,,
f6789303-a0d7-4e84-b6dc-5b3e861664e6,2029-02-28,2029-03-02,Apple.com/bill,5734,Shopping,Electronics,-203.96,GBP,-121917.17,E-Com,Cupertino,US,1045,user_001,,
3fe3f3bb-79a3-475e-8d52-3df574e50cb2,2029-03-01,2029-03-02,Crown Estates Lettings,6513,Housing,Rent,-1493.1,GBP,-123410.27,POS,London,GB,9074,user_001,rec_19f70fbcce,
e0e0ad7a-ed8a-4e7d-9585-745cab0fead6,2029-03-01,2029-03-05,Apple.com/bill,5734,Shopping,Electronics,-30.6,USD,-123440.87,E-Com,Cupertino,US,2219,user_001,,FX purchase 37.25 USD @ rate 1.22
8e7fb7f4-b0aa-4160-93c3-60885be45fd4,2029-03-02,2029-03-02,Airline Refund,4511,Travel,Refund,253.06,GBP,-123187.81,Credit,London,GB,2219,user_002,,Refund for British Airways
b2ea5893-9c83-4bc6-8870-f91f919a71d4,2029-03-02,2029-03-05,Local Market,5499,Groceries,Specialty,-20.39,GBP,-123208.2,POS,London,GB,1045,user_002,,
dbd9caa3-2328-447e-a650-4d8db093137f,2029-03-02,2029-03-05,Transport for London,4111,Transport,Transit,-4.23,GBP,-123212.43,POS,London,GB,4488,user_001,,
dffa5898-2ba6-467a-a7b2-e433548e24da,2029-03-02,2029-03-02,Amazon UK,5942,Shopping,Online Retail,-83.89,GBP,-123296.32,E-Com,London,GB,9074,user_001,,
0aa5cc7a-dfc6-46dc-b44b-35eecda1c055,2029-03-03,2029-03-05,Local Market,5499,Groceries,Specialty,-6.14,GBP,-123302.46,POS,London,GB,9074,user_001,,
7f43b209-9063-4bab-9c70-9f9a671216ba,2029-03-03,2029-03-05,Waitrose,5411,Groceries,Supermarket,-34.91,GBP,-123337.37,POS,London,GB,4488,user_002,,
14bfd9f8-8d8e-4634-9506-807792ced572,2029-03-04,2029-03-05,HM Revenue & Customs,9311,Income,Tax Refund,19.03,GBP,-123318.34,Credit,London,GB,4488,user_001,,Refund for Uber UK
6c34dce2-7410-40b1-b9a4-58b213c297dd,2029-03-04,2029-03-06,Pret A Manger,5814,Food & Drink,Eating Out,-9.16,GBP,-123327.5,POS,London,GB,1045,user_001,,
0a5f3a82-7eac-41b1-8522-0e54459eef8c,2029-03-05,2029-03-07,Amazon UK,5942,Shopping,Online Retail,-119.37,GBP,-123446.87,E-Com,London,GB,9074,user_001,,
e1e61e21-d9a5-4834-a92f-b108d69ccbcd,2029-03-05,2029-03-07,Tesco,5411,Groceries,Supermarket,-28.71,GBP,-123475.58,POS,London,GB,1045,user_001,,
47e610f7-ad76-4d00-ae89-f909d82de046,2029-03-06,2029-03-06,British Airways,4511,Travel,Flights,-420.56,GBP,-123896.14,E-Com,London,GB,1045,user_001,,Business travel
3a0c6252-c46a-44f2-b57e-9e08c180eba2,2029-03-07,2029-03-07,Octopus Energy,4900,Utilities,Electricity,-131.7,GBP,-124027.84,Direct Debit,London,GB,4488,user_001,rec_141a4a0666,
f894299d-6375-4981-9c16-a7644d88b81e,2029-03-07,2029-03-08,Local Market,5499,Groceries,Specialty,-18.08,GBP,-124045.92,POS,London,GB,4488,user_001,,
9fde6dd3-d563-4a5c-bf5f-ae438d1720ba,2029-03-08,2029-03-12,Amazon UK,5942,Shopping,Online Retail,-76.79,GBP,-124122.71,E-Com,London,GB,2219,user_001,,
c264e995-a34e-4af4-9d40-7eca42196774,2029-03-08,2029-03-09,Pret A Manger,5814,Food & Drink,Eating Out,-6.9,GBP,-124129.61,POS,London,GB,4488,user_001,,
08da50fd-38aa-4812-9296-4f2cf67ec7ee,2029-03-09,2029-03-12,Transport for London,4111,Transport,Transit,-5.06,GBP,-124134.67,POS,London,GB,9074,user_001,,
b9e60f78-3abd-4586-9014-77cfddd8bbac,2029-03-09,2029-03-12,Waitrose,5411,Groceries,Supermarket,-67.49,GBP,-124202.16,POS,London,GB,4488,user_001,,
229d9116-a98d-43bb-b73e-00370bd5f32d,2029-03-10,2029-03-12,Waitrose,5411,Groceries,Supermarket,-83.86,GBP,-124286.02,POS,London,GB,1045,user_001,,
46db0d2e-e303-4440-b5a6-24ede90503a9,2029-03-11,2029-03-12,Shell,5541,Transport,Fuel,-84.85,GBP,-124370.87,POS,London,GB,2219,user_001,,
638637f4-402d-4dec-941d-9c227d1ecdd4,2029-03-11,2029-03-12,ATM Withdrawal,6011,Cash,ATM,-115.43,GBP,-124486.3,ATM,London,GB,9074,user_001,,
d88db276-2dd0-41e9-a099-d4fc5028f631,2029-03-11,2029-03-12,Waitrose,5411,Groceries,Supermarket,-49.09,GBP,-124535.39,POS,London,GB,9074,user_001,,
dd289f1d-cf92-46ec-bdd5-3165c690adfe,2029-03-11,2029-03-12,Pret A Manger,5814,Food & Drink,Eating Out,-11.4,GBP,-124546.79,POS,London,GB,9074,user_001,,
0745955b-6f8e-417a-abfa-234064002e8e,2029-03-12,2029-03-12,Uber UK,4121,Transport,Ride Hailing,-35.8,GBP,-124582.59,E-Com,London,GB,2219,user_001,,
d14ed304-65a5-4898-828f-73695411e656,2029-03-12,2029-03-14,Thames Water,4900,Utilities,Water,-33.01,GBP,-124615.6,Direct Debit,Reading,GB,2219,user_001,rec_3a34d62842,
e9bb9f1e-345f-440d-8748-2f253374c80a,2029-03-12,2029-03-12,Transport for London,4111,Transport,Transit,-11.04,GBP,-124626.64,POS,London,GB,2219,user_001,,
0c363223-a329-4fd5-8041-0055461ab240,2029-03-13,2029-03-14,City Council Tax,9399,Utilities,Council Tax,-160.76,GBP,-124787.4,Direct Debit,London,GB,2219,user_001,rec_f531495db5,
9edc039f-f613-48ed-a331-8ad5166445d2,2029-03-15,2029-03-15,O2 UK,4814,Bills,Mobile,-36.42,GBP,-124823.82,Direct Debit,Slough,GB,9074,user_001,rec_95042d8101,
b74d6986-1ab2-47cd-865a-f767cc3daeac,2029-03-15,2029-03-15,Sainsbury's,5411,Groceries,Supermarket,-15.74,GBP,-124839.56,POS,London,GB,4488,user_002,,
c47b9525-0b40-410f-859d-c085fb8c0c21,2029-03-15,2029-03-19,Pret A Manger,5814,Food & Drink,Eating Out,-8.56,GBP,-124848.12,POS,London,GB,9074,user_001,,
2b65609d-8154-4df1-bfd9-35fe9b647574,2029-03-16,2029-03-19,Transport for London,4111,Transport,Transit,-11.38,GBP,-124859.5,POS,London,GB,1045,user_001,,
3c0241dc-ddb8-46f3-8169-be5686d7adf7,2029-03-17,2029-03-19,Sainsbury's,5411,Groceries,Supermarket,-27.9,GBP,-124887.4,POS,London,GB,2219,user_001,,
41654a4e-5d54-4bfb-8ae7-07dfac41f82b,2029-03-17,2029-03-19,Pret A Manger,5814,Food & Drink,Eating Out,-6.88,GBP,-124894.28,POS,London,GB,1045,user_001,,
c87ab6a2-80aa-48b6-b503-c373c4c57eea,2029-03-17,2029-03-19,Waitrose,5411,Groceries,Supermarket,-71.04,GBP,-124965.32,POS,London,GB,2219,user_002,,
2aae74e0-07fa-4723-bcc9-d32877216e83,2029-03-18,2029-03-19,Uber UK,4121,Transport,Ride Hailing,-8.78,GBP,-124974.1,E-Com,London,GB,9074,user_001,,
60710eda-c0d1-4e32-b2e0-270c3fc3f4c8,2029-03-18,2029-03-19,Local Market,5499,Groceries,Specialty,-8.56,GBP,-124982.66,POS,London,GB,2219,user_002,,
7e68d1a8-14fa-4c9b-b205-9f886eef7c4c,2029-03-18,2029-03-19,Waitrose,5411,Groceries,Supermarket,-54.74,GBP,-125037.4,POS,London,GB,1045,user_001,,
9b7a6fa4-d46e-4676-b6a4-ca5ef4e6de90,2029-03-18,2029-03-19,Tesco,5411,Groceries,Supermarket,-47.52,GBP,-125084.92,POS,London,GB,4488,user_002,,
cfa6acd9-d9f1-4d5f-b1bd-dc28331d6ec0,2029-03-19,2029-03-19,Deliveroo,5812,Food & Drink,Delivery,-19.65,GBP,-125104.57,E-Com,London,GB,1045,user_001,,
dab9fec7-c29e-4b13-8513-5d2c2fd7d341,2029-03-19,2029-03-19,GymBox,7997,Wellness,Gym,-49.71,GBP,-125154.28,Direct Debit,London,GB,2219,user_002,rec_19771e79cd,
e7e6c7f5-48c9-432b-9876-2181797ae7e1,2029-03-19,2029-03-20,Spotify,5735,Entertainment,Subscriptions,-8.59,GBP,-125162.87,E-Com,Stockholm,SE,4488,user_001,rec_4c746d2c3b,
47661adc-2c88-4849-bae3-b3db55acabe9,2029-03-20,2029-03-21,Local Market,5499,Groceries,Specialty,-18.53,GBP,-125181.4,POS,London,GB,4488,user_001,,
6ba031b9-0acc-40e9-94e6-0a417d9e39c2,2029-03-20,2029-03-22,Transport for London,4111,Transport,Transit,-5.16,GBP,-125186.56,POS,London,GB,2219,user_001,,
75011755-2023-4f3d-808f-0111f8ecc40a,2029-03-21,2029-03-23,Transport for London,4111,Transport,Transit,-11.75,GBP,-125198.31,POS,London,GB,4488,user_001,,
8db36b4d-b085-4a36-a0fd-4de92934e3cf,2029-03-21,2029-03-23,Netflix,7841,Entertainment,Subscriptions,-10.83,GBP,-125209.14,E-Com,Los Gatos,US,4488,user_001,rec_1bfe33738d,
be4d9384-3082-4e7f-a6a7-92fdf647ae68,2029-03-22,2029-03-22,Deliveroo,5812,Food & Drink,Delivery,-25.06,GBP,-125234.2,E-Com,London,GB,1045,user_001,,
f9359bdb-235a-4b14-9ea3-8dbf65f3351c,2029-03-22,2029-03-23,Waitrose,5411,Groceries,Supermarket,-59.57,GBP,-125293.77,POS,London,GB,4488,user_001,,
185105c0-2f79-4809-80e3-e6c1f9fae36d,2029-03-23,2029-03-26,Sainsbury's,5411,Groceries,Supermarket,-69.91,GBP,-125363.68,POS,London,GB,2219,user_001,,
27df0acc-e09b-48ed-8031-7e273c34c44d,2029-03-23,2029-03-26,Waitrose,5411,Groceries,Supermarket,-25.8,GBP,-125389.48,POS,London,GB,4488,user_001,,
904894b9-c8e4-4e2f-9d45-4e5ad8875547,2029-03-23,2029-03-23,T212 Capital,6011,Income,Salary,3290.13,GBP,-122099.35,Credit,London,GB,4488,user_001,rec_2ff8f778d0,
d387295e-2065-4549-985f-f54c2066bdb2,2029-03-23,2029-03-26,Deliveroo,5812,Food & Drink,Delivery,-15.37,GBP,-122114.72,E-Com,London,GB,1045,user_001,,
8e70d679-19a3-4d44-9694-123763496176,2029-03-24,2029-03-26,Transport for London,4111,Transport,Transit,-11.09,GBP,-122125.81,POS,London,GB,2219,user_001,,
d512e537-8ad0-4b64-bf9b-e28fa4ab9572,2029-03-24,2029-03-26,Uber UK,4121,Transport,Ride Hailing,-18.53,GBP,-122144.34,E-Com,London,GB,4488,user_001,,
d89b9ea2-f022-45dc-8f06-74654586107e,2029-03-24,2029-03-26,Amazon UK,5942,Shopping,Online Retail,-80.57,GBP,-122224.91,E-Com,London,GB,1045,user_001,,
d96f725e-b362-47a6-b21a-f87e5b6bae4b,2029-03-25,2029-03-27,Deliveroo,5812,Food & Drink,Delivery,-29.23,GBP,-122254.14,E-Com,London,GB,2219,user_002,,
deff3721-6fa5-4839-8f6b-f9943f43f986,2029-03-25,2029-03-27,Pret A Manger,5814,Food & Drink,Eating Out,-9.77,GBP,-122263.91,POS,London,GB,1045,user_001,,
1b95d5a3-d8b1-4090-9440-41c37bd757ae,2029-03-26,2029-03-26,Uber UK,4121,Transport,Ride Hailing,-34.23,GBP,-122298.14,E-Com,London,GB,1045,user_001,,
383bba2e-a384-4c40-a96d-c2815bcba180,2029-03-26,2029-03-26,Sainsbury's,5411,Groceries,Supermarket,-38.7,GBP,-122336.84,POS,London,GB,2219,user_001,,
7a431d33-7cb8-4b31-a750-f56664d1d02a,2029-03-26,2029-03-27,Shell,5541,Transport,Fuel,-64.08,GBP,-122400.92,POS,London,GB,1045,user_001,,
4f1a3b5f-cc07-45ee-8496-9e1d9bbdc579,2029-03-27,2029-03-27,Tesco,5411,Groceries,Supermarket,-66.14,GBP,-122467.06,POS,London,GB,9074,user_001,,
5bad4b2b-269d-48ca-b6bc-6beb55e7fdb7,2029-03-27,2029-03-29,Apple.com/bill,5734,Shopping,Electronics,-67.29,USD,-122534.35,E-Com,Cupertino,US,9074,user_001,,FX purchase 84.03 USD @ rate 1.25
5ebb0afe-f2f9-4b22-a44b-0bc63731609a,2029-03-27,2029-03-28,Local Market,5499,Groceries,Specialty,-16.25,GBP,-122550.6,POS,London,GB,9074,user_001,,
d836bcba-bd9d-4cda-ac03-44b6231bf0b0,2029-03-28,2029-03-30,ATM Withdrawal,6011,Cash,ATM,-104.8,GBP,-122655.4,ATM,London,GB,1045,user_002,,
115b77c1-db8e-4109-92dd-775e61665c21,2029-03-29,2029-04-02,Amazon UK,5942,Shopping,Online Retail,-101.94,GBP,-122757.34,E-Com,London,GB,4488,user_001,,
2e68f584-27c5-4473-ab42-9c0ccdc447b8,2029-03-29,2029-03-30,Amazon UK,5942,Shopping,Online Retail,-49.62,GBP,-122806.96,E-Com,London,GB,9074,user_001,,
a874124e-08bf-44a4-a638-3dc241abeff4,2029-03-29,2029-04-02,Apple.com/bill,5734,Shopping,Electronics,-116.0,USD,-122922.96,E-Com,Cupertino,US,1045,user_001,,FX purchase 146.88 USD @ rate 1.27
a50fec5b-f8ca-450e-bf0f-3173dcd35f22,2029-03-30,2029-04-02,Shell,5541,Transport,Fuel,-84.56,GBP,-123007.52,POS,London,GB,2219,user_001,,
44131c53-6ed9-4353-ba47-c224f138695f,2029-03-31,2029-04-02,Uber UK,4121,Transport,Ride Hailing,-22.32,GBP,-123029.84,E-Com,London,GB,2219,user_001,,
4784e6bb-e7d3-4110-8f6d-bb54455aa7d1,2029-03-31,2029-04-02,Deliveroo,5812,Food & Drink,Delivery,-33.94,GBP,-123063.78,E-Com,London,GB,9074,user_001,,
59db8dde-d17f-469c-a3b8-d5ac39ec6700,2029-03-31,2029-04-02,Shell,5541,Transport,Fuel,-51.9,GBP,-123115.68,POS,London,GB,2219,user_001,,
cff49a84-d524-4266-adf9-f1576449fba4,2029-04-01,2029-04-02,Tesco,5411,Groceries,Supermarket,-31.58,GBP,-123147.26,POS,London,GB,4488,user_001,,
0b875da6-dab0-43ca-9154-7fd54dbc7a3e,2029-04-02,2029-04-02,Tesco,5411,Groceries,Supermarket,-34.43,GBP,-123181.69,POS,London,GB,2219,user_001,,
5ced7dfe-eced-462b-a43b-b52d70b0ab09,2029-04-02,2029-04-03,Transport for London,4111,Transport,Transit,-5.1,GBP,-123186.79,POS,London,GB,4488,user_001,,
8366a0e8-29ff-4f50-b82f-f9763d939713,2029-04-02,2029-04-02,Crown Estates Lettings,6513,Housing,Rent,-1529.31,GBP,-124716.1,POS,London,GB,1045,user_001,rec_19f70fbcce,
be7b6a00-712f-4ca6-bbc1-80910b2c0573,2029-04-03,2029-04-04,Shell,5541,Transport,Fuel,-75.19,GBP,-124791.29,POS,London,GB,2219,user_001,,
de44ce4e-79f2-461b-84a8-a0a6d706cebe,2029-04-03,2029-04-05,Pret A Manger,5814,Food & Drink,Eating Out,-6.89,GBP,-124798.18,POS,London,GB,2219,user_001,,
f02b3bdf-12c7-4d71-b4f7-194db2db5668,2029-04-03,2029-04-05,Apple.com/bill,5734,Shopping,Electronics,-140.88,GBP,-124939.06,E-Com,Cupertino,US,9074,user_001,,
89b3b0d1-e50d-4d74-8c03-9f1617f6d8eb,2029-04-04,2029-04-05,ATM Withdrawal,6011,Cash,ATM,-79.17,GBP,-125018.23,ATM,London,GB,9074,user_001,,
9e750eff-05fe-4d6c-a9a7-bcf1e252a2f0,2029-04-04,2029-04-04,HM Revenue & Customs,9311,Income,Tax Refund,17.92,GBP,-125000.31,Credit,London,GB,4488,user_001,,Refund for O2 UK
de059421-fed8-443b-9e9f-57856e50dc8c,2029-04-04,2029-04-04,Uber UK,4121,Transport,Ride Hailing,-22.81,GBP,-125023.12,E-Com,London,GB,1045,user_001,,
09d83e3a-80c3-48b9-9ba8-f97dfd512f3f,2029-04-05,2029-04-06,Apple.com/bill,5734,Shopping,Electronics,-145.03,GBP,-125168.15,E-Com,Cupertino,US,1045,user_001,,
5444e706-45da-4359-8310-9bfa06b45978,2029-04-05,2029-04-05,Deliveroo,5812,Food & Drink,Delivery,-26.89,GBP,-125195.04,E-Com,London,GB,9074,user_001,,
735f957a-dec6-46a7-9f05-272cf0a07fff,2029-04-06,2029-04-09,Sainsbury's,5411,Groceries,Supermarket,-14.44,GBP,-125209.48,POS,London,GB,2219,user_002,,
8613150f-a4fa-4834-be6f-f208dfd55879,2029-04-06,2029-04-09,Apple.com/bill,5734,Shopping,Electronics,-157.53,USD,-125367.01,E-Com,Cupertino,US,9074,user_001,,FX purchase 203.3 USD @ rate 1.29
0257dd52-1f1c-4c1c-9db0-5fccef3c7f6e,2029-04-07,2029-04-09,Transport for London,4111,Transport,Transit,-7.92,GBP,-125374.93,POS,London,GB,1045,user_001,,
75f7940d-df0e-4f5f-b13b-719ea50bf19f,2029-04-07,2029-04-09,Sainsbury's,5411,Groceries,Supermarket,-52.88,GBP,-125427.81,POS,London,GB,1045,user_001,,
9c131168-a9ea-46d5-bfa5-f2a933c00d52,2029-04-07,2029-04-09,Waitrose,5411,Groceries,Supermarket,-30.31,GBP,-125458.12,POS,London,GB,4488,user_001,,
d00ee9ed-fb8f-4853-8f9b-62654d7a3720,2029-04-07,2029-04-09,Amazon UK,5942,Shopping,Online Retail,-105.9,GBP,-125564.02,E-Com,London,GB,9074,user_001,,
da5081b1-fd3e-40a9-aa49-c592bca2dce6,2029-04-07,2029-04-09,Deliveroo,5812,Food & Drink,Delivery,-15.34,GBP,-125579.36,E-Com,London,GB,9074,user_001,,
03743b7c-6b0f-41a7-ac2c-39404190c49c,2029-04-08,2029-04-09,Uber UK,4121,Transport,Ride Hailing,-30.5,GBP,-125609.86,E-Com,London,GB,9074,user_001,,
46e74e23-844b-4a2a-9654-798ef71098c8,2029-04-08,2029-04-10,Transport for London,4111,Transport,Transit,-8.44,GBP,-125618.3,POS,London,GB,1045,user_001,,
6d07f385-3bb1-4b48-82d7-23bb2f6fa149,2029-04-08,2029-04-09,Sainsbury's,5411,Groceries,Supermarket,-64.4,GBP,-125682.7,POS,London,GB,2219,user_002,,
711307f8-8c5b-4c44-8537-5cf10d4e63a7,2029-04-08,2029-04-10,Tesco,5411,Groceries,Supermarket,-59.15,GBP,-125741.85,POS,London,GB,2219,user_001,,
7b0b2330-2f22-427d-9b80-b9059889d20e,2029-04-08,2029-04-10,Amazon UK,5942,Shopping,Online Retail,-32.23,GBP,-125774.08,E-Com,London,GB,2219,user_001,,
87330c7d-4074-4095-b954-4529fd9bddb5,2029-04-08,2029-04-09,Uber UK,4121,Transport,Ride Hailing,-34.77,GBP,-125808.85,E-Com,London,GB,1045,user_001,,
88c829a4-a7e4-44da-be2d-0b9167df9f60,2029-04-08,2029-04-09,Amazon UK,5942,Shopping,Online Retail,-68.89,GBP,-125877.74,E-Com,London,GB,2219,user_001,,
ee8586da-0665-4172-8c04-863fad8f72ae,2029-04-08,2029-04-10,Apple.com/bill,5734,Shopping,Electronics,-123.2,USD,-126000.94,E-Com,Cupertino,US,2219,user_002,,FX purchase 148.97 USD @ rate 1.21
532ae3b9-ed75-4e64-9996-bb00fe7db40e,2029-04-09,2029-04-10,Apple.com/bill,5734,Shopping,Electronics,-102.12,GBP,-126103.06,E-Com,Cupertino,US,4488,user_001,,
d6f506dc-8962-4634-8e39-eac7a831b2bb,2029-04-09,2029-04-11,Octopus Energy,4900,Utilities,Electricity,-144.25,GBP,-126247.31,Direct Debit,London,GB,1045,user_001,rec_141a4a0666,
99ce7fb9-5c81-4ca4-a555-5745c8fc8ab9,2029-04-10,2029-04-11,Waitrose,5411,Groceries,Supermarket,-47.42,GBP,-126294.73,POS,London,GB,1045,user_001,,
c27daf54-9d30-4044-bfed-0ffd9e8cb778,2029-04-10,2029-04-11,Deliveroo,5812,Food & Drink,Delivery,-19.46,GBP,-126314.19,E-Com,London,GB,9074,user_001,,
4df6a3ba-5c60-4e46-8000-612e6d4959af,2029-04-11,2029-04-13,Thames Water,4900,Utilities,Water,-35.03,GBP,-126349.22,Direct Debit,Reading,GB,9074,user_001,rec_3a34d62842,
d3602c64-6a86-44dd-aa98-d096d8ebed18,2029-04-11,2029-04-11,Waitrose,5411,Groceries,Supermarket,-79.26,GBP,-126428.48,POS,London,GB,9074,user_002,,
d62a9541-7feb-4d6b-8e5d-2bfafffdf57b,2029-04-11,2029-04-13,Transport for London,4111,Transport,Transit,-4.85,GBP,-126433.33,POS,London,GB,9074,user_001,,
e96ddc28-6672-4f1d-940d-5be4de3fc33f,2029-04-11,2029-04-12,Tesco,5411,Groceries,Supermarket,-68.66,GBP,-126501.99,POS,London,GB,9074,user_001,,
10a3d4dd-00a8-49a8-9e0e-8da2b7476944,2029-04-12,2029-04-13,Apple.com/bill,5734,Shopping,Electronics,-107.58,USD,-126609.57,E-Com,Cupertino,US,4488,user_002,,FX purchase 129.58 USD @ rate 1.20
24678bbb-b2f0-4781-a61c-21000dc12a20,2029-04-12,2029-04-12,Uber UK,4121,Transport,Ride Hailing,-21.31,GBP,-126630.88,E-Com,London,GB,1045,user_002,,
49ba6317-152d-4674-bd30-920bdc5a648b,2029-04-12,2029-04-13,Waitrose,5411,Groceries,Supermarket,-85.37,GBP,-126716.25,POS,London,GB,1045,user_002,,
4f651d58-2abf-4226-80cf-b7d3e1a53f62,2029-04-12,2029-04-13,Sainsbury's,5411,Groceries,Supermarket,-17.77,GBP,-126734.02,POS,London,GB,4488,user_001,,
04c2805e-8429-468b-9ed4-43f925b035ba,2029-04-13,2029-04-13,ATM Withdrawal,6011,Cash,ATM,-76.27,GBP,-126810.29,ATM,London,GB,2219,user_002,,
2610d0e4-6448-4ea9-a2ad-f4cf653af176,2029-04-13,2029-04-16,City Council Tax,9399,Utilities,Council Tax,-157.74,GBP,-126968.03,Direct Debit,London,GB,2219,user_001,rec_f531495db5,
dc612762-1266-432f-ab31-c0132bb84d03,2029-04-13,2029-04-13,Sainsbury's,5411,Groceries,Supermarket,-40.68,GBP,-127008.71,POS,London,GB,4488,user_002,,
06138582-6c0e-400e-a312-e12a57d09147,2029-04-14,2029-04-16,Tesco,5411,Groceries,Supermarket,-20.33,GBP,-127029.04,POS,London,GB,1045,user_001,,
28737c89-e60a-4aab-8b16-04a98117b1c4,2029-04-14,2029-04-16,Sainsbury's,5411,Groceries,Supermarket,-56.07,GBP,-127085.11,POS,London,GB,4488,user_001,,
6ed1c3d5-2117-42fa-a379-2bec142f34cc,2029-04-14,2029-04-16,ATM Withdrawal,6011,Cash,ATM,-82.45,GBP,-127167.56,ATM,London,GB,4488,user_001,,
6d7fe56d-7fa7-424f-b664-56bba642eb7f,2029-04-15,2029-04-17,Transport for London,4111,Transport,Transit,-9.66,GBP,-127177.22,POS,London,GB,1045,user_001,,
ab8eab49-df8a-4979-b1d0-febc827e0984,2029-04-15,2029-04-16,Shell,5541,Transport,Fuel,-90.79,GBP,-127268.01,POS,London,GB,1045,user_002,,
b5b23032-d99a-46bd-a4e6-22be6f761c5e,2029-04-15,2029-04-16,Amazon UK,5942,Shopping,Online Retail,-57.6,GBP,-127325.61,E-Com,London,GB,2219,user_001,,
ed4e1969-bb85-4ee9-af76-a39e18bbf31b,2029-04-15,2029-04-16,Shell,5541,Transport,Fuel,-65.14,GBP,-127390.75,POS,London,GB,1045,user_002,,
fc9f1568-cd03-491d-bb8d-b75f589229a2,2029-04-15,2029-04-16,ATM Withdrawal,6011,Cash,ATM,-92.5,GBP,-127483.25,ATM,London,GB,1045,user_001,,
5241d90c-ad1e-4be3-afb2-c8302fc3e73e,2029-04-16,2029-04-18,Waitrose,5411,Groceries,Supermarket,-46.57,GBP,-127529.82,POS,London,GB,9074,user_001,,
a2099f1c-f9ba-4572-ad9d-03e7f43ffa36,2029-04-16,2029-04-18,O2 UK,4814,Bills,Mobile,-50.01,GBP,-127579.83,Direct Debit,Slough,GB,1045,user_001,rec_95042d8101,
b0a29a70-d0ed-4435-a473-8d23e30f8859,2029-04-16,2029-04-16,HM Revenue & Customs,9311,Income,Tax Refund,14.09,GBP,-127565.74,Credit,London,GB,9074,user_001,,Refund for Deliveroo
9a8fd976-00f7-49ba-83ba-c1886aa8aedc,2029-04-17,2029-04-19,GymBox,7997,Wellness,Gym,-64.66,GBP,-127630.4,Direct Debit,London,GB,1045,user_001,rec_3906953fd2,
a816c119-3450-4505-b1b6-7301c2f3d91e,2029-04-17,2029-04-17,Tesco,5411,Groceries,Supermarket,-78.61,GBP,-127709.01,POS,London,GB,2219,user_001,,
847a0008-a916-4418-ae51-9dc15afe401f,2029-04-18,2029-04-19,Uber UK,4121,Transport,Ride Hailing,-10.25,GBP,-127719.26,E-Com,London,GB,1045,user_002,,
e9cf234e-d5d1-4c28-b9b8-37c529e9505b,2029-04-18,2029-04-18,Sainsbury's,5411,Groceries,Supermarket,-32.73,GBP,-127751.99,POS,London,GB,1045,user_001,,
fa98cc7f-7384-484f-9a71-3e93e961b62f,2029-04-18,2029-04-19,Tesco,5411,Groceries,Supermarket,-46.63,GBP,-127798.62,POS,London,GB,9074,user_001,,
ccfb986a-c927-4e68-8641-99ab2706868a,2029-04-19,2029-04-23,Spotify,5735,Entertainment,Subscriptions,-8.64,EUR,-127807.26,E-Com,Stockholm,SE,1045,user_001,rec_4c746d2c3b,FX purchase 9.79 EUR @ rate 1.13
e56f504c-b11b-4bd0-9733-61c9fc2bf034,2029-04-19,2029-04-20,Amazon UK,5942,Shopping,Online Retail,-115.93,GBP,-127923.19,E-Com,London,GB,9074,user_002,,
e69d5c4a-70c3-48b5-b049-3692474cb28e,2029-04-19,2029-04-23,Tesco,5411,Groceries,Supermarket,-44.88,GBP,-127968.07,POS,London,GB,1045,user_001,,
2ffd5891-7e13-44c9-b764-f90a91941ca5,2029-04-20,2029-04-20,Deliveroo,5812,Food & Drink,Delivery,-17.16,GBP,-127985.23,E-Com,London,GB,1045,user_002,,
3ab0f3a2-55e1-4a9c-88e0-8531eec418c0,2029-04-20,2029-04-20,Waitrose,5411,Groceries,Supermarket,-45.12,GBP,-128030.35,POS,London,GB,2219,user_001,,
74fc12cc-99af-4978-bbcf-d89af17a0291,2029-04-20,2029-04-20,Airline Refund,4511,Travel,Refund,1253.49,GBP,-126776.86,Credit,London,GB,9074,user_001,,Refund for Crown Estates Lettings
3db5638e-0d13-4d47-b500-a2c8834f7add,2029-04-21,2029-04-23,Shell,5541,Transport,Fuel,-69.59,GBP,-126846.45,POS,London,GB,4488,user_001,,
4403ef43-e345-49fb-b62b-e963f6463ffe,2029-04-21,2029-04-23,Tesco,5411,Groceries,Supermarket,-56.64,GBP,-126903.09,POS,London,GB,1045,user_001,,
7669c504-a422-417c-8b5a-338985327ad6,2029-04-21,2029-04-23,Waitrose,5411,Groceries,Supermarket,-85.02,GBP,-126988.11,POS,London,GB,1045,user_001,,
536e4db4-0f9a-40bf-acd4-f4aae27cda7c,2029-04-22,2029-04-24,Pret A Manger,5814,Food & Drink,Eating Out,-8.73,GBP,-126996.84,POS,London,GB,4488,user_002,,
6564ad6f-22ec-448e-a564-09b1c223633d,2029-04-22,2029-04-24,Transport for London,4111,Transport,Transit,-10.29,GBP,-127007.13,POS,London,GB,4488,user_002,,
67fe5a0f-9eda-46e0-9b36-b14a911d31b8,2029-04-22,2029-04-23,Local Market,5499,Groceries,Specialty,-19.73,GBP,-127026.86,POS,London,GB,4488,user_001,,
d2f809a9-0208-4eab-8457-79ab88118b39,2029-04-22,2029-04-24,Waitrose,5411,Groceries,Supermarket,-61.71,GBP,-127088.57,POS,London,GB,4488,user_001,,
5d01ac7e-4a55-44d1-8b99-9adc1f5649b6,2029-04-23,2029-04-24,Netflix,7841,Entertainment,Subscriptions,-15.84,USD,-127104.41,E-Com,Los Gatos,US,2219,user_001,rec_1bfe33738d,FX purchase 19.07 USD @ rate 1.20
07a380f9-63d0-4c22-b180-3dc45abd5b96,2029-04-24,2029-04-24,Transport for London,4111,Transport,Transit,-5.25,GBP,-127109.66,POS,London,GB,2219,user_001,,
51bc4085-ed81-4595-adc3-d0297c674cd1,2029-04-24,2029-04-24,Amazon UK,5942,Shopping,Online Retail,-64.51,GBP,-127174.17,E-Com,London,GB,1045,user_001,,
fd900de1-0676-4cb6-b0b5-718d35751406,2029-04-24,2029-04-26,Local Market,5499,Groceries,Specialty,-10.09,GBP,-127184.26,POS,London,GB,4488,user_001,,
8d9a1d4a-61ec-405f-b03d-d178d3fc3450,2029-04-25,2029-04-27,Deliveroo,5812,Food & Drink,Delivery,-23.28,GBP,-127207.54,E-Com,London,GB,2219,user_001,,
f3b623e6-4460-4fe5-8bf1-204bdd160ffc,2029-04-25,2029-04-25,T212 Capital,6011,Income,Salary,3181.62,GBP,-124025.92,Credit,London,GB,2219,user_001,rec_2ff8f778d0,
bb34fa5e-2398-4a4a-a595-3fdb5af34be3,2029-04-26,2029-04-27,Uber UK,4121,Transport,Ride Hailing,-8.77,GBP,-124034.69,E-Com,London,GB,9074,user_001,,
fdcf0712-cc8b-4364-90cb-a821f6002409,2029-04-26,2029-04-30,Deliveroo,5812,Food & Drink,Delivery,-13.48,GBP,-124048.17,E-Com,London,GB,9074,user_001,,
291dc561-ec36-4b48-8904-85d7ea00f1be,2029-04-27,2029-04-30,Pret A Manger,5814,Food & Drink,Eating Out,-8.75,GBP,-124056.92,POS,London,GB,9074,user_001,,
624bfdbb-56d6-43fc-bc53-7a830b877cd3,2029-04-27,2029-04-30,Deliveroo,5812,Food & Drink,Delivery,-19.02,GBP,-124075.94,E-Com,London,GB,2219,user_001,,
626720ce-1cf0-4efb-9349-c15d626868f2,2029-04-28,2029-04-30,Apple.com/bill,5734,Shopping,Electronics,-101.55,GBP,-124177.49,E-Com,Cupertino,US,2219,user_002,,
6eb531a1-9ef1-4fc6-9838-fd59e53eb6ad,2029-04-28,2029-04-30,Local Market,5499,Groceries,Specialty,-19.79,GBP,-124197.28,POS,London,GB,1045,user_001,,
826774a9-3b22-4ba2-9806-b39caf96e90e,2029-04-28,2029-04-30,Amazon UK,5942,Shopping,Online Retail,-116.11,GBP,-124313.39,E-Com,London,GB,1045,user_001,,
acdd6b04-aa08-4272-8177-5c779aeb03d2,2029-04-28,2029-04-30,Tesco,5411,Groceries,Supermarket,-73.74,GBP,-124387.13,POS,London,GB,4488,user_002,,
fc9c9767-612a-43d9-92b6-c6bc58fa9a25,2029-04-28,2029-04-30,Apple.com/bill,5734,Shopping,Electronics,-162.09,GBP,-124549.22,E-Com,Cupertino,US,2219,user_001,,
0714deb0-276c-4ba3-877e-8864c89d8f40,2029-04-29,2029-05-01,Shell,5541,Transport,Fuel,-58.44,GBP,-124607.66,POS,London,GB,2219,user_002,,
2938c105-3fbf-40ca-9bd3-5a565773ae21,2029-04-29,2029-05-01,Shell,5541,Transport,Fuel,-41.46,GBP,-124649.12,POS,London,GB,2219,user_001,,
efb4db1b-05cf-4646-8bab-dc24f92ceef7,2029-04-29,2029-04-30,Uber UK,4121,Transport,Ride Hailing,-9.78,GBP,-124658.9,E-Com,London,GB,4488,user_001,,
86fbabfa-e02e-44ff-a70c-13402a8b5769,2029-04-30,2029-05-02,Waitrose,5411,Groceries,Supermarket,-46.6,GBP,-124705.5,POS,London,GB,4488,user_001,,
2240133a-8c14-45b6-a0ff-9f9eb0da885d,2029-05-01,2029-05-02,Crown Estates Lettings,6513,Housing,Rent,-1626.32,GBP,-126331.82,POS,London,GB,2219,user_001,rec_19f70fbcce,
e072ecdb-ac03-4d33-8346-bdd58a9809bf,2029-05-01,2029-05-03,Waitrose,5411,Groceries,Supermarket,-35.93,GBP,-126367.75,POS,London,GB,9074,user_001,,
20b0edd2-813b-4489-8734-b6251fcf1f57,2029-05-02,2029-05-04,Deliveroo,5812,Food & Drink,Delivery,-22.77,GBP,-126390.52,E-Com,London,GB,4488,user_001,,
5f89344e-9b17-4ee5-b89d-b6204ae718fb,2029-05-02,2029-05-03,Waitrose,5411,Groceries,Supermarket,-39.46,GBP,-126429.98,POS,London,GB,1045,user_001,,
133c9af5-2823-43ef-b446-0ed10f13ffa0,2029-05-03,2029-05-07,Tesco,5411,Groceries,Supermarket,-62.82,GBP,-126492.8,POS,London,GB,9074,user_001,,
89a454e3-0654-4fff-8398-f1d07f54dcb8,2029-05-03,2029-05-04,Sainsbury's,5411,Groceries,Supermarket,-56.06,GBP,-126548.86,POS,London,GB,2219,user_001,,
436d1bdd-7f86-4a56-a584-a1074904472c,2029-05-05,2029-05-07,Apple.com/bill,5734,Shopping,Electronics,-44.19,USD,-126593.05,E-Com,Cupertino,US,4488,user_002,,FX purchase 52.81 USD @ rate 1.19
82bf36b5-295b-4b46-9967-4ebf8720a6f7,2029-05-05,2029-05-07,Deliveroo,5812,Food & Drink,Delivery,-13.8,GBP,-126606.85,E-Com,London,GB,9074,user_001,,
a1ad0a8d-ea3b-4c2f-bea6-31fd6c7b0b8a,2029-05-05,2029-05-07,Sainsbury's,5411,Groceries,Supermarket,-47.27,GBP,-126654.12,POS,London,GB,4488,user_001,,
5718321e-94e4-4809-b8ad-b970f5dd1c43,2029-05-06,2029-05-08,Shell,5541,Transport,Fuel,-58.66,GBP,-126712.78,POS,London,GB,4488,user_001,,
e8bd4949-f0fe-4853-a2b1-ef4c6d15ff6c,2029-05-06,2029-05-07,Tesco,5411,Groceries,Supermarket,-75.37,GBP,-126788.15,POS,London,GB,9074,user_001,,
eb41ed9c-98d0-41e5-bf48-55404960dba1,2029-05-06,2029-05-07,Waitrose,5411,Groceries,Supermarket,-79.58,GBP,-126867.73,POS,London,GB,4488,user_002,,
c919ef88-de70-484e-8dff-64b3bbc30321,2029-05-07,2029-05-08,Octopus Energy,4900,Utilities,Electricity,-132.45,GBP,-127000.18,Direct Debit,London,GB,9074,user_001,rec_141a4a0666,
61a51704-dfef-451c-b3f9-c0072c420329,2029-05-08,2029-05-08,Deliveroo,5812,Food & Drink,Delivery,-19.89,GBP,-127020.07,E-Com,London,GB,2219,user_001,,
89f01aab-d77e-4cdf-afc9-d0d6e17b7721,2029-05-08,2029-05-10,Shell,5541,Transport,Fuel,-40.91,GBP,-127060.98,POS,London,GB,2219,user_001,,
a93f1323-155a-4ac0-9e79-14ea02018fdb,2029-05-08,2029-05-09,Local Market,5499,Groceries,Specialty,-19.61,GBP,-127080.59,POS,London,GB,4488,user_001,,
ae9e3cd2-428d-4a6c-96f4-27cd4e0539b6,2029-05-08,2029-05-09,Transport for London,4111,Transport,Transit,-6.12,GBP,-127086.71,POS,London,GB,2219,user_001,,
1caa7beb-2d7e-4795-bead-923436b9f8e8,2029-05-09,2029-05-11,Amazon UK,5942,Shopping,Online Retail,-67.43,GBP,-127154.14,E-Com,London,GB,2219,user_001,,
a1aee38c-d7e6-49d4-8d6c-e04d620fca06,2029-05-09,2029-05-09,Apple.com/bill,5734,Shopping,Electronics,-21.28,USD,-127175.42,E-Com,Cupertino,US,4488,user_001,,FX purchase 26.24 USD @ rate 1.23
a3313ca5-2c4b-48c1-90f4-0ac49c907b8a,2029-05-09,2029-05-11,Local Market,5499,Groceries,Specialty,-16.13,GBP,-127191.55,POS,London,GB,1045,user_002,,
0ac269a2-9896-460a-b9e4-0f221670b954,2029-05-10,2029-05-14,Apple.com/bill,5734,Shopping,Electronics,-135.41,GBP,-127326.96,E-Com,Cupertino,US,1045,user_001,,
77e2d5e0-eaaa-4aef-9c52-e50d59514684,2029-05-10,2029-05-14,Deliveroo,5812,Food & Drink,Delivery,-33.35,GBP,-127360.31,E-Com,London,GB,9074,user_001,,
5abe4136-4017-4cd4-92eb-f58e2c43bcaf,2029-05-11,2029-05-14,Amazon UK,5942,Shopping,Online Retail,-49.49,GBP,-127409.8,E-Com,London,GB,2219,user_001,,
847d4174-86cc-4d80-bebb-adc18afeec0e,2029-05-11,2029-05-11,Tesco,5411,Groceries,Supermarket,-53.39,GBP,-127463.19,POS,London,GB,2219,user_001,,
f41b4f83-5567-4107-9ead-8fe5ab8d30db,2029-05-11,2029-05-14,Thames Water,4900,Utilities,Water,-37.59,GBP,-127500.78,Direct Debit,Reading,GB,9074,user_001,rec_3a34d62842,
331167b3-b667-4a1b-90ab-3df5b84dfbf6,2029-05-12,2029-05-14,Airbnb,7011,Travel,Accommodation,-320.64,EUR,-127821.42,E-Com,Dublin,IE,9074,user_002,,Business travel
46c4e8e3-21e4-48ea-91d6-8898360eab03,2029-05-12,2029-05-14,Uber UK,4121,Transport,Ride Hailing,-10.12,GBP,-127831.54,E-Com,London,GB,9074,user_001,,
489c1be1-206e-4056-919f-4f61a379193e,2029-05-12,2029-05-14,Pret A Manger,5814,Food & Drink,Eating Out,-8.94,GBP,-127840.48,POS,London,GB,9074,user_001,,
4efb011b-17ff-480c-80c8-45c5476e748b,2029-05-13,2029-05-14,Amazon UK,5942,Shopping,Online Retail,-108.31,GBP,-127948.79,E-Com,London,GB,9074,user_002,,
c3abbf62-49ec-4488-8051-f4fc38a20ca2,2029-05-13,2029-05-14,Apple.com/bill,5734,Shopping,Electronics,-123.24,USD,-128072.03,E-Com,Cupertino,US,1045,user_002,,FX purchase 153.88 USD @ rate 1.25
e541cbbe-451a-4955-80c5-eb497b804abb,2029-05-13,2029-05-14,Transport for London,4111,Transport,Transit,-9.12,GBP,-128081.15,POS,London,GB,9074,user_001,,
29bed7df-4c72-45aa-a81c-15271f61d98a,2029-05-14,2029-05-15,Amazon UK,5942,Shopping,Online Retail,-74.38,GBP,-128155.53,E-Com,London,GB,9074,user_002,,
c8c3f2f9-8d7f-4f11-be7f-58d4ba2970e7,2029-05-14,2029-05-14,Apple.com/bill,5734,Shopping,Electronics,-182.37,USD,-128337.9,E-Com,Cupertino,US,2219,user_002,,FX purchase 230.73 USD @ rate 1.27
c8d20b34-b225-47b4-8ebd-2fec8ce78647,2029-05-14,2029-05-15,City Council Tax,9399,Utilities,Council Tax,-151.19,GBP,-128489.09,Direct Debit,London,GB,2219,user_001,rec_f531495db5,
ba003873-35ab-403f-9a50-4ec55e748dff,2029-05-15,2029-05-15,O2 UK,4814,Bills,Mobile,-44.37,GBP,-128533.46,Direct Debit,Slough,GB,2219,user_001,rec_95042d8101,
3bfcaa22-dad5-47ea-b171-43b72589db15,2029-05-16,2029-05-17,Pret A Manger,5814,Food & Drink,Eating Out,-10.82,GBP,-128544.28,POS,London,GB,1045,user_001,,
792bc0ed-0094-4ccd-84b2-489ee1f43ca9,2029-05-16,2029-05-16,Sainsbury's,5411,Groceries,Supermarket,-60.59,GBP,-128604.87,POS,London,GB,1045,user_001,,
a8139dbb-4429-49d7-9888-42acd7fabc98,2029-05-17,2029-05-21,GymBox,7997,Wellness,Gym,-59.14,GBP,-128664.01,Direct Debit,London,GB,4488,user_001,rec_3906953fd2,
d4c1f8b4-c925-4570-a65d-8c7804c52c48,2029-05-17,2029-05-21,Transport for London,4111,Transport,Transit,-11.33,GBP,-128675.34,POS,London,GB,9074,user_001,,
c696774b-f1ba-4e92-bbd5-e7b258b2a55e,2029-05-18,2029-05-21,Transport for London,4111,Transport,Transit,-5.2,GBP,-128680.54,POS,London,GB,4488,user_002,,
e23f040c-7d1c-4528-87fa-64306a59fff0,2029-05-18,2029-05-21,Waitrose,5411,Groceries,Supermarket,-59.02,GBP,-128739.56,POS,London,GB,2219,user_001,,
4f7d043d-1a4b-4a83-953d-03501a9f0150,2029-05-19,2029-05-21,Transport for London,4111,Transport,Transit,-7.56,GBP,-128747.12,POS,London,GB,1045,user_001,,
5272a21a-e5e6-4e44-88c9-f9bc5f8e7c29,2029-05-19,2029-05-21,Pret A Manger,5814,Food & Drink,Eating Out,-8.97,GBP,-128756.09,POS,London,GB,4488,user_001,,
04f8ba0f-7a40-4629-8f90-6f1f5ec13b0d,2029-05-20,2029-05-22,Transport for London,4111,Transport,Transit,-11.67,GBP,-128767.76,POS,London,GB,9074,user_001,,
3dbd8bad-3662-490b-80ae-c575a9ec496e,2029-05-20,2029-05-21,Transport for London,4111,Transport,Transit,-10.03,GBP,-128777.79,POS,London,GB,2219,user_001,,
f4589fb7-e236-4e57-be0a-14f69c5b0ff7,2029-05-20,2029-05-21,Apple.com/bill,5734,Shopping,Electronics,-146.86,GBP,-128924.65,E-Com,Cupertino,US,9074,user_001,,
1e6b34de-065b-4044-aec8-10545c4f1853,2029-05-21,2029-05-21,Spotify,5735,Entertainment,Subscriptions,-8.17,GBP,-128932.82,E-Com,Stockholm,SE,4488,user_001,rec_4c746d2c3b,
8492d154-0944-4b8f-986b-24446e31389a,2029-05-21,2029-05-23,Tesco,5411,Groceries,Supermarket,-51.27,GBP,-128984.09,POS,London,GB,9074,user_001,,
87f5c8a8-a9df-4f37-af96-8cf5475a237d,2029-05-21,2029-05-22,Netflix,7841,Entertainment,Subscriptions,-10.07,USD,-128994.16,E-Com,Los Gatos,US,4488,user_001,rec_1bfe33738d,FX purchase 12.93 USD @ rate 1.28
b174fc83-6151-4dc0-ba61-c161df6bd187,2029-05-24,2029-05-28,Sainsbury's,5411,Groceries,Supermarket,-65.42,GBP,-129059.58,POS,London,GB,1045,user_001,,
c20885f3-1bf7-4065-8bfa-2bc79d78b96d,2029-05-24,2029-05-25,Waitrose,5411,Groceries,Supermarket,-64.78,GBP,-129124.36,POS,London,GB,1045,user_001,,
a127a25b-5326-4b65-a3c9-92665d3ff4bf,2029-05-25,2029-05-28,Transport for London,4111,Transport,Transit,-11.91,GBP,-129136.27,POS,London,GB,9074,user_002,,
c5daa85d-beb8-4536-903c-6e338ff79f81,2029-05-25,2029-05-25,Apple.com/bill,5734,Shopping,Electronics,-85.26,USD,-129221.53,E-Com,Cupertino,US,1045,user_001,,FX purchase 102.61 USD @ rate 1.20
e2f2145e-88bc-4f2d-95c4-058e48bafa9d,2029-05-25,2029-05-25,T212 Capital,6011,Income,Salary,3303.8,GBP,-125917.73,Credit,London,GB,9074,user_001,rec_2ff8f778d0,
c5de4e33-d9ae-407b-a600-2d7279da2eb0,2029-05-26,2029-05-28,Amazon UK,5942,Shopping,Online Retail,-34.34,GBP,-125952.07,E-Com,London,GB,9074,user_001,,
c73a824f-5be3-4b9c-b837-1fea4d1c575e,2029-05-26,2029-05-28,Deliveroo,5812,Food & Drink,Delivery,-24.91,GBP,-125976.98,E-Com,London,GB,9074,user_002,,
e9171e7e-96e9-4399-aaec-73c42b36f7b9,2029-05-26,2029-05-28,Tesco,5411,Groceries,Supermarket,-39.88,GBP,-126016.86,POS,London,GB,4488,user_001,,
5687541c-3751-4238-8745-238584e9c264,2029-05-27,2029-05-29,Uber UK,4121,Transport,Ride Hailing,-18.75,GBP,-126035.61,E-Com,London,GB,4488,user_002,,
abb56d2f-9929-4be3-8cb3-484a7b8c648f,2029-05-27,2029-05-28,Apple.com/bill,5734,Shopping,Electronics,-47.79,GBP,-126083.4,E-Com,Cupertino,US,1045,user_001,,
ca7214c3-eb17-48af-894d-99490efd933c,2029-05-27,2029-05-29,Apple.com/bill,5734,Shopping,Electronics,-108.47,GBP,-126191.87,E-Com,Cupertino,US,1045,user_001,,
65df8eaf-7cc5-4095-86ec-ea7c3b51a11d,2029-05-28,2029-05-28,Shell,5541,Transport,Fuel,-64.39,GBP,-126256.26,POS,London,GB,4488,user_001,,
9c53889b-b3aa-4ba4-ac3d-3deb3717cbc4,2029-05-29,2029-05-31,Apple.com/bill,5734,Shopping,Electronics,-76.04,USD,-126332.3,E-Com,Cupertino,US,4488,user_001,,FX purchase 92.8 USD @ rate 1.22
35efb902-2ce0-4559-b3cd-20dd78b4aeb0,2029-05-30,2029-06-01,Local Market,5499,Groceries,Specialty,-7.84,GBP,-126340.14,POS,London,GB,1045,user_001,,
f0265677-af7e-4662-b6ab-1aee965251bd,2029-05-30,2029-05-31,Local Market,5499,Groceries,Specialty,-8.46,GBP,-126348.6,POS,London,GB,1045,user_001,,
3a910639-9a08-4742-804b-0532c616af86,2029-05-31,2029-06-04,Amazon UK,5942,Shopping,Online Retail,-58.8,GBP,-126407.4,E-Com,London,GB,1045,user_001,,
3557401b-ad50-42af-a279-13115a3cfd79,2029-06-01,2029-06-01,Shell,5541,Transport,Fuel,-86.42,GBP,-126493.82,POS,London,GB,9074,user_001,,
37aab5ff-2aa2-4cba-a546-cff639aa56ed,2029-06-01,2029-06-01,Crown Estates Lettings,6513,Housing,Rent,-1627.12,GBP,-128120.94,POS,London,GB,2219,user_001,rec_19f70fbcce,
b0acc386-8baf-4158-855f-f228f8d7c674,2029-06-01,2029-06-01,Transport for London,4111,Transport,Transit,-7.87,GBP,-128128.81,POS,London,GB,2219,user_001,,
ebd5184b-6127-4eea-8786-858027d3e7db,2029-06-01,2029-06-01,Local Market,5499,Groceries,Specialty,-10.57,GBP,-128139.38,POS,London,GB,4488,user_001,,
6154d580-852a-41f6-8df5-7cf5c36e1535,2029-06-02,2029-06-04,Tesco,5411,Groceries,Supermarket,-66.91,GBP,-128206.29,POS,London,GB,4488,user_001,,
8bcf98b8-9a67-425a-80b3-a2c27e2f6d52,2029-06-02,2029-06-04,Pret A Manger,5814,Food & Drink,Eating Out,-9.83,GBP,-128216.12,POS,London,GB,2219,user_001,,
d830a027-1964-49b5-984c-c3aaf0a99c45,2029-06-02,2029-06-04,Tesco,5411,Groceries,Supermarket,-49.62,GBP,-128265.74,POS,London,GB,4488,user_001,,
4bf8f996-5b7b-4bf2-ad6e-ba26c6edcb83,2029-06-03,2029-06-05,Amazon UK,5942,Shopping,Online Retail,-100.25,GBP,-128365.99,E-Com,London,GB,1045,user_001,,
6c2515e2-12dd-48f8-b688-4e4be1d244c7,2029-06-03,2029-06-04,Uber UK,4121,Transport,Ride Hailing,-18.28,GBP,-128384.27,E-Com,London,GB,9074,user_002,,
f3a37029-4669-4565-8a08-fd79fe8b573c,2029-06-04,2029-06-04,Deliveroo,5812,Food & Drink,Delivery,-23.05,GBP,-128407.32,E-Com,London,GB,9074,user_002,,
aa6536d5-9e6a-4704-baf9-bd2ccfcc5c42,2029-06-05,2029-06-07,Local Market,5499,Groceries,Specialty,-7.86,GBP,-128415.18,POS,London,GB,1045,user_001,,
2fffbaa5-d619-4ffb-a2fb-2c7dd3a92e0f,2029-06-06,2029-06-07,Sainsbury's,5411,Groceries,Supermarket,-18.68,GBP,-128433.86,POS,London,GB,9074,user_001,,
c0c7646f-e553-40f0-a2fb-8d278d9fb2f8,2029-06-06,2029-06-08,Uber UK,4121,Transport,Ride Hailing,-30.56,GBP,-128464.42,E-Com,London,GB,4488,user_001,,
c4de6a7b-4ff6-44cc-9bd0-7e532b078688,2029-06-06,2029-06-07,Local Market,5499,Groceries,Specialty,-14.03,GBP,-128478.45,POS,London,GB,9074,user_001,,
e7f70a61-cfcf-40ca-909f-cab497efad4e,2029-06-06,2029-06-06,Apple.com/bill,5734,Shopping,Electronics,-23.03,GBP,-128501.48,E-Com,Cupertino,US,9074,user_002,,
1bdfc927-e4fa-44cf-b596-0fbe25cc104a,2029-06-07,2029-06-11,Transport for London,4111,Transport,Transit,-11.75,GBP,-128513.23,POS,London,GB,1045,user_002,,
56e0e238-f7c1-45a1-9adc-f4e37ff1351c,2029-06-07,2029-06-08,Tesco,5411,Groceries,Supermarket,-41.02,GBP,-128554.25,POS,London,GB,1045,user_001,,
dd2495c7-455e-46e7-92a0-6261203bd4bf,2029-06-07,2029-06-07,Local Market,5499,Groceries,Specialty,-7.04,GBP,-128561.29,POS,London,GB,1045,user_001,,
dda6ad8f-5d51-4f0d-a171-c809c35d2037,2029-06-07,2029-06-08,Octopus Energy,4900,Utilities,Electricity,-137.36,GBP,-128698.65,Direct Debit,London,GB,4488,user_001,rec_141a4a0666,
58ceb1c6-7d5e-4c3a-9212-ebe399efe6e8,2029-06-09,2029-06-11,Pret A Manger,5814,Food & Drink,Eating Out,-11.82,GBP,-128710.47,POS,London,GB,1045,user_001,,
864bcfc8-fc47-44db-bbb1-7219f97642e5,2029-06-09,2029-06-11,Sainsbury's,5411,Groceries,Supermarket,-63.19,GBP,-128773.66,POS,London,GB,4488,user_001,,
29ec4c9f-6ae4-41fd-bf04-6ebf322ce9c4,2029-06-10,2029-06-11,Shell,5541,Transport,Fuel,-60.34,GBP,-128834.0,POS,London,GB,1045,user_001,,
cad20f32-e923-43ba-8005-169cd6ed81ce,2029-06-10,2029-06-11,Sainsbury's,5411,Groceries,Supermarket,-34.1,GBP,-128868.1,POS,London,GB,1045,user_001,,
d5a40ddd-31af-4000-b9c5-b06e764a4c24,2029-06-10,2029-06-11,Pret A Manger,5814,Food & Drink,Eating Out,-9.87,GBP,-128877.97,POS,London,GB,2219,user_001,,
271e5245-d1ab-4e9e-9a93-0f1ff791f642,2029-06-11,2029-06-13,Uber UK,4121,Transport,Ride Hailing,-28.68,GBP,-128906.65,E-Com,London,GB,2219,user_001,,
410f5278-3504-44e6-ba61-b51fcc4cd95a,2029-06-11,2029-06-11,Shell,5541,Transport,Fuel,-47.6,GBP,-128954.25,POS,London,GB,4488,user_001,,
e440a36f-a35d-4593-88bc-7654c5293d82,2029-06-11,2029-06-11,Thames Water,4900,Utilities,Water,-32.06,GBP,-128986.31,Direct Debit,Reading,GB,4488,user_002,rec_954d02400c,
1a8322e3-1ed5-4dfc-8a2b-bfc1f0ed8595,2029-06-12,2029-06-14,Uber UK,4121,Transport,Ride Hailing,-28.05,GBP,-129014.36,E-Com,London,GB,2219,user_002,,
43b8096c-142a-4d1c-849e-87ed944c926c,2029-06-12,2029-06-12,Shell,5541,Transport,Fuel,-78.39,GBP,-129092.75,POS,London,GB,2219,user_001,,
d6af33bb-372e-41fd-9b2b-5594e7cda7fe,2029-06-12,2029-06-13,Local Market,5499,Groceries,Specialty,-17.33,GBP,-129110.08,POS,London,GB,4488,user_001,,
e5bb38e2-8265-449f-8462-525ca9c67338,2029-06-12,2029-06-13,Local Market,5499,Groceries,Specialty,-18.79,GBP,-129128.87,POS,London,GB,4488,user_002,,
572bda38-e7fd-4b78-aba9-1dc00599bb29,2029-06-13,2029-06-13,Amazon UK,5942,Shopping,Online Retail,-42.67,GBP,-129171.54,E-Com,London,GB,2219,user_001,,
63405ab0-a290-4433-a96b-2034370a339f,2029-06-13,2029-06-14,Pret A Manger,5814,Food & Drink,Eating Out,-9.15,GBP,-129180.69,POS,London,GB,2219,user_001,,
8edbc4c9-309a-4f6b-8459-ad9fa9a4b324,2029-06-13,2029-06-13,City Council Tax,9399,Utilities,Council Tax,-182.64,GBP,-129363.33,Direct Debit,London,GB,2219,user_001,rec_f531495db5,
e453dd82-dc50-4cdd-9698-7dde6fac7148,2029-06-13,2029-06-14,Transport for London,4111,Transport,Transit,-10.45,GBP,-129373.78,POS,London,GB,2219,user_001,,
366b3893-4da7-460b-acd0-17443171ae2d,2029-06-14,2029-06-14,Transport for London,4111,Transport,Transit,-3.93,GBP,-129377.71,POS,London,GB,1045,user_001,,
4e545ff0-1b0f-4215-a7db-22721adab929,2029-06-14,2029-06-15,Amazon UK,5942,Shopping,Online Retail,-53.04,GBP,-129430.75,E-Com,London,GB,9074,user_001,,
1792a2f9-b45b-4a5a-a759-d92145875da0,2029-06-15,2029-06-18,Waitrose,5411,Groceries,Supermarket,-34.84,GBP,-129465.59,POS,London,GB,9074,user_001,,
3236b151-4cfe-4ef3-ba83-ea457de2f867,2029-06-15,2029-06-18,Shell,5541,Transport,Fuel,-37.69,GBP,-129503.28,POS,London,GB,4488,user_001,,
3af8fe8d-9783-4068-a62c-3014097aa780,2029-06-15,2029-06-18,O2 UK,4814,Bills,Mobile,-52.92,GBP,-129556.2,Direct Debit,Slough,GB,1045,user_001,rec_95042d8101,
88578d9e-0679-442f-8b0f-ab86bb04ea05,2029-06-15,2029-06-18,Waitrose,5411,Groceries,Supermarket,-56.08,GBP,-129612.28,POS,London,GB,9074,user_002,,
47ae6110-aa23-4978-854c-5cf46d0239a3,2029-06-16,2029-06-18,Pret A Manger,5814,Food & Drink,Eating Out,-11.7,GBP,-129623.98,POS,London,GB,4488,user_001,,
502124d0-e54f-4142-b361-d9a26da0f904,2029-06-16,2029-06-18,Local Market,5499,Groceries,Specialty,-19.12,GBP,-129643.1,POS,London,GB,9074,user_001,,
8d8d790d-e31f-44ee-ae64-b230aa77d1d8,2029-06-16,2029-06-18,Apple.com/bill,5734,Shopping,Electronics,-144.75,GBP,-129787.85,E-Com,Cupertino,US,1045,user_002,,
1ada2e6c-bc2f-4269-9560-56aee17a931d,2029-06-17,2029-06-18,Deliveroo,5812,Food & Drink,Delivery,-18.54,GBP,-129806.39,E-Com,London,GB,9074,user_001,,
5c96aa4d-ee83-4f27-bf47-1075586af88f,2029-06-17,2029-06-18,Local Market,5499,Groceries,Specialty,-11.47,GBP,-129817.86,POS,London,GB,9074,user_002,,
6074fc7d-5301-4bb8-8639-c01b3cf46f0c,2029-06-17,2029-06-18,Amazon UK,5942,Shopping,Online Retail,-88.2,GBP,-129906.06,E-Com,London,GB,1045,user_002,,
27ba8446-e737-4938-a88f-7bfb965603cd,2029-06-18,2029-06-19,Apple.com/bill,5734,Shopping,Electronics,-86.12,GBP,-129992.18,E-Com,Cupertino,US,2219,user_002,,
28a6b391-ee67-4059-9921-8b1f3ee4696f,2029-06-18,2029-06-19,GymBox,7997,Wellness,Gym,-58.83,GBP,-130051.01,Direct Debit,London,GB,1045,user_001,rec_3906953fd2,
698c6320-28dc-4043-82ca-a12e6ba829cf,2029-06-19,2029-06-19,Transport for London,4111,Transport,Transit,-10.79,GBP,-130061.8,POS,London,GB,4488,user_001,,
dd2e6c0e-eb83-481a-b106-71da2d6fd634,2029-06-19,2029-06-19,Spotify,5735,Entertainment,Subscriptions,-9.01,EUR,-130070.81,E-Com,Stockholm,SE,4488,user_001,rec_4c746d2c3b,FX purchase 10.33 EUR @ rate 1.15
4a1d219a-658f-4f7d-8e55-994880500455,2029-06-20,2029-06-22,Apple.com/bill,5734,Shopping,Electronics,-105.9,USD,-130176.71,E-Com,Cupertino,US,1045,user_001,,FX purchase 132.01 USD @ rate 1.25
e9b39f74-e248-4f7a-b1c4-3040da0b8cab,2029-06-20,2029-06-20,Sainsbury's,5411,Groceries,Supermarket,-16.18,GBP,-130192.89,POS,London,GB,2219,user_002,,
50950294-021b-424e-9f1a-bb812bd379c9,2029-06-21,2029-06-22,Netflix,7841,Entertainment,Subscriptions,-10.44,GBP,-130203.33,E-Com,Los Gatos,US,9074,user_001,rec_1bfe33738d,
b1e8844f-0c99-45d5-b404-62616ab28f2c,2029-06-21,2029-06-22,Uber UK,4121,Transport,Ride Hailing,-30.99,GBP,-130234.32,E-Com,London,GB,2219,user_001,,
30af9e0a-ea53-48aa-b888-9ac062c6ec92,2029-06-22,2029-06-25,Sainsbury's,5411,Groceries,Supermarket,-38.83,GBP,-130273.15,POS,London,GB,1045,user_001,,
536ee8a5-d6ad-488e-9d8e-5b9e7dc5ba93,2029-06-22,2029-06-25,Pret A Manger,5814,Food & Drink,Eating Out,-9.79,GBP,-130282.94,POS,London,GB,4488,user_001,,
c4ef0341-1936-45bd-bdda-0a257c9b7695,2029-06-22,2029-06-22,Airline Refund,4511,Travel,Refund,16.65,GBP,-130266.29,Credit,London,GB,4488,user_001,,Refund for Local Market
300dae3d-c7a8-42e9-bfa8-61f926dca531,2029-06-23,2029-06-25,Tesco,5411,Groceries,Supermarket,-20.72,GBP,-130287.01,POS,London,GB,9074,user_001,,
487839be-7add-45d8-8ee7-d0d273b5ef0a,2029-06-23,2029-06-25,Sainsbury's,5411,Groceries,Supermarket,-14.5,GBP,-130301.51,POS,London,GB,4488,user_001,,
bb15a102-f350-4841-a7a0-e87d674abb64,2029-06-23,2029-06-25,Amazon UK,5942,Shopping,Online Retail,-60.62,GBP,-130362.13,E-Com,London,GB,2219,user_001,,
d365ed6c-3b5e-4a2f-b3fc-b07cbe729cd8,2029-06-23,2029-06-25,Shell,5541,Transport,Fuel,-83.33,GBP,-130445.46,POS,London,GB,9074,user_002,,
dc2af8bc-52cb-4f99-98fb-120ab553123e,2029-06-23,2029-06-25,Apple.com/bill,5734,Shopping,Electronics,-2.69,GBP,-130448.15,E-Com,Cupertino,US,9074,user_001,,
e3334ab5-25f9-4493-bbcb-e6ecc1e53981,2029-06-23,2029-06-25,Amazon UK,5942,Shopping,Online Retail,-10.86,GBP,-130459.01,E-Com,London,GB,4488,user_001,,
0cedd8b2-550f-4daf-85d5-c36e9e2ff944,2029-06-24,2029-06-25,Deliveroo,5812,Food & Drink,Delivery,-18.75,GBP,-130477.76,E-Com,London,GB,1045,user_001,,
fffa7f76-2a32-4b21-8401-1f7d975e7e38,2029-06-24,2029-06-26,Pret A Manger,5814,Food & Drink,Eating Out,-7.19,GBP,-130484.95,POS,London,GB,4488,user_001,,
1f5a3b65-3299-4775-a01f-7941a78f0bd6,2029-06-25,2029-06-27,Sainsbury's,5411,Groceries,Supermarket,-43.62,GBP,-130528.57,POS,London,GB,9074,user_002,,
40c75f5d-fdcc-46bc-98b9-26e0dcb4e036,2029-06-25,2029-06-25,Deliveroo,5812,Food & Drink,Delivery,-30.76,GBP,-130559.33,E-Com,London,GB,9074,user_001,,
a9ed9378-eaf1-4ccd-85de-be6e212eeb5d,2029-06-25,2029-06-25,T212 Capital,6011,Income,Salary,3380.57,GBP,-127178.76,Credit,London,GB,9074,user_001,rec_2ff8f778d0,
cf84aa4e-6507-4821-8797-387c45051d7a,2029-06-25,2029-06-26,Sainsbury's,5411,Groceries,Supermarket,-66.98,GBP,-127245.74,POS,London,GB,9074,user_002,,
1eff1f56-e9a8-42fe-bec7-4a18ee10e6b4,2029-06-27,2029-06-27,Pret A Manger,5814,Food & Drink,Eating Out,-7.01,GBP,-127252.75,POS,London,GB,9074,user_001,,
308d390e-332f-4a4b-9e79-ab2111792ab5,2029-06-27,2029-06-29,Local Market,5499,Groceries,Specialty,-21.59,GBP,-127274.34,POS,London,GB,4488,user_002,,
82fb0b08-9291-4496-88bf-16baa8a13ffc,2029-06-27,2029-06-27,Apple.com/bill,5734,Shopping,Electronics,-124.57,GBP,-127398.91,E-Com,Cupertino,US,1045,user_001,,
93f756d0-da5a-4d8f-817a-6867251518e6,2029-06-28,2029-06-29,Sainsbury's,5411,Groceries,Supermarket,-18.16,GBP,-127417.07,POS,London,GB,2219,user_001,,
f9ed394f-713f-4920-9454-2f0002a0894a,2029-06-28,2029-06-28,Tesco,5411,Groceries,Supermarket,-50.68,GBP,-127467.75,POS,London,GB,1045,user_002,,
4aa73d5a-4ccc-4a90-bdec-2d92069402fd,2029-06-29,2029-07-02,Deliveroo,5812,Food & Drink,Delivery,-16.05,GBP,-127483.8,E-Com,London,GB,4488,user_001,,
bd9d334d-da61-43b9-a1c1-3dcef2bc28f7,2029-06-29,2029-07-02,Sainsbury's,5411,Groceries,Supermarket,-64.35,GBP,-127548.15,POS,London,GB,4488,user_001,,
c641072e-1413-4dbd-bf0d-ddbaeb68582d,2029-06-29,2029-06-29,Apple.com/bill,5734,Shopping,Electronics,-166.77,GBP,-127714.92,E-Com,Cupertino,US,4488,user_002,,
5b2aeebc-40f8-4667-beea-bda880c8ef11,2029-06-30,2029-07-02,Pret A Manger,5814,Food & Drink,Eating Out,-11.62,GBP,-127726.54,POS,London,GB,9074,user_002,,
816aab2e-c18d-4cea-8404-aac9ab87f88f,2029-06-30,2029-07-02,Pret A Manger,5814,Food & Drink,Eating Out,-11.12,GBP,-127737.66,POS,London,GB,4488,user_001,,
fa7ee36a-a855-428d-a286-81b00a2c531a,2029-06-30,2029-07-02,Local Market,5499,Groceries,Specialty,-15.29,GBP,-127752.95,POS,London,GB,4488,user_001,,
89e1a654-a21c-4743-b2e9-23ff33c559c5,2029-07-01,2029-07-02,Tesco,5411,Groceries,Supermarket,-27.48,GBP,-127780.43,POS,London,GB,1045,user_001,,
3ab3aa02-9041-4326-a0c4-367778f124cc,2029-07-02,2029-07-04,Uber UK,4121,Transport,Ride Hailing,-27.31,GBP,-127807.74,E-Com,London,GB,4488,user_001,,
61d8c725-d52f-4305-908d-f76c81a44695,2029-07-02,2029-07-03,Crown Estates Lettings,6513,Housing,Rent,-1503.58,GBP,-129311.32,POS,London,GB,9074,user_001,rec_19f70fbcce,
5a59bcb5-c0f7-495f-adba-4387c8a51e1a,2029-07-03,2029-07-05,Apple.com/bill,5734,Shopping,Electronics,-25.83,GBP,-129337.15,E-Com,Cupertino,US,1045,user_002,,
6694b3ff-71dd-43f1-b124-c1d087739d0b,2029-07-03,2029-07-04,Tesco,5411,Groceries,Supermarket,-51.79,GBP,-129388.94,POS,London,GB,4488,user_001,,
9e08a572-03db-4861-80a4-8a8a39727092,2029-07-04,2029-07-04,Apple.com/bill,5734,Shopping,Electronics,-147.3,USD,-129536.24,E-Com,Cupertino,US,2219,user_002,,FX purchase 187.86 USD @ rate 1.28
f41dc6e6-54cc-4e76-ab0b-e8ab9bce0262,2029-07-04,2029-07-04,Transport for London,4111,Transport,Transit,-11.38,GBP,-129547.62,POS,London,GB,9074,user_001,,
88ff9cbf-edf2-4b3d-aa48-f8d246a08fd8,2029-07-05,2029-07-06,Transport for London,4111,Transport,Transit,-6.82,GBP,-129554.44,POS,London,GB,2219,user_002,,
af1fd702-7188-43c9-96de-730a18ad0d4f,2029-07-05,2029-07-06,Apple.com/bill,5734,Shopping,Electronics,-68.38,GBP,-129622.82,E-Com,Cupertino,US,4488,user_001,,
509f1a12-ca5e-4cdc-b214-ec0bca999dbe,2029-07-06,2029-07-09,Waitrose,5411,Groceries,Supermarket,-21.61,GBP,-129644.43,POS,London,GB,1045,user_002,,
c23c45cc-ab20-47de-8af5-ba4edeed3fda,2029-07-06,2029-07-09,Uber UK,4121,Transport,Ride Hailing,-20.99,GBP,-129665.42,E-Com,London,GB,4488,user_001,,
11bde60e-a831-4815-ae5d-09d0ce023086,2029-07-07,2029-07-09,Waitrose,5411,Groceries,Supermarket,-60.53,GBP,-129725.95,POS,London,GB,2219,user_001,,
1528427e-22f8-4f19-92d4-3dcc715525d0,2029-07-07,2029-07-09,Uber UK,4121,Transport,Ride Hailing,-34.7,GBP,-129760.65,E-Com,London,GB,9074,user_002,,
181d0d83-bb30-40e8-907a-fde73ed9148a,2029-07-07,2029-07-09,Transport for London,4111,Transport,Transit,-7.04,GBP,-129767.69,POS,London,GB,2219,user_001,,
1bc3e831-2745-4ea6-b467-53bff53088cb,2029-07-07,2029-07-09,Waitrose,5411,Groceries,Supermarket,-61.21,GBP,-129828.9,POS,London,GB,4488,user_001,,
29d638db-8674-473b-81d0-59fee4000a03,2029-07-07,2029-07-09,Pret A Manger,5814,Food & Drink,Eating Out,-6.95,GBP,-129835.85,POS,London,GB,1045,user_001,,
3dc11d01-fe9f-4257-87cf-dcbb28cdd24b,2029-07-07,2029-07-09,Tesco,5411,Groceries,Supermarket,-79.74,GBP,-129915.59,POS,London,GB,2219,user_002,,
3eea9e17-ab19-45dd-b1be-370942dd9d9d,2029-07-07,2029-07-09,Sainsbury's,5411,Groceries,Supermarket,-33.88,GBP,-129949.47,POS,London,GB,4488,user_002,,
c114773b-381a-4142-8d8b-1624efca9864,2029-07-07,2029-07-09,Shell,5541,Transport,Fuel,-60.43,GBP,-130009.9,POS,London,GB,9074,user_001,,
2cc849ed-d3e0-4d44-a33a-44b6e3f30d95,2029-07-08,2029-07-09,Deliveroo,5812,Food & Drink,Delivery,-30.32,GBP,-130040.22,E-Com,London,GB,4488,user_001,,
33701af0-e10c-45ac-b7e4-15bc50bd00c0,2029-07-08,2029-07-09,Deliveroo,5812,Food & Drink,Delivery,-31.85,GBP,-130072.07,E-Com,London,GB,2219,user_001,,
39391c18-0ec0-41ed-87e3-61469b85545e,2029-07-08,2029-07-09,Pret A Manger,5814,Food & Drink,Eating Out,-10.27,GBP,-130082.34,POS,London,GB,2219,user_001,,
3ab15bd0-a360-4771-b965-ed7890f87b18,2029-07-08,2029-07-09,Uber UK,4121,Transport,Ride Hailing,-27.12,GBP,-130109.46,E-Com,London,GB,1045,user_001,,
a2ab29de-1302-456d-90f9-094fa088ac86,2029-07-08,2029-07-10,Shell,5541,Transport,Fuel,-52.18,GBP,-130161.64,POS,London,GB,4488,user_001,,
5caa47da-ca61-4ad9-8b54-397c9599bab0,2029-07-09,2029-07-10,Amazon UK,5942,Shopping,Online Retail,-117.64,GBP,-130279.28,E-Com,London,GB,1045,user_002,,
a9580632-530b-49f6-953c-eaa1d9d760be,2029-07-09,2029-07-11,Octopus Energy,4900,Utilities,Electricity,-137.28,GBP,-130416.56,Direct Debit,London,GB,1045,user_001,rec_141a4a0666,
19152353-5cd9-420d-bff2-20a9cc80c0fd,2029-07-10,2029-07-10,Shell,5541,Transport,Fuel,-56.19,GBP,-130472.75,POS,London,GB,4488,user_001,,
33c6692d-6da6-4980-9251-b1908f0fd11d,2029-07-10,2029-07-10,Pret A Manger,5814,Food & Drink,Eating Out,-9.51,GBP,-130482.26,POS,London,GB,9074,user_001,,
487e46b7-f49e-4e4b-a8d6-1353d45c951e,2029-07-10,2029-07-12,Deliveroo,5812,Food & Drink,Delivery,-18.06,GBP,-130500.32,E-Com,London,GB,4488,user_001,,
010a2559-bce5-4539-8209-f51d7ba2c528,2029-07-11,2029-07-13,Pret A Manger,5814,Food & Drink,Eating Out,-6.84,GBP,-130507.16,POS,London,GB,9074,user_001,,
3f6f2624-5f57-414d-a1a1-ef3b0e557c78,2029-07-11,2029-07-13,Pret A Manger,5814,Food & Drink,Eating Out,-8.98,GBP,-130516.14,POS,London,GB,9074,user_001,,
6594faff-3432-43f0-a394-20c34c7fbf28,2029-07-11,2029-07-11,Transport for London,4111,Transport,Transit,-11.54,GBP,-130527.68,POS,London,GB,9074,user_001,,
ad087d66-9f94-4012-accb-4ea8f8f86f63,2029-07-11,2029-07-11,Thames Water,4900,Utilities,Water,-34.81,GBP,-130562.49,Direct Debit,Reading,GB,1045,user_002,rec_954d02400c,
0f0a3d4a-8c7b-4c84-a0d8-cb144a4b2b5e,2029-07-12,2029-07-16,Transport for London,4111,Transport,Transit,-6.82,GBP,-130569.31,POS,London,GB,4488,user_001,,
fa04de6f-3b14-4106-98a3-0623a28f05c8,2029-07-12,2029-07-16,Waitrose,5411,Groceries,Supermarket,-66.47,GBP,-130635.78,POS,London,GB,1045,user_001,,
32b61105-228e-473e-9e76-9f8b065b30f3,2029-07-13,2029-07-16,Apple.com/bill,5734,Shopping,Electronics,-91.26,USD,-130727.04,E-Com,Cupertino,US,4488,user_001,,FX purchase 117.58 USD @ rate 1.29
ba182699-72af-4d2f-893a-dd2c263e1430,2029-07-13,2029-07-13,City Council Tax,9399,Utilities,Council Tax,-164.59,GBP,-130891.63,Direct Debit,London,GB,2219,user_001,rec_f531495db5,
be4669e5-0c87-4880-af1f-aee685dc68e0,2029-07-13,2029-07-13,Uber UK,4121,Transport,Ride Hailing,-35.32,GBP,-130926.95,E-Com,London,GB,1045,user_001,,
3cefe234-6c79-4c85-94bb-edac30d348a4,2029-07-14,2029-07-16,Waitrose,5411,Groceries,Supermarket,-50.92,GBP,-130977.87,POS,London,GB,4488,user_001,,
890960c4-0ad0-468d-82e6-a86962521af7,2029-07-14,2029-07-16,Pret A Manger,5814,Food & Drink,Eating Out,-10.83,GBP,-130988.7,POS,London,GB,1045,user_001,,
5ddcb776-ed68-4751-8e90-4b9a218ec891,2029-07-15,2029-07-16,Sainsbury's,5411,Groceries,Supermarket,-52.87,GBP,-131041.57,POS,London,GB,9074,user_001,,
f868f8fc-4c8e-41b8-ad35-adf6526b645a,2029-07-15,2029-07-16,HM Revenue & Customs,9311,Income,Tax Refund,1091.56,GBP,-129950.01,Credit,London,GB,9074,user_001,,Refund for Crown Estates Lettings
fe04a033-df5f-4235-8ffe-debbb9bada4f,2029-07-15,2029-07-16,Deliveroo,5812,Food & Drink,Delivery,-12.87,GBP,-129962.88,E-Com,London,GB,9074,user_001,,
fe5805c0-1a60-4608-bfa8-7a0e819e85a8,2029-07-15,2029-07-16,Pret A Manger,5814,Food & Drink,Eating Out,-6.6,GBP,-129969.48,POS,London,GB,9074,user_001,,
7a90e3b9-9945-49b9-a466-8879d4d1968c,2029-07-16,2029-07-16,Deliveroo,5812,Food & Drink,Delivery,-28.09,GBP,-129997.57,E-Com,London,GB,1045,user_001,,
e0e6f3d2-fcea-4e4d-80b2-2b6e7037710b,2029-07-16,2029-07-17,O2 UK,4814,Bills,Mobile,-39.6,GBP,-130037.17,Direct Debit,Slough,GB,9074,user_001,rec_95042d8101,
9093ab24-c0ca-4fb0-9785-f73d8ef1f223,2029-07-17,2029-07-17,GymBox,7997,Wellness,Gym,-58.84,GBP,-130096.01,Direct Debit,London,GB,4488,user_001,rec_3906953fd2,
9653e9af-dd9b-4ae2-bf8b-5146e844db49,2029-07-17,2029-07-18,Amazon UK,5942,Shopping,Online Retail,-86.21,GBP,-130182.22,E-Com,London,GB,4488,user_001,,
fd1b7ca1-3023-454c-89a6-60b3762bf2f3,2029-07-17,2029-07-17,Sainsbury's,5411,Groceries,Supermarket,-38.47,GBP,-130220.69,POS,London,GB,4488,user_001,,
eacd9b0c-9800-480c-9ded-e46b991bac66,2029-07-18,2029-07-18,Local Market,5499,Groceries,Specialty,-16.19,GBP,-130236.88,POS,London,GB,1045,user_001,,
45876231-6cf8-415d-9238-c3d2a735df17,2029-07-19,2029-07-20,Tesco,5411,Groceries,Supermarket,-39.89,GBP,-130276.77,POS,London,GB,9074,user_001,,
69c18726-8871-45b2-aa5b-0e0a530a80e8,2029-07-19,2029-07-23,Shell,5541,Transport,Fuel,-34.27,GBP,-130311.04,POS,London,GB,1045,user_001,,
c5fc283b-533f-45a3-91ab-160c94f55de7,2029-07-19,2029-07-23,Spotify,5735,Entertainment,Subscriptions,-9.47,GBP,-130320.51,E-Com,Stockholm,SE,9074,user_001,rec_4c746d2c3b,
e2071c51-e8f2-4224-af6a-43081d947ffc,2029-07-19,2029-07-20,Local Market,5499,Groceries,Specialty,-12.71,GBP,-130333.22,POS,London,GB,1045,user_001,,
fbb51643-4bd7-4b81-8f31-cf788ef445c5,2029-07-19,2029-07-19,Deliveroo,5812,Food & Drink,Delivery,-12.98,GBP,-130346.2,E-Com,London,GB,9074,user_001,,
533a14f4-6694-4eaa-8a58-b448975be191,2029-07-20,2029-07-20,Local Market,5499,Groceries,Specialty,-21.01,GBP,-130367.21,POS,London,GB,4488,user_001,,
705b39bc-4309-4762-ad57-149720f710ac,2029-07-20,2029-07-23,Apple.com/bill,5734,Shopping,Electronics,-74.07,GBP,-130441.28,E-Com,Cupertino,US,1045,user_001,,
a2c63cef-443c-4fb1-92e2-c488890d7e31,2029-07-20,2029-07-20,Amazon UK,5942,Shopping,Online Retail,-115.05,GBP,-130556.33,E-Com,London,GB,4488,user_001,,
9931b1f3-4095-4dc1-a199-9b1d582c5d2c,2029-07-21,2029-07-23,Waitrose,5411,Groceries,Supermarket,-50.76,GBP,-130607.09,POS,London,GB,4488,user_001,,
dbc37092-899b-4627-809a-bc08438a990d,2029-07-21,2029-07-23,Pret A Manger,5814,Food & Drink,Eating Out,-9.8,GBP,-130616.89,POS,London,GB,1045,user_001,,
f0867455-57ba-4018-b53d-1988baea70b4,2029-07-21,2029-07-23,Apple.com/bill,5734,Shopping,Electronics,-58.57,GBP,-130675.46,E-Com,Cupertino,US,4488,user_002,,
28ffe38e-29eb-4b8a-b241-1b851d0b35a9,2029-07-22,2029-07-24,Sainsbury's,5411,Groceries,Supermarket,-36.26,GBP,-130711.72,POS,London,GB,9074,user_001,,
3dc2261c-36c3-41f5-b14e-126c59512c4e,2029-07-22,2029-07-23,Amazon UK,5942,Shopping,Online Retail,-78.57,GBP,-130790.29,E-Com,London,GB,1045,user_001,,
65fd99de-71c9-4be5-9a7e-0d3e0e7ad20d,2029-07-22,2029-07-23,Transport for London,4111,Transport,Transit,-10.77,GBP,-130801.06,POS,London,GB,1045,user_001,,
830ecbac-cc38-4a7f-9f44-1e09fbcc3e70,2029-07-22,2029-07-24,Tesco,5411,Groceries,Supermarket,-70.71,GBP,-130871.77,POS,London,GB,2219,user_001,,
442590a1-1ea9-4b13-bbcb-e15f0ff7f67f,2029-07-23,2029-07-24,Netflix,7841,Entertainment,Subscriptions,-15.7,GBP,-130887.47,E-Com,Los Gatos,US,4488,user_001,rec_1bfe33738d,
778c4337-c45e-46d2-9bff-dbe6a727a29d,2029-07-23,2029-07-24,Transport for London,4111,Transport,Transit,-7.26,GBP,-130894.73,POS,London,GB,2219,user_001,,
8e4194fb-dace-4268-a475-4ad4355c62e1,2029-07-23,2029-07-25,Pret A Manger,5814,Food & Drink,Eating Out,-5.67,GBP,-130900.4,POS,London,GB,2219,user_001,,
dc1d6a39-cb28-4ab7-9e51-68bd306a4368,2029-07-24,2029-07-25,Shell,5541,Transport,Fuel,-40.37,GBP,-130940.77,POS,London,GB,4488,user_001,,
e55225e0-f36c-43a7-b237-7db123a5a5c8,2029-07-24,2029-07-25,Shell,5541,Transport,Fuel,-79.11,GBP,-131019.88,POS,London,GB,2219,user_001,,
0b08d8cb-f902-4f1d-9742-2a4966fad332,2029-07-25,2029-07-25,Shell,5541,Transport,Fuel,-91.68,GBP,-131111.56,POS,London,GB,2219,user_002,,
2f5e4907-f526-41ee-9a75-1a5325ceb021,2029-07-25,2029-07-25,T212 Capital,6011,Income,Salary,3288.76,GBP,-127822.8,Credit,London,GB,4488,user_001,rec_2ff8f778d0,
32e96d65-bbbc-46b1-b427-10538316eba7,2029-07-25,2029-07-26,Pret A Manger,5814,Food & Drink,Eating Out,-5.6,GBP,-127828.4,POS,London,GB,9074,user_001,,
1f878b06-ec00-442f-9c2e-88aaf588dd22,2029-07-26,2029-07-30,Deliveroo,5812,Food & Drink,Delivery,-29.45,GBP,-127857.85,E-Com,London,GB,1045,user_002,,
ac05b1db-1439-495b-98cb-28d2aa96f912,2029-07-26,2029-07-26,Shell,5541,Transport,Fuel,-59.45,GBP,-127917.3,POS,London,GB,2219,user_001,,
c8f32cf8-5487-49f3-a5cd-9c812af23014,2029-07-26,2029-07-30,Shell,5541,Transport,Fuel,-31.99,GBP,-127949.29,POS,London,GB,1045,user_001,,
8eecb079-e7f1-4a0f-9448-78070cebecb5,2029-07-27,2029-07-30,Sainsbury's,5411,Groceries,Supermarket,-17.97,GBP,-127967.26,POS,London,GB,1045,user_001,,
965427f3-0a59-435b-b01c-de5b5d8797f9,2029-07-27,2029-07-30,Amazon UK,5942,Shopping,Online Retail,-72.58,GBP,-128039.84,E-Com,London,GB,1045,user_001,,
a1cfb7c7-1206-4c46-bf32-c3d9ae9e9f7e,2029-07-27,2029-07-30,Shell,5541,Transport,Fuel,-94.17,GBP,-128134.01,POS,London,GB,2219,user_002,,
aafbff4f-0dd2-457a-abf3-c5a2d9606030,2029-07-27,2029-07-30,Deliveroo,5812,Food & Drink,Delivery,-30.1,GBP,-128164.11,E-Com,London,GB,9074,user_001,,
74099d62-75a4-415d-bf8d-deca9618da99,2029-07-28,2029-07-30,Waitrose,5411,Groceries,Supermarket,-32.67,GBP,-128196.78,POS,London,GB,2219,user_002,,
63ba8df4-2f20-49f9-87f7-00353ad6ad88,2029-07-29,2029-07-31,Sainsbury's,5411,Groceries,Supermarket,-28.95,GBP,-128225.73,POS,London,GB,9074,user_001,,
734dd7c9-69d8-4d44-8021-7a4bd81432ae,2029-07-29,2029-07-30,Shell,5541,Transport,Fuel,-59.2,GBP,-128284.93,POS,London,GB,9074,user_001,,
77029528-2f04-4884-9a2a-845af3f0a080,2029-07-29,2029-07-30,Deliveroo,5812,Food & Drink,Delivery,-18.99,GBP,-128303.92,E-Com,London,GB,9074,user_001,,
bd73d246-6c6d-4c2a-a380-c0c11db2b39e,2029-07-29,2029-07-30,HM Revenue & Customs,9311,Income,Tax Refund,21.0,GBP,-128282.92,Credit,London,GB,4488,user_001,,Refund for Tesco
ec10f0a0-d2a4-4226-a1dc-64ec90162245,2029-07-30,2029-07-31,Uber UK,4121,Transport,Ride Hailing,-35.19,GBP,-128318.11,E-Com,London,GB,2219,user_001,,
2f8e6f81-1686-4448-8e37-c2dfd6323d09,2029-08-01,2029-08-03,Deliveroo,5812,Food & Drink,Delivery,-22.22,GBP,-128340.33,E-Com,London,GB,2219,user_001,,
4cc49ac9-4014-4f57-bdcf-cdccd5b97715,2029-08-01,2029-08-01,Crown Estates Lettings,6513,Housing,Rent,-1589.78,GBP,-129930.11,POS,London,GB,4488,user_001,rec_19f70fbcce,
62acb1d9-64fc-4e2c-a3a4-ab849d0262ea,2029-08-01,2029-08-01,Pret A Manger,5814,Food & Drink,Eating Out,-6.41,GBP,-129936.52,POS,London,GB,1045,user_001,,
1c3b3b0b-b575-4ad6-a288-7e4cbcf746b7,2029-08-02,2029-08-02,Local Market,5499,Groceries,Specialty,-8.86,GBP,-129945.38,POS,London,GB,9074,user_002,,
8099fbff-08d3-40a3-9a22-536197d32be1,2029-08-03,2029-08-06,Deliveroo,5812,Food & Drink,Delivery,-12.91,GBP,-129958.29,E-Com,London,GB,9074,user_001,,
ba408031-5a9b-4e1b-944a-56cc75149e07,2029-08-03,2029-08-06,Deliveroo,5812,Food & Drink,Delivery,-18.02,GBP,-129976.31,E-Com,London,GB,2219,user_001,,
92522ed7-e586-4451-b641-9fa86eb3cf2f,2029-08-04,2029-08-06,Shell,5541,Transport,Fuel,-38.41,GBP,-130014.72,POS,London,GB,1045,user_001,,
9f95911e-763e-43bc-9143-2337b56538dc,2029-08-04,2029-08-06,Deliveroo,5812,Food & Drink,Delivery,-24.6,GBP,-130039.32,E-Com,London,GB,9074,user_001,,
0bc93adb-192f-42fb-a5b9-5111b2714f32,2029-08-05,2029-08-06,Airline Refund,4511,Travel,Refund,27.74,GBP,-130011.58,Credit,London,GB,1045,user_001,,Refund for Sainsbury's
3c5c7646-16d7-4255-95a6-22f089287ff1,2029-08-05,2029-08-07,Amazon UK,5942,Shopping,Online Retail,-92.88,GBP,-130104.46,E-Com,London,GB,4488,user_001,,
483d60a0-8465-4be7-aea7-b51127a9b706,2029-08-05,2029-08-07,Shell,5541,Transport,Fuel,-83.86,GBP,-130188.32,POS,London,GB,9074,user_001,,
cbd6c632-da39-41ed-82df-aa7eb0d685da,2029-08-05,2029-08-06,Airline Refund,4511,Travel,Refund,25.87,GBP,-130162.45,Credit,London,GB,2219,user_001,,Refund for Shell
abf51d84-42b1-4720-b644-c2011eaf03e2,2029-08-06,2029-08-07,Transport for London,4111,Transport,Transit,-7.06,GBP,-130169.51,POS,London,GB,9074,user_001,,
548c94b6-13a3-4de3-a7a5-54aed751fccf,2029-08-07,2029-08-09,Octopus Energy,4900,Utilities,Electricity,-127.79,GBP,-130297.3,Direct Debit,London,GB,4488,user_001,rec_141a4a0666,
f5b5af0f-cb23-4890-88da-3b0fdc242bde,2029-08-07,2029-08-07,Transport for London,4111,Transport,Transit,-9.1,GBP,-130306.4,POS,London,GB,2219,user_001,,
d8db8634-cf10-43bb-96de-b33709dac600,2029-08-08,2029-08-10,Sainsbury's,5411,Groceries,Supermarket,-18.25,GBP,-130324.65,POS,London,GB,4488,user_001,,
f2d04bdd-4e43-4c43-8fe5-b4bff0b514d8,2029-08-09,2029-08-09,Amazon UK,5942,Shopping,Online Retail,-76.5,GBP,-130401.15,E-Com,London,GB,2219,user_001,,
09ddcc24-ba27-42ca-b2ff-8dfe1f2871dd,2029-08-10,2029-08-13,Transport for London,4111,Transport,Transit,-7.4,GBP,-130408.55,POS,London,GB,4488,user_002,,
25f934b1-9140-49da-9564-1132df31aa8f,2029-08-10,2029-08-13,Sainsbury's,5411,Groceries,Supermarket,-33.66,GBP,-130442.21,POS,London,GB,2219,user_001,,
34d4f5f8-6b24-4a7a-bcd3-9adc70268a84,2029-08-11,2029-08-13,Apple.com/bill,5734,Shopping,Electronics,-196.04,GBP,-130638.25,E-Com,Cupertino,US,2219,user_001,,
b9d621f3-5a34-47a7-875c-6675d525de36,2029-08-11,2029-08-13,Apple.com/bill,5734,Shopping,Electronics,-77.38,GBP,-130715.63,E-Com,Cupertino,US,4488,user_001,,
34dd5c44-790c-490f-8e27-90a24a90f955,2029-08-12,2029-08-14,Shell,5541,Transport,Fuel,-92.48,GBP,-130808.11,POS,London,GB,9074,user_001,,
60ede98b-dd5c-48d0-82cf-477c748e497a,2029-08-12,2029-08-13,Deliveroo,5812,Food & Drink,Delivery,-18.61,GBP,-130826.72,E-Com,London,GB,9074,user_001,,
7726e5b6-c72f-4b7f-8fb2-ec1c39a21eb4,2029-08-12,2029-08-13,Waitrose,5411,Groceries,Supermarket,-59.26,GBP,-130885.98,POS,London,GB,9074,user_001,,
8207309f-726d-497f-b599-0386d65d642e,2029-08-13,2029-08-14,Tesco,5411,Groceries,Supermarket,-50.24,GBP,-130936.22,POS,London,GB,4488,user_001,,
a0a4c4c5-12a2-47d5-88a0-d9ff27eabb19,2029-08-13,2029-08-13,City Council Tax,9399,Utilities,Council Tax,-154.08,GBP,-131090.3,Direct Debit,London,GB,9074,user_001,rec_f531495db5,
f96aeee4-1881-418a-8f9a-079398f78c4a,2029-08-13,2029-08-14,Thames Water,4900,Utilities,Water,-36.57,GBP,-131126.87,Direct Debit,Reading,GB,1045,user_001,rec_3a34d62842,
1fd6bd54-bbba-435a-999d-2cd973e4f9fb,2029-08-14,2029-08-16,Shell,5541,Transport,Fuel,-67.02,GBP,-131193.89,POS,London,GB,4488,user_001,,
337d1420-a9dc-472b-8de8-5239f99e17f6,2029-08-14,2029-08-14,Pret A Manger,5814,Food & Drink,Eating Out,-10.91,GBP,-131204.8,POS,London,GB,9074,user_001,,
68ee2594-d9d8-422f-b7c2-df59456139a8,2029-08-14,2029-08-15,Pret A Manger,5814,Food & Drink,Eating Out,-8.78,GBP,-131213.58,POS,London,GB,2219,user_001,,
ab34830a-e8fa-4b88-b6e3-0e9e31d1614b,2029-08-14,2029-08-15,Local Market,5499,Groceries,Specialty,-18.09,GBP,-131231.67,POS,London,GB,2219,user_001,,
d58a7e63-81b7-48da-afbe-2f02290df5eb,2029-08-14,2029-08-16,Transport for London,4111,Transport,Transit,-8.1,GBP,-131239.77,POS,London,GB,1045,user_002,,
1ca218c8-c0d7-466f-a7cf-b6945a17e98c,2029-08-15,2029-08-15,Amazon UK,5942,Shopping,Online Retail,-38.8,GBP,-131278.57,E-Com,London,GB,2219,user_001,,
4e3decef-4341-451b-a2e6-a4ff806853c0,2029-08-15,2029-08-17,O2 UK,4814,Bills,Mobile,-48.51,GBP,-131327.08,Direct Debit,Slough,GB,2219,user_002,rec_d2dce4c42f,
62e800e1-fa9c-4aad-958c-4a077f400546,2029-08-15,2029-08-16,Sainsbury's,5411,Groceries,Supermarket,-46.83,GBP,-131373.91,POS,London,GB,1045,user_001,,
951c98f8-1fc6-433b-b74b-e24c3021326a,2029-08-15,2029-08-15,Deliveroo,5812,Food & Drink,Delivery,-14.9,GBP,-131388.81,E-Com,London,GB,1045,user_001,,
ab06c69e-cee8-4a7c-8e77-4840dcce8405,2029-08-15,2029-08-15,Airline Refund,4511,Travel,Refund,3.41,GBP,-131385.4,Credit,London,GB,4488,user_001,,Refund for Pret A Manger
ceb2f195-e45d-4d53-99c8-b734dc3e94fd,2029-08-15,2029-08-16,Waitrose,5411,Groceries,Supermarket,-25.13,GBP,-131410.53,POS,London,GB,1045,user_001,,
c7c0b9dd-52e2-4a0d-9e4b-6a841b2cb237,2029-08-17,2029-08-17,GymBox,7997,Wellness,Gym,-57.8,GBP,-131468.33,Direct Debit,London,GB,9074,user_001,rec_3906953fd2,
cd9787ce-3535-4512-b954-59b7f58c8b67,2029-08-17,2029-08-20,Uber UK,4121,Transport,Ride Hailing,-35.94,GBP,-131504.27,E-Com,London,GB,4488,user_002,,
c0c64bbd-dd23-4bfc-b4f7-1ada16d3815f,2029-08-18,2029-08-20,Amazon UK,5942,Shopping,Online Retail,-14.42,GBP,-131518.69,E-Com,London,GB,9074,user_001,,
cb3a4497-afe0-4210-9cbe-aebf42883a74,2029-08-18,2029-08-20,Tesco,5411,Groceries,Supermarket,-66.74,GBP,-131585.43,POS,London,GB,2219,user_001,,
dc5e220c-4470-409b-87d0-37ecb379f6a7,2029-08-18,2029-08-20,Apple.com/bill,5734,Shopping,Electronics,-2.83,GBP,-131588.26,E-Com,Cupertino,US,2219,user_001,,
269d37fc-94d0-49ad-95ad-940a6a65ca60,2029-08-19,2029-08-20,Uber UK,4121,Transport,Ride Hailing,-14.57,GBP,-131602.83,E-Com,London,GB,1045,user_002,,
687388eb-2ee1-455d-9e3e-833ec67cfb7f,2029-08-19,2029-08-21,Apple.com/bill,5734,Shopping,Electronics,-112.74,GBP,-131715.57,E-Com,Cupertino,US,4488,user_001,,
6adb58b8-3cdb-4daf-bf3c-149760034ce0,2029-08-19,2029-08-20,British Airways,4511,Travel,Flights,-608.16,GBP,-132323.73,E-Com,London,GB,4488,user_001,,Holiday booking
841f4d47-ffd0-480e-8fed-d684f00acb3a,2029-08-19,2029-08-20,Tesco,5411,Groceries,Supermarket,-57.12,GBP,-132380.85,POS,London,GB,1045,user_002,,
cea805ae-bbc6-4fd8-88a2-51a327a391d9,2029-08-19,2029-08-21,Local Market,5499,Groceries,Specialty,-12.2,GBP,-132393.05,POS,London,GB,9074,user_002,,
95ee0222-f0a7-47a0-aa0e-e7bac9c59316,2029-08-20,2029-08-20,Spotify,5735,Entertainment,Subscriptions,-8.27,GBP,-132401.32,E-Com,Stockholm,SE,9074,user_001,rec_4c746d2c3b,
b7e44abb-fa0a-4acc-951a-39ef2cb728c2,2029-08-20,2029-08-20,Uber UK,4121,Transport,Ride Hailing,-14.1,GBP,-132415.42,E-Com,London,GB,4488,user_001,,
d75a1c5c-efef-46bb-a3be-144be63fa523,2029-08-20,2029-08-21,Local Market,5499,Groceries,Specialty,-6.5,GBP,-132421.92,POS,London,GB,1045,user_001,,
0de1e4a1-4381-4061-a13e-e16eef8a5076,2029-08-21,2029-08-21,Transport for London,4111,Transport,Transit,-10.28,GBP,-132432.2,POS,London,GB,2219,user_001,,
3e55bc72-7ed2-4864-ac86-d9baee9d0396,2029-08-21,2029-08-21,Netflix,7841,Entertainment,Subscriptions,-11.25,USD,-132443.45,E-Com,Los Gatos,US,4488,user_001,rec_1bfe33738d,FX purchase 13.96 USD @ rate 1.24
6b22dd7d-a1c1-4387-9a6d-6eb87230baf6,2029-08-21,2029-08-23,Deliveroo,5812,Food & Drink,Delivery,-31.51,GBP,-132474.96,E-Com,London,GB,2219,user_001,,
99a8a213-ed73-4683-bc90-bdaf6cc48456,2029-08-21,2029-08-21,Transport for London,4111,Transport,Transit,-7.22,GBP,-132482.18,POS,London,GB,1045,user_001,,
ff4b6383-829b-481c-9762-438697269d46,2029-08-21,2029-08-23,ATM Withdrawal,6011,Cash,ATM,-109.88,GBP,-132592.06,ATM,London,GB,2219,user_002,,
18f9adb8-a211-433e-bc2c-24f9a68f3313,2029-08-22,2029-08-23,Tesco,5411,Groceries,Supermarket,-55.24,GBP,-132647.3,POS,London,GB,1045,user_002,,
e40d2891-f6e3-4840-bdb9-930280d576de,2029-08-22,2029-08-23,Transport for London,4111,Transport,Transit,-5.82,GBP,-132653.12,POS,London,GB,4488,user_002,,
373bc2d2-17e3-43cd-89ac-028aac533a98,2029-08-23,2029-08-27,Sainsbury's,5411,Groceries,Supermarket,-67.0,GBP,-132720.12,POS,London,GB,9074,user_001,,
8cda2a85-5249-46a1-b15c-458814cfe5b0,2029-08-24,2029-08-24,Shell,5541,Transport,Fuel,-43.46,GBP,-132763.58,POS,London,GB,9074,user_001,,
e02d78a4-3a26-4bc7-8488-1cc7f5099d15,2029-08-24,2029-08-24,T212 Capital,6011,Income,Salary,3006.21,GBP,-129757.37,Credit,London,GB,4488,user_001,rec_2ff8f778d0,
b3299f04-20c5-48a0-a990-9f3db9800789,2029-08-25,2029-08-27,Sainsbury's,5411,Groceries,Supermarket,-59.29,GBP,-129816.66,POS,London,GB,9074,user_001,,
f6080f35-d987-4a16-9594-808635341a08,2029-08-25,2029-08-27,Amazon UK,5942,Shopping,Online Retail,-97.45,GBP,-129914.11,E-Com,London,GB,4488,user_001,,
0eedef25-7c46-442d-a8df-b3d6a6c08397,2029-08-26,2029-08-27,Shell,5541,Transport,Fuel,-91.04,GBP,-130005.15,POS,London,GB,1045,user_001,,
59d33d67-a504-43e9-86b3-707941e0d555,2029-08-26,2029-08-28,Waitrose,5411,Groceries,Supermarket,-79.24,GBP,-130084.39,POS,London,GB,1045,user_001,,
5fb14eae-4b9a-473f-8666-c9edb1e7c76e,2029-08-26,2029-08-27,Apple.com/bill,5734,Shopping,Electronics,-9.43,USD,-130093.82,E-Com,Cupertino,US,4488,user_001,,FX purchase 11.64 USD @ rate 1.23
d14678dc-653a-4a95-8861-422d2198d493,2029-08-26,2029-08-27,Shell,5541,Transport,Fuel,-84.8,GBP,-130178.62,POS,London,GB,9074,user_001,,
78cfc3a8-c663-4475-ad9a-1a003ad78919,2029-08-27,2029-08-27,Apple.com/bill,5734,Shopping,Electronics,-207.36,GBP,-130385.98,E-Com,Cupertino,US,4488,user_002,,
c3bd0896-a822-4837-8402-76ec5f67a914,2029-08-27,2029-08-27,Apple.com/bill,5734,Shopping,Electronics,-173.18,GBP,-130559.16,E-Com,Cupertino,US,1045,user_002,,
2d27260b-65a1-4114-b3f2-1b8abe6e1ae2,2029-08-28,2029-08-29,Pret A Manger,5814,Food & Drink,Eating Out,-6.4,GBP,-130565.56,POS,London,GB,4488,user_002,,
a062e172-6946-4708-b24c-74561f7cf575,2029-08-28,2029-08-28,Uber UK,4121,Transport,Ride Hailing,-18.49,GBP,-130584.05,E-Com,London,GB,2219,user_001,,
72ec1af8-aa77-480d-99fc-832d08c7ad90,2029-08-30,2029-08-30,Tesco,5411,Groceries,Supermarket,-37.57,GBP,-130621.62,POS,London,GB,2219,user_001,,
bd85156c-2a7d-45de-b3fa-d6f76c2d5b4c,2029-08-30,2029-08-30,Uber UK,4121,Transport,Ride Hailing,-11.35,GBP,-130632.97,E-Com,London,GB,1045,user_001,,
9132af11-22ef-4095-a395-d0a80930b63a,2029-09-01,2029-09-03,Tesco,5411,Groceries,Supermarket,-51.58,GBP,-130684.55,POS,London,GB,9074,user_001,,
eaef1290-5d71-4ce6-8ad6-5c12b81f0a80,2029-09-01,2029-09-03,Apple.com/bill,5734,Shopping,Electronics,-141.27,USD,-130825.82,E-Com,Cupertino,US,4488,user_001,,FX purchase 173.03 USD @ rate 1.22
effb8ab2-4dcd-4019-9b2d-c81cf3edba1a,2029-09-01,2029-09-03,Sainsbury's,5411,Groceries,Supermarket,-41.24,GBP,-130867.06,POS,London,GB,9074,user_001,,
1d177541-0807-4118-997e-1df3d940827a,2029-09-02,2029-09-03,Local Market,5499,Groceries,Specialty,-18.41,GBP,-130885.47,POS,London,GB,4488,user_001,,
3e381655-0832-4552-9ce6-87a770caf78a,2029-09-02,2029-09-03,Transport for London,4111,Transport,Transit,-9.16,GBP,-130894.63,POS,London,GB,9074,user_002,,
5d0a8a7e-5d4a-4776-8375-ff33830ac031,2029-09-02,2029-09-03,Pret A Manger,5814,Food & Drink,Eating Out,-9.45,GBP,-130904.08,POS,London,GB,4488,user_001,,
ef36edb5-8357-4d74-9de6-a26cdd2c9e38,2029-09-02,2029-09-03,Sainsbury's,5411,Groceries,Supermarket,-56.77,GBP,-130960.85,POS,London,GB,2219,user_001,,
19b853c4-c6d1-402a-aa00-44301e6c7415,2029-09-03,2029-09-03,Transport for London,4111,Transport,Transit,-5.32,GBP,-130966.17,POS,London,GB,9074,user_001,,
5e57ad16-f455-4883-8efe-d6669ff0fa85,2029-09-03,2029-09-04,Apple.com/bill,5734,Shopping,Electronics,-43.78,GBP,-131009.95,E-Com,Cupertino,US,4488,user_001,,
fa3f8eab-9e5b-4006-871f-926df669dc29,2029-09-03,2029-09-03,Transport for London,4111,Transport,Transit,-6.52,GBP,-131016.47,POS,London,GB,4488,user_001,,
fe7750f4-7db1-4397-a2ce-d79097a9da3b,2029-09-03,2029-09-05,Crown Estates Lettings,6513,Housing,Rent,-1602.67,GBP,-132619.14,POS,London,GB,1045,user_002,rec_fc2ae06846,
27926127-3f4e-4fac-bf43-1fb10267e378,2029-09-04,2029-09-06,Apple.com/bill,5734,Shopping,Electronics,-57.45,USD,-132676.59,E-Com,Cupertino,US,4488,user_001,,FX purchase 72.41 USD @ rate 1.26
5c1014e7-5eea-40dc-aceb-5cdfddb2d536,2029-09-05,2029-09-05,Uber UK,4121,Transport,Ride Hailing,-12.7,GBP,-132689.29,E-Com,London,GB,1045,user_001,,
ccbf4fe2-2a14-48aa-8bb2-31169be1b0b0,2029-09-05,2029-09-07,Uber UK,4121,Transport,Ride Hailing,-13.56,GBP,-132702.85,E-Com,London,GB,9074,user_001,,
23706b78-b14a-4277-9d50-1431e5d23f2d,2029-09-06,2029-09-06,Pret A Manger,5814,Food & Drink,Eating Out,-7.94,GBP,-132710.79,POS,London,GB,2219,user_001,,
444df0cc-c87f-4523-83a1-40b34be01bc1,2029-09-06,2029-09-06,Uber UK,4121,Transport,Ride Hailing,-35.09,GBP,-132745.88,E-Com,London,GB,1045,user_002,,
6fdf859d-d966-4b09-afc8-28765da5c791,2029-09-06,2029-09-07,Shell,5541,Transport,Fuel,-76.47,GBP,-132822.35,POS,London,GB,1045,user_001,,
72a4ddc1-ba68-4051-aada-55d203d130c3,2029-09-06,2029-09-07,Shell,5541,Transport,Fuel,-68.38,GBP,-132890.73,POS,London,GB,4488,user_001,,
c3fbd262-f1a7-4f7f-a99a-73244e06f960,2029-09-06,2029-09-06,Local Market,5499,Groceries,Specialty,-21.69,GBP,-132912.42,POS,London,GB,9074,user_001,,
f2d3b20b-3788-40d8-9cd7-0ce3514b4356,2029-09-06,2029-09-07,Local Market,5499,Groceries,Specialty,-14.6,GBP,-132927.02,POS,London,GB,4488,user_001,,
548bddbe-9b80-47e7-be63-512ec361f2f0,2029-09-07,2029-09-10,Octopus Energy,4900,Utilities,Electricity,-124.04,GBP,-133051.06,Direct Debit,London,GB,4488,user_002,rec_09c3f12b18,
6bdc5748-ae6e-493b-9625-eff1ad12d1e5,2029-09-07,2029-09-10,Pret A Manger,5814,Food & Drink,Eating Out,-5.76,GBP,-133056.82,POS,London,GB,4488,user_001,,
79184891-d0a0-4806-842a-51398b4e86b1,2029-09-07,2029-09-07,Sainsbury's,5411,Groceries,Supermarket,-43.87,GBP,-133100.69,POS,London,GB,4488,user_001,,
ab8cc39b-794e-4cb2-a874-7321ef3b36d6,2029-09-07,2029-09-07,Shell,5541,Transport,Fuel,-93.11,GBP,-133193.8,POS,London,GB,4488,user_001,,
18c07774-1d99-43cd-ae7d-4f939ca59f30,2029-09-08,2029-09-10,Local Market,5499,Groceries,Specialty,-10.11,GBP,-133203.91,POS,London,GB,4488,user_001,,
7d05eef1-6fa4-4393-ac3f-247aa2fe8071,2029-09-08,2029-09-10,Apple.com/bill,5734,Shopping,Electronics,-70.63,GBP,-133274.54,E-Com,Cupertino,US,1045,user_002,,
879571b0-464c-45ba-8020-dd4a08a09ce0,2029-09-08,2029-09-10,Waitrose,5411,Groceries,Supermarket,-84.37,GBP,-133358.91,POS,London,GB,2219,user_001,,
fdbd9fa3-1006-4095-b982-78fc07882b55,2029-09-08,2029-09-10,Apple.com/bill,5734,Shopping,Electronics,-144.01,USD,-133502.92,E-Com,Cupertino,US,1045,user_001,,FX purchase 181.88 USD @ rate 1.26
6462ed77-c196-43bd-bbdd-a82fe71dde01,2029-09-09,2029-09-10,Tesco,5411,Groceries,Supermarket,-46.34,GBP,-133549.26,POS,London,GB,2219,user_001,,
93205044-0517-49b6-9000-8984f4f72f73,2029-09-10,2029-09-11,Shell,5541,Transport,Fuel,-48.22,GBP,-133597.48,POS,London,GB,1045,user_001,,
35f4000d-be2c-4f0a-aaee-90a876f2df19,2029-09-11,2029-09-11,Pret A Manger,5814,Food & Drink,Eating Out,-8.74,GBP,-133606.22,POS,London,GB,4488,user_001,,
5d89a838-e26b-4932-bbb1-d7bf4828c89d,2029-09-11,2029-09-11,Amazon UK,5942,Shopping,Online Retail,-43.69,GBP,-133649.91,E-Com,London,GB,2219,user_001,,
f5a7a956-0023-4d5e-8ca3-20683d5182ac,2029-09-11,2029-09-11,Waitrose,5411,Groceries,Supermarket,-34.23,GBP,-133684.14,POS,London,GB,4488,user_001,,
f9544812-6c73-4004-b512-05a448964879,2029-09-11,2029-09-12,Thames Water,4900,Utilities,Water,-44.95,GBP,-133729.09,Direct Debit,Reading,GB,4488,user_001,rec_3a34d62842,
385d1fc2-4f4f-4f8a-bf01-11ebbeb63482,2029-09-12,2029-09-12,Sainsbury's,5411,Groceries,Supermarket,-28.94,GBP,-133758.03,POS,London,GB,4488,user_001,,
b6e4a4d1-6fb8-48c5-a97b-b94ba6b88335,2029-09-12,2029-09-14,Waitrose,5411,Groceries,Supermarket,-58.76,GBP,-133816.79,POS,London,GB,4488,user_001,,
6bd6e102-dabc-462b-9ae5-7c7eeffc5ea5,2029-09-13,2029-09-14,City Council Tax,9399,Utilities,Council Tax,-170.05,GBP,-133986.84,Direct Debit,London,GB,4488,user_001,rec_f531495db5,
a0f4d09c-338f-4ad8-a269-022c2f471905,2029-09-13,2029-09-14,Sainsbury's,5411,Groceries,Supermarket,-67.39,GBP,-134054.23,POS,London,GB,9074,user_001,,
c4b9e9a9-7710-4435-969e-81f4e89842b7,2029-09-13,2029-09-13,Deliveroo,5812,Food & Drink,Delivery,-22.11,GBP,-134076.34,E-Com,London,GB,1045,user_001,,
9a319ec3-ee45-466e-b6d7-5c875461bc66,2029-09-14,2029-09-14,Sainsbury's,5411,Groceries,Supermarket,-46.21,GBP,-134122.55,POS,London,GB,9074,user_001,,
f05ef5dc-dddf-4cbb-9677-e20356f85623,2029-09-14,2029-09-17,Local Market,5499,Groceries,Specialty,-9.37,GBP,-134131.92,POS,London,GB,9074,user_001,,
7b8421f3-addb-4866-b2c6-506ac9c6a406,2029-09-15,2029-09-17,Local Market,5499,Groceries,Specialty,-10.79,GBP,-134142.71,POS,London,GB,1045,user_001,,
baf20352-c011-43d1-9acf-57efa6527ac7,2029-09-15,2029-09-17,ATM Withdrawal,6011,Cash,ATM,-99.39,GBP,-134242.1,ATM,London,GB,1045,user_001,,
e62d294a-ba03-4e5e-83d2-4448516bc8dc,2029-09-15,2029-09-17,Transport for London,4111,Transport,Transit,-7.16,GBP,-134249.26,POS,London,GB,2219,user_001,,
ea5f4488-5812-49a1-adae-bc669ba6ef70,2029-09-15,2029-09-17,Transport for London,4111,Transport,Transit,-5.55,GBP,-134254.81,POS,London,GB,1045,user_001,,
353ae1ee-8672-4923-acbd-500d583da87f,2029-09-16,2029-09-18,Pret A Manger,5814,Food & Drink,Eating Out,-6.94,GBP,-134261.75,POS,London,GB,9074,user_002,,
424e0d77-9877-4b52-8d75-4e5ea9d00c4d,2029-09-16,2029-09-17,Amazon UK,5942,Shopping,Online Retail,-116.97,GBP,-134378.72,E-Com,London,GB,1045,user_002,,
8f6814df-558c-4dcb-89ab-79c282fd5dba,2029-09-16,2029-09-18,Pret A Manger,5814,Food & Drink,Eating Out,-5.98,GBP,-134384.7,POS,London,GB,2219,user_001,,
b1f05b78-41ad-4a58-8c26-9623056d68b1,2029-09-16,2029-09-17,Waitrose,5411,Groceries,Supermarket,-32.92,GBP,-134417.62,POS,London,GB,1045,user_001,,
e1a69162-7134-4ec9-811c-9c52bd67cc9d,2029-09-16,2029-09-17,Shell,5541,Transport,Fuel,-31.91,GBP,-134449.53,POS,London,GB,4488,user_001,,
f0e91900-02e4-4435-9930-ea2e1a1d281d,2029-09-16,2029-09-17,Pret A Manger,5814,Food & Drink,Eating Out,-11.68,GBP,-134461.21,POS,London,GB,1045,user_001,,
0a7c06ac-00cf-4c24-a565-a7203232aa14,2029-09-17,2029-09-19,Pret A Manger,5814,Food & Drink,Eating Out,-6.85,GBP,-134468.06,POS,London,GB,4488,user_001,,
0b948284-94dc-4c97-9e6a-ae2168f0ad6b,2029-09-17,2029-09-19,ATM Withdrawal,6011,Cash,ATM,-82.24,GBP,-134550.3,ATM,London,GB,4488,user_001,,
15a2f57b-5584-41fc-a5cc-f7386cf7d1c5,2029-09-17,2029-09-17,GymBox,7997,Wellness,Gym,-55.0,GBP,-134605.3,Direct Debit,London,GB,4488,user_002,rec_19771e79cd,
4c70437e-4844-4c0f-bbf2-e4696bb40af5,2029-09-17,2029-09-18,O2 UK,4814,Bills,Mobile,-50.54,GBP,-134655.84,Direct Debit,Slough,GB,1045,user_001,rec_95042d8101,
6d2d6715-9574-4a4d-a13b-0faec0b3a6cc,2029-09-17,2029-09-18,Local Market,5499,Groceries,Specialty,-14.52,GBP,-134670.36,POS,London,GB,2219,user_002,,
3411ac27-e6c4-4504-a9e3-75f1d556ec93,2029-09-18,2029-09-18,Local Market,5499,Groceries,Specialty,-10.43,GBP,-134680.79,POS,London,GB,9074,user_001,,
76a0efde-9059-4395-91d0-7bd1298a1033,2029-09-18,2029-09-18,Apple.com/bill,5734,Shopping,Electronics,-43.4,GBP,-134724.19,E-Com,Cupertino,US,1045,user_001,,
b0ae898f-07a6-499a-bb59-b0ecae02df96,2029-09-18,2029-09-20,Apple.com/bill,5734,Shopping,Electronics,-125.1,GBP,-134849.29,E-Com,Cupertino,US,9074,user_001,,
6120b122-b83f-43fe-979b-c0c6b681746e,2029-09-19,2029-09-21,Tesco,5411,Groceries,Supermarket,-82.2,GBP,-134931.49,POS,London,GB,4488,user_001,,
d0f8ab8f-0220-4816-9c07-0cdd68d74639,2029-09-19,2029-09-20,Spotify,5735,Entertainment,Subscriptions,-8.01,EUR,-134939.5,E-Com,Stockholm,SE,4488,user_001,rec_4c746d2c3b,FX purchase 8.93 EUR @ rate 1.11
9d085f48-8e24-4c42-acef-88929cd53eb8,2029-09-20,2029-09-24,Waitrose,5411,Groceries,Supermarket,-32.65,GBP,-134972.15,POS,London,GB,9074,user_001,,
cfe42675-1346-4cfb-bd59-4c543e039718,2029-09-20,2029-09-21,Deliveroo,5812,Food & Drink,Delivery,-12.73,GBP,-134984.88,E-Com,London,GB,1045,user_001,,
49937c62-41c5-411c-8fd4-dba419c377b3,2029-09-21,2029-09-21,Airline Refund,4511,Travel,Refund,31.85,GBP,-134953.03,Credit,London,GB,2219,user_001,,Refund for Apple.com/bill
4ddc4249-7de6-4800-8c2d-0a93d97b6666,2029-09-21,2029-09-24,Local Market,5499,Groceries,Specialty,-13.64,GBP,-134966.67,POS,London,GB,2219,user_001,,
5dcd13a2-84cc-47ee-88d2-027b00ad0d24,2029-09-21,2029-09-21,Tesco,5411,Groceries,Supermarket,-26.69,GBP,-134993.36,POS,London,GB,2219,user_001,,
e74c5221-95f3-47ef-9a19-59274dd17498,2029-09-21,2029-09-24,Netflix,7841,Entertainment,Subscriptions,-15.0,GBP,-135008.36,E-Com,Los Gatos,US,1045,user_001,rec_1bfe33738d,
560a252a-a088-4d95-a0d0-867fc3fef612,2029-09-22,2029-09-24,Pret A Manger,5814,Food & Drink,Eating Out,-10.25,GBP,-135018.61,POS,London,GB,4488,user_001,,
5d9d6e33-ab1a-4c62-8c0f-2a2fd85f6187,2029-09-22,2029-09-24,Shell,5541,Transport,Fuel,-72.11,GBP,-135090.72,POS,London,GB,4488,user_002,,
90cc4814-1bd5-4cb8-a213-8107d3721dd3,2029-09-22,2029-09-24,Waitrose,5411,Groceries,Supermarket,-55.54,GBP,-135146.26,POS,London,GB,4488,user_001,,
ce88ff5b-0b30-40e7-985f-f03a143a811d,2029-09-22,2029-09-24,Transport for London,4111,Transport,Transit,-6.16,GBP,-135152.42,POS,London,GB,4488,user_001,,
1af73bae-8ad8-4ad7-ad29-46bc59eec602,2029-09-23,2029-09-24,Transport for London,4111,Transport,Transit,-4.78,GBP,-135157.2,POS,London,GB,4488,user_002,,
258fdc99-ad74-4083-be83-e8e79150c483,2029-09-24,2029-09-24,Local Market,5499,Groceries,Specialty,-6.36,GBP,-135163.56,POS,London,GB,2219,user_001,,
27cba896-29d1-4467-b4da-01c499b0c5da,2029-09-24,2029-09-26,Shell,5541,Transport,Fuel,-72.96,GBP,-135236.52,POS,London,GB,1045,user_001,,
a5dcfc69-bf0b-4699-84f1-f67ac4dc7fa9,2029-09-24,2029-09-24,Pret A Manger,5814,Food & Drink,Eating Out,-10.74,GBP,-135247.26,POS,London,GB,2219,user_001,,
539ec60d-7383-4be8-a887-95fe77751d1a,2029-09-25,2029-09-25,ATM Withdrawal,6011,Cash,ATM,-92.19,GBP,-135339.45,ATM,London,GB,1045,user_001,,
f6f70037-3d3c-45f1-9523-21ee6a09855d,2029-09-25,2029-09-25,T212 Capital,6011,Income,Salary,2875.59,GBP,-132463.86,Credit,London,GB,1045,user_001,rec_2ff8f778d0,
32491e24-7668-442e-bd39-f967fc995e98,2029-09-26,2029-09-26,Deliveroo,5812,Food & Drink,Delivery,-24.1,GBP,-132487.96,E-Com,London,GB,9074,user_001,,
7b77f9bc-b480-443f-808d-496c69c757b0,2029-09-26,2029-09-27,Sainsbury's,5411,Groceries,Supermarket,-46.22,GBP,-132534.18,POS,London,GB,9074,user_002,,
9dab6f46-d496-45b7-b023-3a640a39bc25,2029-09-26,2029-09-26,Pret A Manger,5814,Food & Drink,Eating Out,-11.44,GBP,-132545.62,POS,London,GB,2219,user_002,,
7fdd8d6e-6e9c-4a45-a673-53676196f035,2029-09-27,2029-09-28,Local Market,5499,Groceries,Specialty,-11.17,GBP,-132556.79,POS,London,GB,9074,user_002,,
ca4b5bfe-31ef-41a7-9315-4c7c063756f8,2029-09-27,2029-09-27,HM Revenue & Customs,9311,Income,Tax Refund,23.63,GBP,-132533.16,Credit,London,GB,1045,user_001,,Refund for Tesco
13fe553a-7ce0-459a-8ab9-f5a03ce70a22,2029-09-28,2029-10-01,Amazon UK,5942,Shopping,Online Retail,-45.45,GBP,-132578.61,E-Com,London,GB,9074,user_002,,
50d51fef-8c93-4c71-a809-5c4419873f27,2029-09-28,2029-09-28,Transport for London,4111,Transport,Transit,-10.75,GBP,-132589.36,POS,London,GB,1045,user_001,,
a91d601d-4328-4cf8-bc2d-345760bbe3ba,2029-09-28,2029-10-01,Waitrose,5411,Groceries,Supermarket,-46.21,GBP,-132635.57,POS,London,GB,1045,user_001,,
92d7a03c-8d21-4580-82d0-6add3b504356,2029-09-29,2029-10-01,Pret A Manger,5814,Food & Drink,Eating Out,-11.13,GBP,-132646.7,POS,London,GB,2219,user_001,,
fd5c613e-e390-43b4-b050-5a65dbc0e704,2029-09-29,2029-10-01,Pret A Manger,5814,Food & Drink,Eating Out,-10.31,GBP,-132657.01,POS,London,GB,2219,user_001,,
067f8a46-e00d-4651-b0dc-5439b8c16f2f,2029-09-30,2029-10-02,Sainsbury's,5411,Groceries,Supermarket,-41.77,GBP,-132698.78,POS,London,GB,4488,user_002,,
70317c76-90ea-4583-ba83-38f605206566,2029-09-30,2029-10-01,Waitrose,5411,Groceries,Supermarket,-24.39,GBP,-132723.17,POS,London,GB,1045,user_001,,
806b3a11-f76a-40ff-945c-ea86ee01e931,2029-09-30,2029-10-02,Sainsbury's,5411,Groceries,Supermarket,-58.67,GBP,-132781.84,POS,London,GB,9074,user_001,,
be125ffb-1ac9-4849-9a36-87828323acd9,2029-09-30,2029-10-01,Transport for London,4111,Transport,Transit,-10.12,GBP,-132791.96,POS,London,GB,4488,user_001,,
9fb9da7e-d7b6-46ff-84f2-56e46edc9f02,2029-10-01,2029-10-03,Crown Estates Lettings,6513,Housing,Rent,-1604.51,GBP,-134396.47,POS,London,GB,1045,user_001,rec_19f70fbcce,
b3fa8193-7af1-4a8f-8be6-843c9e87f594,2029-10-01,2029-10-02,Waitrose,5411,Groceries,Supermarket,-76.56,GBP,-134473.03,POS,London,GB,2219,user_001,,
6e65a35d-b3e8-4df6-9661-4d205527c302,2029-10-02,2029-10-04,Shell,5541,Transport,Fuel,-91.0,GBP,-134564.03,POS,London,GB,9074,user_001,,
20dea10c-9e0a-46da-a7c7-deab5e1842b1,2029-10-03,2029-10-04,Tesco,5411,Groceries,Supermarket,-67.24,GBP,-134631.27,POS,London,GB,2219,user_002,,
9f55bda3-f414-42e9-b7ef-8879468d5e28,2029-10-04,2029-10-08,Transport for London,4111,Transport,Transit,-4.97,GBP,-134636.24,POS,London,GB,4488,user_001,,
b9dd1878-bccf-49b8-85a1-b959006d7a26,2029-10-04,2029-10-05,Uber UK,4121,Transport,Ride Hailing,-9.3,GBP,-134645.54,E-Com,London,GB,1045,user_002,,
59c6aae3-c45f-4b2b-abd2-b0a459155137,2029-10-05,2029-10-08,Apple.com/bill,5734,Shopping,Electronics,-56.29,GBP,-134701.83,E-Com,Cupertino,US,2219,user_001,,
5f4c48ae-be2e-4a08-87fc-58dc2676e5a4,2029-10-06,2029-10-08,Pret A Manger,5814,Food & Drink,Eating Out,-9.11,GBP,-134710.94,POS,London,GB,4488,user_001,,
9a166a91-e0aa-480e-a93f-62a12b592d7b,2029-10-06,2029-10-08,Apple.com/bill,5734,Shopping,Electronics,-190.87,GBP,-134901.81,E-Com,Cupertino,US,4488,user_001,,
0de9b6fb-8e8d-427a-81cd-44eadc3c02f7,2029-10-07,2029-10-09,Transport for London,4111,Transport,Transit,-4.41,GBP,-134906.22,POS,London,GB,4488,user_002,,
77f7f60c-5ca3-4f3c-9336-02c9740a7cc1,2029-10-07,2029-10-08,Local Market,5499,Groceries,Specialty,-20.88,GBP,-134927.1,POS,London,GB,9074,user_001,,
9754f940-1e87-466f-b8d8-dc7b5ede8dcb,2029-10-07,2029-10-08,Local Market,5499,Groceries,Specialty,-7.7,GBP,-134934.8,POS,London,GB,4488,user_001,,
a471d992-8dcc-420e-84b6-03e7b790fb6a,2029-10-07,2029-10-08,Apple.com/bill,5734,Shopping,Electronics,-13.68,GBP,-134948.48,E-Com,Cupertino,US,4488,user_001,,
c10f9c77-06e6-4272-9cdb-03ba0db8ad03,2029-10-07,2029-10-08,Pret A Manger,5814,Food & Drink,Eating Out,-9.65,GBP,-134958.13,POS,London,GB,4488,user_001,,
ce84d346-03c3-48e7-af4d-5d53afa45eca,2029-10-07,2029-10-08,Pret A Manger,5814,Food & Drink,Eating Out,-11.66,GBP,-134969.79,POS,London,GB,4488,user_001,,
0e32051f-5a7a-460d-8fdd-2bb2dfea602f,2029-10-08,2029-10-08,Amazon UK,5942,Shopping,Online Retail,-108.26,GBP,-135078.05,E-Com,London,GB,1045,user_001,,
2bb321f6-b752-4148-944f-bddac5e1551f,2029-10-08,2029-10-08,Uber UK,4121,Transport,Ride Hailing,-20.83,GBP,-135098.88,E-Com,London,GB,1045,user_001,,
d435c3b7-3280-404c-8218-7a0004dbaa00,2029-10-08,2029-10-10,Octopus Energy,4900,Utilities,Electricity,-139.94,GBP,-135238.82,Direct Debit,London,GB,1045,user_002,rec_09c3f12b18,
fb3ad836-0303-4199-baed-6f27be37e08f,2029-10-09,2029-10-09,Uber UK,4121,Transport,Ride Hailing,-16.57,GBP,-135255.39,E-Com,London,GB,1045,user_002,,
19ac93ce-c40b-43dd-b255-ab8a25cf51a4,2029-10-10,2029-10-12,Tesco,5411,Groceries,Supermarket,-84.15,GBP,-135339.54,POS,London,GB,4488,user_002,,
295533f5-530c-467e-8037-a044c710a1af,2029-10-10,2029-10-12,Tesco,5411,Groceries,Supermarket,-70.61,GBP,-135410.15,POS,London,GB,4488,user_001,,
81f924d2-131b-4fd5-b98e-ce36b8807d0d,2029-10-10,2029-10-12,Sainsbury's,5411,Groceries,Supermarket,-27.76,GBP,-135437.91,POS,London,GB,2219,user_001,,
a13de550-4892-47be-b944-40651d31794f,2029-10-10,2029-10-12,Local Market,5499,Groceries,Specialty,-8.66,GBP,-135446.57,POS,London,GB,4488,user_001,,
2ddb3285-4f6a-458d-8f04-4e740931bd0d,2029-10-11,2029-10-11,Thames Water,4900,Utilities,Water,-33.17,GBP,-135479.74,Direct Debit,Reading,GB,4488,user_001,rec_3a34d62842,
f65b09c8-10c0-499a-8182-6066e1e1a5be,2029-10-11,2029-10-15,Tesco,5411,Groceries,Supermarket,-79.11,GBP,-135558.85,POS,London,GB,4488,user_001,,
5178621f-75ef-4ed6-9f18-8d04d94e1ff6,2029-10-13,2029-10-15,Apple.com/bill,5734,Shopping,Electronics,-194.52,GBP,-135753.37,E-Com,Cupertino,US,1045,user_002,,
d9ccd5f4-24ca-4748-ba34-b0b1d5dbb0bb,2029-10-13,2029-10-15,Shell,5541,Transport,Fuel,-69.59,GBP,-135822.96,POS,London,GB,4488,user_002,,
2e9e6d55-0283-4613-8c65-c03410cddad4,2029-10-14,2029-10-16,Tesco,5411,Groceries,Supermarket,-50.41,GBP,-135873.37,POS,London,GB,1045,user_001,,
5f513d38-eaa1-483a-86ae-54276e8e1e2e,2029-10-14,2029-10-15,Airline Refund,4511,Travel,Refund,30.22,GBP,-135843.15,Credit,London,GB,4488,user_002,,Refund for Tesco
6fa09f41-eb21-405d-8ded-d9bc09d1d125,2029-10-15,2029-10-16,O2 UK,4814,Bills,Mobile,-53.73,GBP,-135896.88,Direct Debit,Slough,GB,4488,user_002,rec_d2dce4c42f,
f99a6e1b-9be6-4bb2-893f-481901b74682,2029-10-15,2029-10-16,City Council Tax,9399,Utilities,Council Tax,-178.33,GBP,-136075.21,Direct Debit,London,GB,1045,user_001,rec_f531495db5,
46e83d11-115a-4d6e-8ef2-14f33e1e796d,2029-10-16,2029-10-17,Sainsbury's,5411,Groceries,Supermarket,-15.7,GBP,-136090.91,POS,London,GB,9074,user_002,,
8300d5d6-5b2e-4535-9b50-07d932e7892b,2029-10-16,2029-10-17,Sainsbury's,5411,Groceries,Supermarket,-47.14,GBP,-136138.05,POS,London,GB,4488,user_001,,
90fb8d25-f3c6-4fbd-8f03-bf5a82a7ef98,2029-10-16,2029-10-16,Airline Refund,4511,Travel,Refund,22.85,GBP,-136115.2,Credit,London,GB,4488,user_001,,Refund for Deliveroo
0b48ef1f-784d-45b8-8f5b-1016eb25e1a4,2029-10-17,2029-10-18,Pret A Manger,5814,Food & Drink,Eating Out,-6.08,GBP,-136121.28,POS,London,GB,2219,user_002,,
866511f2-9a61-4102-a5bc-41649bb59ad7,2029-10-17,2029-10-18,GymBox,7997,Wellness,Gym,-46.28,GBP,-136167.56,Direct Debit,London,GB,4488,user_001,rec_3906953fd2,
e3bf6539-d2cc-4153-927c-32be5e328240,2029-10-17,2029-10-19,Shell,5541,Transport,Fuel,-51.73,GBP,-136219.29,POS,London,GB,2219,user_002,,
492f9e13-9760-4fd2-8ae5-3d0181bc021f,2029-10-18,2029-10-18,Airline Refund,4511,Travel,Refund,5.07,GBP,-136214.22,Credit,London,GB,9074,user_002,,Refund for Uber UK
a892eeb0-7b19-4a85-81ac-8dfb124ce1ac,2029-10-18,2029-10-18,Amazon UK,5942,Shopping,Online Retail,-47.74,GBP,-136261.96,E-Com,London,GB,9074,user_002,,
b1c12a14-8dc1-4e06-9f22-42035c655bfb,2029-10-18,2029-10-19,Apple.com/bill,5734,Shopping,Electronics,-57.32,GBP,-136319.28,E-Com,Cupertino,US,2219,user_001,,
ca7a4bd3-4a8a-4ba5-98fc-580d8ab505da,2029-10-18,2029-10-19,Amazon UK,5942,Shopping,Online Retail,-102.21,GBP,-136421.49,E-Com,London,GB,1045,user_001,,
fbd632e6-d442-40a1-9544-766fcf6d34fe,2029-10-18,2029-10-19,Amazon UK,5942,Shopping,Online Retail,-109.41,GBP,-136530.9,E-Com,London,GB,2219,user_001,,
4da0bc45-0654-4574-8c93-135e27ad6229,2029-10-19,2029-10-22,Shell,5541,Transport,Fuel,-64.24,GBP,-136595.14,POS,London,GB,9074,user_001,,
b2ba04d2-6826-4031-be87-f177787e7215,2029-10-19,2029-10-19,Transport for London,4111,Transport,Transit,-11.38,GBP,-136606.52,POS,London,GB,9074,user_001,,
da23e9d2-b7e4-4ab3-9be9-a05d7c994c87,2029-10-19,2029-10-19,Spotify,5735,Entertainment,Subscriptions,-8.23,GBP,-136614.75,E-Com,Stockholm,SE,9074,user_001,rec_4c746d2c3b,
05e065ef-f630-4018-82ab-9aa9eb884e6b,2029-10-20,2029-10-22,Waitrose,5411,Groceries,Supermarket,-63.79,GBP,-136678.54,POS,London,GB,2219,user_002,,
062642da-1eea-4de2-aa18-b7079ad4dfe5,2029-10-20,2029-10-22,Amazon UK,5942,Shopping,Online Retail,-10.25,GBP,-136688.79,E-Com,London,GB,2219,user_001,,
1c09d428-a722-40ec-a85d-f8500cddf28b,2029-10-20,2029-10-22,Sainsbury's,5411,Groceries,Supermarket,-29.54,GBP,-136718.33,POS,London,GB,2219,user_001,,
fb558c2a-bbf6-492e-bd95-d828ba167898,2029-10-20,2029-10-22,Sainsbury's,5411,Groceries,Supermarket,-40.27,GBP,-136758.6,POS,London,GB,9074,user_002,,
a939bfda-a890-4eed-a915-ca570ee6fa24,2029-10-21,2029-10-23,Tesco,5411,Groceries,Supermarket,-74.08,GBP,-136832.68,POS,London,GB,4488,user_001,,
e40074ec-faea-44a2-900f-6c1370744ca3,2029-10-21,2029-10-22,Shell,5541,Transport,Fuel,-42.72,GBP,-136875.4,POS,London,GB,1045,user_001,,
52889666-b7f6-4d97-81d2-7ea5a1ff9f21,2029-10-22,2029-10-22,Tesco,5411,Groceries,Supermarket,-65.0,GBP,-136940.4,POS,London,GB,1045,user_001,,
a49dbd1f-e232-4869-a5f1-0c354bbb31cb,2029-10-22,2029-10-23,Sainsbury's,5411,Groceries,Supermarket,-67.52,GBP,-137007.92,POS,London,GB,1045,user_001,,
aa30261e-d233-4781-8050-d21b7a67d790,2029-10-22,2029-10-24,Uber UK,4121,Transport,Ride Hailing,-31.14,GBP,-137039.06,E-Com,London,GB,1045,user_001,,
b237bb7a-58a2-44ef-a940-c8c53cb4280c,2029-10-22,2029-10-23,Netflix,7841,Entertainment,Subscriptions,-14.41,GBP,-137053.47,E-Com,Los Gatos,US,2219,user_001,rec_1bfe33738d,
23447570-7bc2-4b11-b592-6bd89ce4f5a7,2029-10-23,2029-10-23,Waitrose,5411,Groceries,Supermarket,-64.28,GBP,-137117.75,POS,London,GB,4488,user_001,,
490d0bd5-d480-49c0-bf1f-01e32cec92a4,2029-10-23,2029-10-24,Pret A Manger,5814,Food & Drink,Eating Out,-10.11,GBP,-137127.86,POS,London,GB,2219,user_001,,
5dba5652-78ed-4bb6-ab9b-56f652ecf023,2029-10-23,2029-10-25,Pret A Manger,5814,Food & Drink,Eating Out,-7.04,GBP,-137134.9,POS,London,GB,1045,user_002,,
5e9cc5b4-6b1f-4f08-aee1-31082725f39d,2029-10-23,2029-10-23,Pret A Manger,5814,Food & Drink,Eating Out,-7.29,GBP,-137142.19,POS,London,GB,1045,user_001,,
1c7273a2-3225-4a5e-8e03-7b893e7cb8a9,2029-10-24,2029-10-25,Waitrose,5411,Groceries,Supermarket,-25.01,GBP,-137167.2,POS,London,GB,2219,user_001,,
250223af-c1c5-4b62-9386-173895779481,2029-10-24,2029-10-26,Sainsbury's,5411,Groceries,Supermarket,-16.06,GBP,-137183.26,POS,London,GB,9074,user_002,,
baeceb12-f770-4d11-bb4f-cd7de1cb405b,2029-10-24,2029-10-24,Pret A Manger,5814,Food & Drink,Eating Out,-6.65,GBP,-137189.91,POS,London,GB,2219,user_001,,
3e45990f-adec-4b46-9307-3293b9db6bff,2029-10-25,2029-10-29,Sainsbury's,5411,Groceries,Supermarket,-28.03,GBP,-137217.94,POS,London,GB,9074,user_002,,
c02aa76c-3e69-484f-a3ea-705a0c5b8a23,2029-10-25,2029-10-25,T212 Capital,6011,Income,Salary,3163.34,GBP,-134054.6,Credit,London,GB,9074,user_001,rec_2ff8f778d0,
7c5ee779-ff84-491d-8866-7460e11d67a8,2029-10-26,2029-10-29,Sainsbury's,5411,Groceries,Supermarket,-26.08,GBP,-134080.68,POS,London,GB,9074,user_002,,
84192115-e598-4693-8831-8ece6a632567,2029-10-26,2029-10-29,Waitrose,5411,Groceries,Supermarket,-64.71,GBP,-134145.39,POS,London,GB,9074,user_002,,
091f1163-2034-4b7e-ab40-8b7e76197991,2029-10-27,2029-10-29,Tesco,5411,Groceries,Supermarket,-67.89,GBP,-134213.28,POS,London,GB,2219,user_001,,
277f2f8b-2e90-4cd2-b594-8dd7ddd7f50a,2029-10-27,2029-10-29,Tesco,5411,Groceries,Supermarket,-74.1,GBP,-134287.38,POS,London,GB,2219,user_001,,
5bec208e-d0d5-4d54-8537-4a29e11f9c3a,2029-10-27,2029-10-29,Tesco,5411,Groceries,Supermarket,-53.48,GBP,-134340.86,POS,London,GB,9074,user_001,,
6502d3d8-2338-4c47-8e20-0e51f3edc54f,2029-10-27,2029-10-29,Tesco,5411,Groceries,Supermarket,-54.71,GBP,-134395.57,POS,London,GB,4488,user_002,,
c26c00c1-8ea7-4ef4-9ac1-8d56bff9c364,2029-10-27,2029-10-29,Uber UK,4121,Transport,Ride Hailing,-16.85,GBP,-134412.42,E-Com,London,GB,9074,user_001,,
10bb2422-7e39-4a70-8141-0be249291639,2029-10-28,2029-10-29,Uber UK,4121,Transport,Ride Hailing,-34.73,GBP,-134447.15,E-Com,London,GB,4488,user_001,,
b243b151-53ea-46b2-8581-45e30c6d529e,2029-10-28,2029-10-29,Sainsbury's,5411,Groceries,Supermarket,-41.35,GBP,-134488.5,POS,London,GB,4488,user_001,,
bae1d087-543e-4005-af92-a48cc9443c19,2029-10-29,2029-10-29,Apple.com/bill,5734,Shopping,Electronics,-31.39,GBP,-134519.89,E-Com,Cupertino,US,2219,user_001,,
bb9e05ad-de99-451e-be15-632d60bb98b8,2029-10-29,2029-10-31,Deliveroo,5812,Food & Drink,Delivery,-12.7,GBP,-134532.59,E-Com,London,GB,9074,user_001,,
16572f86-5d07-4b26-a605-53ab7d7e2ae7,2029-10-30,2029-10-31,Pret A Manger,5814,Food & Drink,Eating Out,-8.19,GBP,-134540.78,POS,London,GB,1045,user_001,,
691ca377-49fb-4d9f-9ec4-2147db8611cf,2029-10-30,2029-11-01,Local Market,5499,Groceries,Specialty,-14.98,GBP,-134555.76,POS,London,GB,9074,user_002,,
945c5c97-1560-4dee-b16a-97e0abe1b4ef,2029-10-30,2029-11-01,Uber UK,4121,Transport,Ride Hailing,-17.39,GBP,-134573.15,E-Com,London,GB,2219,user_001,,
51581102-3b9f-4e40-a6dd-46013851f11b,2029-10-31,2029-10-31,Tesco,5411,Groceries,Supermarket,-29.01,GBP,-134602.16,POS,London,GB,4488,user_001,,
1002739e-4fc2-41ad-90dc-85c7b592f7b3,2029-11-01,2029-11-05,Pret A Manger,5814,Food & Drink,Eating Out,-8.06,GBP,-134610.22,POS,London,GB,1045,user_001,,
64c89ae7-0fe4-484d-b402-27dd55610038,2029-11-01,2029-11-02,Waitrose,5411,Groceries,Supermarket,-45.91,GBP,-134656.13,POS,London,GB,2219,user_002,,
adb11034-9a66-4afc-80b5-5c73d7204c46,2029-11-01,2029-11-01,Crown Estates Lettings,6513,Housing,Rent,-1629.44,GBP,-136285.57,POS,London,GB,9074,user_001,rec_19f70fbcce,
bb228b6d-e6d7-4f5a-ba51-6967f7208be5,2029-11-01,2029-11-05,Tesco,5411,Groceries,Supermarket,-43.09,GBP,-136328.66,POS,London,GB,1045,user_001,,
c2dbb92b-cd0e-4f2a-a0ee-f022534fe97e,2029-11-01,2029-11-05,Shell,5541,Transport,Fuel,-85.83,GBP,-136414.49,POS,London,GB,2219,user_001,,
402c77e2-1bc2-4f34-8761-cebae9403ac8,2029-11-02,2029-11-02,Deliveroo,5812,Food & Drink,Delivery,-28.14,GBP,-136442.63,E-Com,London,GB,1045,user_001,,
19f391b5-7f77-4d1a-85f1-86a002c580ed,2029-11-03,2029-11-05,Local Market,5499,Groceries,Specialty,-8.01,GBP,-136450.64,POS,London,GB,2219,user_001,,
791179f6-386d-42ce-ae49-d509866ebbcd,2029-11-03,2029-11-05,Apple.com/bill,5734,Shopping,Electronics,-74.58,USD,-136525.22,E-Com,Cupertino,US,2219,user_001,,FX purchase 93.97 USD @ rate 1.26
3d440117-9ea1-46e1-9637-96cd0497d377,2029-11-04,2029-11-06,Shell,5541,Transport,Fuel,-88.81,GBP,-136614.03,POS,London,GB,9074,user_001,,
5ee5f672-5a61-48f3-8b56-4197e0059999,2029-11-04,2029-11-05,Tesco,5411,Groceries,Supermarket,-69.86,GBP,-136683.89,POS,London,GB,2219,user_001,,
6fdd296a-5919-45d8-ac75-ce434514602e,2029-11-04,2029-11-05,Shell,5541,Transport,Fuel,-51.06,GBP,-136734.95,POS,London,GB,2219,user_001,,
e0c42a1a-7a1f-4b1e-8369-d01b4dd99de3,2029-11-04,2029-11-05,Shell,5541,Transport,Fuel,-83.6,GBP,-136818.55,POS,London,GB,9074,user_001,,
e0ede42f-30ed-465b-968e-b18245a9988c,2029-11-04,2029-11-05,Transport for London,4111,Transport,Transit,-8.22,GBP,-136826.77,POS,London,GB,9074,user_001,,
b5b3be20-c331-48db-9ab2-13d561e71365,2029-11-05,2029-11-06,Shell,5541,Transport,Fuel,-90.75,GBP,-136917.52,POS,London,GB,4488,user_001,,
c5af6872-5a8a-45a7-b1b0-b962ca1091d8,2029-11-05,2029-11-06,Sainsbury's,5411,Groceries,Supermarket,-35.87,GBP,-136953.39,POS,London,GB,4488,user_001,,
c6c92035-9639-4ce7-8821-c175b31dead5,2029-11-05,2029-11-06,Shell,5541,Transport,Fuel,-92.26,GBP,-137045.65,POS,London,GB,4488,user_001,,
ab5f3c7b-b5df-4708-ad1b-7fac07937932,2029-11-06,2029-11-07,Apple.com/bill,5734,Shopping,Electronics,-25.64,GBP,-137071.29,E-Com,Cupertino,US,4488,user_001,,
f0d1e69c-e97f-4513-9b60-029e764db96e,2029-11-06,2029-11-08,Transport for London,4111,Transport,Transit,-9.92,GBP,-137081.21,POS,London,GB,1045,user_001,,
8582f2e9-81a4-4b06-ad2e-78874eee0e87,2029-11-07,2029-11-08,Octopus Energy,4900,Utilities,Electricity,-133.89,GBP,-137215.1,Direct Debit,London,GB,2219,user_001,rec_141a4a0666,
f4ed57e7-a8db-443d-949d-481acd6f8c49,2029-11-07,2029-11-07,Local Market,5499,Groceries,Specialty,-8.52,GBP,-137223.62,POS,London,GB,9074,user_001,,
031d377f-d743-46f6-8748-69f3bd9e8968,2029-11-08,2029-11-08,Apple.com/bill,5734,Shopping,Electronics,-44.49,GBP,-137268.11,E-Com,Cupertino,US,9074,user_001,,
0f64f321-7ceb-4b0f-b7a2-af4231f1bccb,2029-11-08,2029-11-12,Local Market,5499,Groceries,Specialty,-7.21,GBP,-137275.32,POS,London,GB,1045,user_001,,
5f2b6bd6-71db-43ef-a7f4-1b6016a670c0,2029-11-08,2029-11-12,ATM Withdrawal,6011,Cash,ATM,-114.42,GBP,-137389.74,ATM,London,GB,2219,user_001,,
9b96063e-0111-4d50-993c-454b690fe21e,2029-11-08,2029-11-09,Sainsbury's,5411,Groceries,Supermarket,-28.55,GBP,-137418.29,POS,London,GB,1045,user_001,,
4e53a0a6-e000-474c-8e15-fc4bc5e6d1b2,2029-11-09,2029-11-12,ATM Withdrawal,6011,Cash,ATM,-66.62,GBP,-137484.91,ATM,London,GB,4488,user_001,,
654b44f6-3d78-4c20-8c6a-b0172ff76eaf,2029-11-09,2029-11-12,Deliveroo,5812,Food & Drink,Delivery,-25.38,GBP,-137510.29,E-Com,London,GB,9074,user_001,,
97b6ceef-13d2-4c34-9abb-e725f18df8c6,2029-11-10,2029-11-12,Tesco,5411,Groceries,Supermarket,-62.95,GBP,-137573.24,POS,London,GB,4488,user_001,,
d95d7757-e9fd-47eb-90f6-c94566179a5b,2029-11-10,2029-11-12,Apple.com/bill,5734,Shopping,Electronics,-70.68,GBP,-137643.92,E-Com,Cupertino,US,2219,user_001,,
e57b348d-32ed-4578-a143-ed2125a110c6,2029-11-10,2029-11-12,Waitrose,5411,Groceries,Supermarket,-24.38,GBP,-137668.3,POS,London,GB,2219,user_001,,
fa36bfe4-bb1f-4307-b8f1-252e78e0fb80,2029-11-10,2029-11-12,Local Market,5499,Groceries,Specialty,-16.22,GBP,-137684.52,POS,London,GB,9074,user_001,,
0b0e0e28-2359-438c-b270-472baf523a1a,2029-11-11,2029-11-13,Transport for London,4111,Transport,Transit,-4.75,GBP,-137689.27,POS,London,GB,2219,user_001,,
2f57a84b-b6e1-401b-bc56-5645f7c56c16,2029-11-11,2029-11-12,Tesco,5411,Groceries,Supermarket,-59.02,GBP,-137748.29,POS,London,GB,9074,user_001,,
72b0ebae-4985-4a80-a64d-9da93404f6da,2029-11-11,2029-11-12,Pret A Manger,5814,Food & Drink,Eating Out,-6.09,GBP,-137754.38,POS,London,GB,9074,user_002,,
42bcdeec-2d36-4cd3-ad60-d1b2bfcc278d,2029-11-12,2029-11-12,Apple.com/bill,5734,Shopping,Electronics,-94.71,GBP,-137849.09,E-Com,Cupertino,US,2219,user_001,,
c3caf29e-22a6-4938-a434-4b8a543c5583,2029-11-12,2029-11-12,Thames Water,4900,Utilities,Water,-42.76,GBP,-137891.85,Direct Debit,Reading,GB,4488,user_001,rec_3a34d62842,
e6e15490-02f4-4815-bb12-6b6e49e7e628,2029-11-12,2029-11-14,Pret A Manger,5814,Food & Drink,Eating Out,-10.43,GBP,-137902.28,POS,London,GB,9074,user_001,,
1f5c7aaa-bbfb-4e9d-bfcc-7605ecae0af5,2029-11-13,2029-11-14,Local Market,5499,Groceries,Specialty,-17.89,GBP,-137920.17,POS,London,GB,9074,user_002,,
a7ae3090-908a-4d04-81d2-bd71e549a7a5,2029-11-13,2029-11-15,City Council Tax,9399,Utilities,Council Tax,-171.83,GBP,-138092.0,Direct Debit,London,GB,4488,user_001,rec_f531495db5,
14dd8f6b-8152-46dc-8db9-9800645c337d,2029-11-14,2029-11-15,ATM Withdrawal,6011,Cash,ATM,-89.62,GBP,-138181.62,ATM,London,GB,2219,user_002,,
796bae39-5211-4edd-9749-df376ed86cfb,2029-11-14,2029-11-14,Amazon UK,5942,Shopping,Online Retail,-86.03,GBP,-138267.65,E-Com,London,GB,9074,user_001,,
24d602b0-08d8-47f3-9194-eb80aa72fdec,2029-11-15,2029-11-16,O2 UK,4814,Bills,Mobile,-48.14,GBP,-138315.79,Direct Debit,Slough,GB,1045,user_001,rec_95042d8101,
dff864fc-6a6f-4e7b-9db6-133d6624e949,2029-11-15,2029-11-19,Apple.com/bill,5734,Shopping,Electronics,-65.35,GBP,-138381.14,E-Com,Cupertino,US,1045,user_001,,
1378458b-c36d-4760-9add-1493e238971d,2029-11-16,2029-11-16,Waitrose,5411,Groceries,Supermarket,-70.27,GBP,-138451.41,POS,London,GB,4488,user_001,,
3f870f14-55d2-4c67-a93b-e94c91a9032c,2029-11-16,2029-11-16,Uber UK,4121,Transport,Ride Hailing,-15.41,GBP,-138466.82,E-Com,London,GB,2219,user_001,,
4f128121-036f-409a-86ff-39a536421cba,2029-11-16,2029-11-16,Tesco,5411,Groceries,Supermarket,-77.95,GBP,-138544.77,POS,London,GB,2219,user_001,,
d46e7e5a-71b0-474d-8517-9dd48c278799,2029-11-16,2029-11-19,Sainsbury's,5411,Groceries,Supermarket,-36.94,GBP,-138581.71,POS,London,GB,2219,user_001,,
064e6160-3d1b-4936-b78c-90bfb5a6c4b2,2029-11-17,2029-11-19,Local Market,5499,Groceries,Specialty,-12.86,GBP,-138594.57,POS,London,GB,9074,user_001,,
260b453c-55a8-4bee-b750-c1d20b4a4969,2029-11-17,2029-11-19,Transport for London,4111,Transport,Transit,-7.37,GBP,-138601.94,POS,London,GB,4488,user_001,,
7aecfbc1-8405-4941-8191-e12e8e2dc9b5,2029-11-17,2029-11-19,Amazon UK,5942,Shopping,Online Retail,-45.34,GBP,-138647.28,E-Com,London,GB,1045,user_001,,
909815d1-1227-4780-9285-a7af3d37d19e,2029-11-17,2029-11-19,Shell,5541,Transport,Fuel,-41.23,GBP,-138688.51,POS,London,GB,9074,user_001,,
9df9202b-f202-4203-add9-11da520c8cb8,2029-11-17,2029-11-19,Waitrose,5411,Groceries,Supermarket,-82.69,GBP,-138771.2,POS,London,GB,2219,user_001,,
ca5b1026-713d-4d43-bcb7-2f1b55305f3b,2029-11-17,2029-11-19,Apple.com/bill,5734,Shopping,Electronics,-145.85,GBP,-138917.05,E-Com,Cupertino,US,4488,user_001,,
0be4a8b4-b84e-497b-8bf7-66f78a82d24d,2029-11-18,2029-11-19,ATM Withdrawal,6011,Cash,ATM,-107.77,GBP,-139024.82,ATM,London,GB,1045,user_001,,
56330a46-71ab-45f8-b261-b6d7c4b4af06,2029-11-18,2029-11-20,Amazon UK,5942,Shopping,Online Retail,-77.16,GBP,-139101.98,E-Com,London,GB,2219,user_001,,
79d7c7f4-e316-4197-b4f2-7f60122d564a,2029-11-18,2029-11-19,Local Market,5499,Groceries,Specialty,-17.75,GBP,-139119.73,POS,London,GB,9074,user_001,,
91c4c1d0-569b-42eb-82d8-c94c9e02ea4d,2029-11-18,2029-11-19,Sainsbury's,5411,Groceries,Supermarket,-38.65,GBP,-139158.38,POS,London,GB,4488,user_001,,
b0dd7aaa-ed34-4a51-80dd-7628364dc9aa,2029-11-18,2029-11-20,Transport for London,4111,Transport,Transit,-3.72,GBP,-139162.1,POS,London,GB,1045,user_001,,
b723e867-e440-4965-a5a8-ee33914fadff,2029-11-18,2029-11-19,Amazon UK,5942,Shopping,Online Retail,-14.55,GBP,-139176.65,E-Com,London,GB,9074,user_001,,
1081d652-38ad-4079-97df-5ccbd86047f5,2029-11-19,2029-11-21,Transport for London,4111,Transport,Transit,-11.38,GBP,-139188.03,POS,London,GB,9074,user_001,,
5fcb6c40-1bd9-42b8-b2c9-30421c361482,2029-11-19,2029-11-20,ATM Withdrawal,6011,Cash,ATM,-90.25,GBP,-139278.28,ATM,London,GB,9074,user_001,,
66499d27-9daf-4ba8-8fe9-a3401610cb26,2029-11-19,2029-11-19,GymBox,7997,Wellness,Gym,-53.4,GBP,-139331.68,Direct Debit,London,GB,9074,user_001,rec_3906953fd2,
6c7b1060-5b97-4b19-bdb3-db25dc24ce2c,2029-11-19,2029-11-19,Amazon UK,5942,Shopping,Online Retail,-100.46,GBP,-139432.14,E-Com,London,GB,9074,user_001,,
78b0af0f-b7cb-4410-af62-9557290a2ab6,2029-11-19,2029-11-21,Pret A Manger,5814,Food & Drink,Eating Out,-11.0,GBP,-139443.14,POS,London,GB,9074,user_001,,
835579cc-a4c1-4679-bca7-ea1be1aeb9ab,2029-11-19,2029-11-21,Spotify,5735,Entertainment,Subscriptions,-9.92,GBP,-139453.06,E-Com,Stockholm,SE,4488,user_001,rec_4c746d2c3b,
ec73473f-7f8c-4f2e-a315-e1676810229f,2029-11-20,2029-11-22,Pret A Manger,5814,Food & Drink,Eating Out,-7.51,GBP,-139460.57,POS,London,GB,9074,user_001,,
46cb9b6c-cc75-4bf0-b7af-08cae8bc85f4,2029-11-21,2029-11-23,Netflix,7841,Entertainment,Subscriptions,-12.66,USD,-139473.23,E-Com,Los Gatos,US,1045,user_001,rec_1bfe33738d,FX purchase 15.63 USD @ rate 1.23
7a7ee808-6a66-405e-8cf3-1322a42bd346,2029-11-21,2029-11-23,Transport for London,4111,Transport,Transit,-9.34,GBP,-139482.57,POS,London,GB,9074,user_001,,
4ebd343a-ee60-4b16-9bcf-93e50d26c3d0,2029-11-22,2029-11-23,Waitrose,5411,Groceries,Supermarket,-34.22,GBP,-139516.79,POS,London,GB,2219,user_002,,
4f4c519f-a383-4c25-9d38-3cce0d948bf8,2029-11-23,2029-11-26,Sainsbury's,5411,Groceries,Supermarket,-41.36,GBP,-139558.15,POS,London,GB,2219,user_001,,
57b65d1c-3993-4d22-af35-122569e99a40,2029-11-23,2029-11-26,Local Market,5499,Groceries,Specialty,-14.43,GBP,-139572.58,POS,London,GB,9074,user_001,,
bfc17c35-220a-4fb3-bf72-09c9f347a485,2029-11-23,2029-11-23,T212 Capital,6011,Income,Salary,3106.0,GBP,-136466.58,Credit,London,GB,4488,user_002,rec_c649d24d0f,
a9bc3872-16ad-4629-991d-aa1b18a05feb,2029-11-24,2029-11-26,Sainsbury's,5411,Groceries,Supermarket,-51.54,GBP,-136518.12,POS,London,GB,4488,user_001,,
d6db594a-f13e-4af5-91c6-34abcd18d506,2029-11-24,2029-11-26,Local Market,5499,Groceries,Specialty,-13.79,GBP,-136531.91,POS,London,GB,1045,user_002,,
eb6606ce-d6dd-456e-a344-2bef8c4962a3,2029-11-24,2029-11-26,Waitrose,5411,Groceries,Supermarket,-73.6,GBP,-136605.51,POS,London,GB,9074,user_001,,
1d24a687-c395-4ffe-ad99-5ed4ca6f896a,2029-11-25,2029-11-26,Shell,5541,Transport,Fuel,-64.63,GBP,-136670.14,POS,London,GB,2219,user_001,,
1d65c817-9b67-45ff-b55b-21cfd331178f,2029-11-25,2029-11-27,Pret A Manger,5814,Food & Drink,Eating Out,-6.57,GBP,-136676.71,POS,London,GB,4488,user_001,,
6a2b567b-dc46-41ef-97a9-497acda204bc,2029-11-25,2029-11-26,Pret A Manger,5814,Food & Drink,Eating Out,-6.81,GBP,-136683.52,POS,London,GB,4488,user_001,,
bd025d8a-2aad-4513-907a-315e87b29266,2029-11-25,2029-11-26,Pret A Manger,5814,Food & Drink,Eating Out,-7.07,GBP,-136690.59,POS,London,GB,2219,user_001,,
e25429dd-82cc-4246-8566-9525aa452b98,2029-11-25,2029-11-27,Transport for London,4111,Transport,Transit,-9.51,GBP,-136700.1,POS,London,GB,9074,user_001,,
e5eba0d0-4787-41ef-9c1d-3235a77ddbf0,2029-11-25,2029-11-26,Tesco,5411,Groceries,Supermarket,-62.63,GBP,-136762.73,POS,London,GB,1045,user_001,,
06b37ed6-74fa-45a2-87e0-bc10d065db70,2029-11-26,2029-11-26,Apple.com/bill,5734,Shopping,Electronics,-48.13,GBP,-136810.86,E-Com,Cupertino,US,2219,user_001,,
7d465a24-3aec-477d-9d5c-260a41ed4a1f,2029-11-26,2029-11-26,Amazon UK,5942,Shopping,Online Retail,-17.48,GBP,-136828.34,E-Com,London,GB,9074,user_001,,
8eb6cf9d-1c26-40be-a8d4-0da9f622e77a,2029-11-26,2029-11-28,Transport for London,4111,Transport,Transit,-6.76,GBP,-136835.1,POS,London,GB,4488,user_001,,
0479f717-a64c-451d-812b-a5c6c0fe4274,2029-11-27,2029-11-29,Transport for London,4111,Transport,Transit,-11.28,GBP,-136846.38,POS,London,GB,2219,user_001,,
1bd1dc65-ff91-4e05-a6b0-82ade833668c,2029-11-27,2029-11-27,Local Market,5499,Groceries,Specialty,-21.02,GBP,-136867.4,POS,London,GB,2219,user_001,,
9b03d5a4-5368-48e4-867e-875e09bc4db2,2029-11-27,2029-11-27,HM Revenue & Customs,9311,Income,Tax Refund,44.01,GBP,-136823.39,Credit,London,GB,4488,user_001,,Refund for Tesco
04b21131-5c5c-4f49-881b-e84e8be55ca0,2029-11-28,2029-11-29,Transport for London,4111,Transport,Transit,-3.51,GBP,-136826.9,POS,London,GB,9074,user_001,,
16c6b62a-6a51-4ca9-9f61-9b8399fa8d9c,2029-11-28,2029-11-28,Sainsbury's,5411,Groceries,Supermarket,-48.49,GBP,-136875.39,POS,London,GB,1045,user_002,,
65c64021-10b5-4cdc-bc7b-fcbacda2ae90,2029-11-28,2029-11-29,Apple.com/bill,5734,Shopping,Electronics,-170.33,GBP,-137045.72,E-Com,Cupertino,US,1045,user_001,,
1a251b20-f803-44ee-a33d-104ac9248323,2029-11-29,2029-11-30,Deliveroo,5812,Food & Drink,Delivery,-21.54,GBP,-137067.26,E-Com,London,GB,2219,user_002,,
9662fcac-182d-43c1-b8cb-13559a15066e,2029-11-29,2029-12-03,Uber UK,4121,Transport,Ride Hailing,-17.02,GBP,-137084.28,E-Com,London,GB,4488,user_001,,
2e69d949-6a62-40f0-a8d5-0fdfc2a66141,2029-11-30,2029-11-30,ATM Withdrawal,6011,Cash,ATM,-92.27,GBP,-137176.55,ATM,London,GB,2219,user_001,,
43326666-746e-4925-9673-368c746c6348,2029-12-01,2029-12-03,Tesco,5411,Groceries,Supermarket,-44.51,GBP,-137221.06,POS,London,GB,9074,user_001,,
577cc358-152d-43d1-bbea-9bee6e36cc3b,2029-12-01,2029-12-03,Shell,5541,Transport,Fuel,-31.38,GBP,-137252.44,POS,London,GB,1045,user_002,,
1591ad3a-0e26-4e5f-9f19-9af909cfe37e,2029-12-02,2029-12-03,Transport for London,4111,Transport,Transit,-10.03,GBP,-137262.47,POS,London,GB,1045,user_001,,
5af19caf-b39a-498e-a11d-8d8e9d01eb2f,2029-12-02,2029-12-03,Sainsbury's,5411,Groceries,Supermarket,-25.83,GBP,-137288.3,POS,London,GB,1045,user_001,,
644df234-b69c-4763-835b-6bee228fdb9f,2029-12-02,2029-12-03,Tesco,5411,Groceries,Supermarket,-55.31,GBP,-137343.61,POS,London,GB,4488,user_001,,
871af8d0-66bf-4aa7-b3ba-f1a9f435052e,2029-12-02,2029-12-03,Shell,5541,Transport,Fuel,-80.21,GBP,-137423.82,POS,London,GB,2219,user_001,,
14531dd1-595e-427e-8649-a95e1f181241,2029-12-03,2029-12-04,Crown Estates Lettings,6513,Housing,Rent,-1548.05,GBP,-138971.87,POS,London,GB,2219,user_001,rec_19f70fbcce,
2ebc1fd1-8f8d-49a6-9c1e-342e873d2f06,2029-12-03,2029-12-04,Sainsbury's,5411,Groceries,Supermarket,-62.31,GBP,-139034.18,POS,London,GB,4488,user_001,,
3f40d86a-c510-499e-ad26-50440589e2ae,2029-12-03,2029-12-03,Uber UK,4121,Transport,Ride Hailing,-9.72,GBP,-139043.9,E-Com,London,GB,9074,user_001,,
575675f0-fea9-432e-8ff3-a50b97c7785f,2029-12-03,2029-12-04,Tesco,5411,Groceries,Supermarket,-56.76,GBP,-139100.66,POS,London,GB,9074,user_001,,
3b0f60a9-5715-4895-8582-88db521b1531,2029-12-04,2029-12-04,Pret A Manger,5814,Food & Drink,Eating Out,-9.23,GBP,-139109.89,POS,London,GB,2219,user_001,,
60b23e55-b23d-48a2-8d0f-45f75efc6db0,2029-12-05,2029-12-07,Pret A Manger,5814,Food & Drink,Eating Out,-10.55,GBP,-139120.44,POS,London,GB,1045,user_002,,
b6506c20-ac41-4741-a688-f1075d7d84bb,2029-12-05,2029-12-07,Sainsbury's,5411,Groceries,Supermarket,-22.61,GBP,-139143.05,POS,London,GB,1045,user_001,,
7351800f-4bc1-41e7-b12a-d035bd98ad30,2029-12-06,2029-12-10,Uber UK,4121,Transport,Ride Hailing,-26.44,GBP,-139169.49,E-Com,London,GB,1045,user_001,,
73815646-9c00-46f6-bb30-d79d87070b76,2029-12-06,2029-12-10,Tesco,5411,Groceries,Supermarket,-20.95,GBP,-139190.44,POS,London,GB,1045,user_001,,
1b8e6fac-fcb7-44c5-bb0e-5cbf9caae879,2029-12-07,2029-12-10,Octopus Energy,4900,Utilities,Electricity,-143.63,GBP,-139334.07,Direct Debit,London,GB,1045,user_001,rec_141a4a0666,
4d827248-c651-440f-af03-ae6edf583c51,2029-12-07,2029-12-10,Pret A Manger,5814,Food & Drink,Eating Out,-8.78,GBP,-139342.85,POS,London,GB,1045,user_001,,
9e215aa9-ae5a-4c3e-aadb-bf018ac1031d,2029-12-07,2029-12-10,Waitrose,5411,Groceries,Supermarket,-25.71,GBP,-139368.56,POS,London,GB,1045,user_001,,
2ca90f32-9ed3-4a15-a410-f810b170001d,2029-12-08,2029-12-10,Waitrose,5411,Groceries,Supermarket,-39.43,GBP,-139407.99,POS,London,GB,9074,user_001,,
339059be-a7ab-4175-98e2-dc2c4aa4119a,2029-12-08,2029-12-10,Pret A Manger,5814,Food & Drink,Eating Out,-7.98,GBP,-139415.97,POS,London,GB,4488,user_001,,
3a85e630-be89-4ef3-9f6a-071ab3f946b0,2029-12-08,2029-12-10,Waitrose,5411,Groceries,Supermarket,-68.59,GBP,-139484.56,POS,London,GB,2219,user_002,,
86b3754a-a92f-4b11-a877-a9ac6ef1543b,2029-12-08,2029-12-10,Pret A Manger,5814,Food & Drink,Eating Out,-5.62,GBP,-139490.18,POS,London,GB,4488,user_001,,
f3010a77-06ec-4fc2-9780-2a53d6447cae,2029-12-08,2029-12-10,Apple.com/bill,5734,Shopping,Electronics,-2.54,GBP,-139492.72,E-Com,Cupertino,US,9074,user_001,,
b88603a6-8002-4913-b3d8-5485ec27d1f8,2029-12-09,2029-12-11,Apple.com/bill,5734,Shopping,Electronics,-145.54,GBP,-139638.26,E-Com,Cupertino,US,9074,user_001,,
c389b29c-c694-480c-aa2b-18feb1168ad7,2029-12-09,2029-12-11,Shell,5541,Transport,Fuel,-84.14,GBP,-139722.4,POS,London,GB,2219,user_001,,
c5e8fa3a-91a8-40ea-afa1-6cc16165efc1,2029-12-09,2029-12-10,Waitrose,5411,Groceries,Supermarket,-37.44,GBP,-139759.84,POS,London,GB,1045,user_001,,
ffb9cfb5-3578-4d09-927d-9704f2073df0,2029-12-09,2029-12-10,Transport for London,4111,Transport,Transit,-4.63,GBP,-139764.47,POS,London,GB,4488,user_002,,
2343c2c7-da0b-4ab7-8204-f8919b568afd,2029-12-10,2029-12-11,Apple.com/bill,5734,Shopping,Electronics,-96.08,GBP,-139860.55,E-Com,Cupertino,US,2219,user_001,,
f732433b-23e1-4d98-8350-2a4f1e65084b,2029-12-10,2029-12-12,Apple.com/bill,5734,Shopping,Electronics,-189.47,GBP,-140050.02,E-Com,Cupertino,US,4488,user_001,,
14e21ba3-6d92-4e8b-b659-aad2f5c44e7f,2029-12-11,2029-12-13,Uber UK,4121,Transport,Ride Hailing,-17.17,GBP,-140067.19,E-Com,London,GB,4488,user_001,,
6af02719-dc2c-4315-8b29-f3f1582627b3,2029-12-11,2029-12-12,Thames Water,4900,Utilities,Water,-34.64,GBP,-140101.83,Direct Debit,Reading,GB,2219,user_001,rec_3a34d62842,
b4a5df7a-7cb7-41e9-b0eb-322194bdaa11,2029-12-11,2029-12-12,Waitrose,5411,Groceries,Supermarket,-59.49,GBP,-140161.32,POS,London,GB,1045,user_002,,
b61bf36b-f98a-4873-b0c8-08adb489ee7c,2029-12-11,2029-12-12,Uber UK,4121,Transport,Ride Hailing,-10.73,GBP,-140172.05,E-Com,London,GB,4488,user_001,,
633fea5f-9336-4597-90be-768996f8b15e,2029-12-13,2029-12-14,Deliveroo,5812,Food & Drink,Delivery,-28.1,GBP,-140200.15,E-Com,London,GB,9074,user_001,,
f938cf50-ce66-4f1c-b8b5-d77387f54996,2029-12-13,2029-12-13,City Council Tax,9399,Utilities,Council Tax,-151.65,GBP,-140351.8,Direct Debit,London,GB,4488,user_001,rec_f531495db5,
c9788680-53dd-43c0-90c6-2ebcc0394e7c,2029-12-14,2029-12-14,Sainsbury's,5411,Groceries,Supermarket,-29.58,GBP,-140381.38,POS,London,GB,1045,user_001,,
1fc68efe-8332-44b2-9e05-11c66b034b76,2029-12-15,2029-12-17,British Airways,4511,Travel,Flights,-310.27,GBP,-140691.65,E-Com,London,GB,2219,user_001,,Business travel
7f573cd4-7940-4749-8561-1e44047ab544,2029-12-15,2029-12-17,Pret A Manger,5814,Food & Drink,Eating Out,-11.72,GBP,-140703.37,POS,London,GB,4488,user_001,,
ed25c339-c47d-4eb2-a691-a6ab7ea159a1,2029-12-15,2029-12-17,Waitrose,5411,Groceries,Supermarket,-63.63,GBP,-140767.0,POS,London,GB,4488,user_002,,
0671cb54-a7e8-4916-8837-1134596380d4,2029-12-16,2029-12-17,Sainsbury's,5411,Groceries,Supermarket,-14.11,GBP,-140781.11,POS,London,GB,1045,user_001,,
4be47c7d-6257-4509-be54-53e7d5a9ab5b,2029-12-16,2029-12-17,Pret A Manger,5814,Food & Drink,Eating Out,-9.5,GBP,-140790.61,POS,London,GB,4488,user_001,,
5f75ed19-c343-4595-b068-c21bdaa79028,2029-12-16,2029-12-18,Local Market,5499,Groceries,Specialty,-13.76,GBP,-140804.37,POS,London,GB,1045,user_002,,
671d3987-b628-4699-b4c1-e86bc95a1bba,2029-12-16,2029-12-17,Sainsbury's,5411,Groceries,Supermarket,-45.98,GBP,-140850.35,POS,London,GB,4488,user_001,,
9bc8a027-bb4d-4822-9d8f-f506e39536c1,2029-12-16,2029-12-17,Sainsbury's,5411,Groceries,Supermarket,-63.41,GBP,-140913.76,POS,London,GB,4488,user_001,,
b29fcfd7-cca0-4896-92f6-187f4f343680,2029-12-16,2029-12-18,Local Market,5499,Groceries,Specialty,-18.64,GBP,-140932.4,POS,London,GB,4488,user_001,,
37ec54ae-dea3-4ac7-b45a-b305b532e0b1,2029-12-17,2029-12-17,Apple.com/bill,5734,Shopping,Electronics,-190.73,GBP,-141123.13,E-Com,Cupertino,US,9074,user_001,,
a2ae4336-7d14-4a33-9946-ad67d11df409,2029-12-17,2029-12-18,Amazon UK,5942,Shopping,Online Retail,-104.4,GBP,-141227.53,E-Com,London,GB,4488,user_001,,
acf6980d-b4ac-4a2f-8129-47bd0afe31f6,2029-12-17,2029-12-19,GymBox,7997,Wellness,Gym,-55.54,GBP,-141283.07,Direct Debit,London,GB,4488,user_001,rec_3906953fd2,
e084d021-a317-46c9-8b5a-1d768423a7ad,2029-12-17,2029-12-18,O2 UK,4814,Bills,Mobile,-48.49,GBP,-141331.56,Direct Debit,Slough,GB,1045,user_002,rec_d2dce4c42f,
652ddb1b-cc69-49ba-bc51-26c19f91b575,2029-12-18,2029-12-20,Waitrose,5411,Groceries,Supermarket,-58.11,GBP,-141389.67,POS,London,GB,1045,user_002,,
e1b6a7a0-f085-4234-a3d7-6c1748ba33be,2029-12-18,2029-12-19,Shell,5541,Transport,Fuel,-76.41,GBP,-141466.08,POS,London,GB,1045,user_001,,
ed2f8ed0-a25e-4c2f-8331-f3ce49f82489,2029-12-18,2029-12-19,Tesco,5411,Groceries,Supermarket,-33.19,GBP,-141499.27,POS,London,GB,9074,user_002,,
1b9388e2-73f4-47ab-a5e2-ac8bf31e6450,2029-12-19,2029-12-19,Spotify,5735,Entertainment,Subscriptions,-8.82,GBP,-141508.09,E-Com,Stockholm,SE,2219,user_001,rec_4c746d2c3b,
364ef269-a559-458f-8b04-f14727cac0fd,2029-12-19,2029-12-21,Sainsbury's,5411,Groceries,Supermarket,-17.07,GBP,-141525.16,POS,London,GB,2219,user_001,,
76996534-b931-4691-91ef-a914d6adc0cb,2029-12-20,2029-12-24,Transport for London,4111,Transport,Transit,-5.31,GBP,-141530.47,POS,London,GB,1045,user_002,,
799cca97-714c-4148-ada8-d05b21cba0ec,2029-12-20,2029-12-24,Pret A Manger,5814,Food & Drink,Eating Out,-7.62,GBP,-141538.09,POS,London,GB,4488,user_002,,
a32dc286-4394-4986-b90e-2ae8c93562e0,2029-12-20,2029-12-20,Tesco,5411,Groceries,Supermarket,-55.05,GBP,-141593.14,POS,London,GB,4488,user_001,,
07087f7b-8f48-4007-955f-f3f5183d0372,2029-12-21,2029-12-21,Shell,5541,Transport,Fuel,-39.93,GBP,-141633.07,POS,London,GB,4488,user_001,,
8c55fa03-5500-465e-928a-c2c8e490b053,2029-12-21,2029-12-21,Netflix,7841,Entertainment,Subscriptions,-15.24,GBP,-141648.31,E-Com,Los Gatos,US,4488,user_002,rec_d9322c1382,
19cf8d46-22c3-4ef0-b212-0a6f22beee7e,2029-12-22,2029-12-24,Local Market,5499,Groceries,Specialty,-19.99,GBP,-141668.3,POS,London,GB,4488,user_001,,
375041de-9b8e-4d41-9e20-9bcd6c8e77f0,2029-12-22,2029-12-24,Apple.com/bill,5734,Shopping,Electronics,-39.65,GBP,-141707.95,E-Com,Cupertino,US,1045,user_002,,
00e0ec37-515e-4a3c-be43-bf6a4856592d,2029-12-23,2029-12-24,Tesco,5411,Groceries,Supermarket,-33.36,GBP,-141741.31,POS,London,GB,4488,user_001,,
97bfffc3-73c5-42a4-a692-52270b65df80,2029-12-23,2029-12-24,Deliveroo,5812,Food & Drink,Delivery,-28.52,GBP,-141769.83,E-Com,London,GB,2219,user_001,,
9a5ebe70-d36d-472a-af73-4ef705a84ea7,2029-12-24,2029-12-24,Deliveroo,5812,Food & Drink,Delivery,-32.63,GBP,-141802.46,E-Com,London,GB,4488,user_001,,
10f65595-e9eb-4779-b2ed-51391e84f960,2029-12-25,2029-12-25,T212 Capital,6011,Income,Salary,3273.36,GBP,-138529.1,Credit,London,GB,2219,user_001,rec_2ff8f778d0,
d1997d1c-5900-4e1d-8ad6-0b1937ecddf8,2029-12-25,2029-12-27,Sainsbury's,5411,Groceries,Supermarket,-43.98,GBP,-138573.08,POS,London,GB,1045,user_001,,
cc03f0ba-b1cb-4b34-8a06-5e4758e05e36,2029-12-26,2029-12-27,Uber UK,4121,Transport,Ride Hailing,-24.32,GBP,-138597.4,E-Com,London,GB,4488,user_001,,
fc32921c-ed34-4dac-89cc-4b5d0026d0a7,2029-12-28,2029-12-28,Pret A Manger,5814,Food & Drink,Eating Out,-9.47,GBP,-138606.87,POS,London,GB,9074,user_002,,
33ef23ff-fa46-4a1f-8c40-4e7b43292d44,2029-12-29,2029-12-31,Waitrose,5411,Groceries,Supermarket,-85.32,GBP,-138692.19,POS,London,GB,1045,user_001,,
544a5a56-05e0-4177-8942-42eb820c56fa,2029-12-29,2029-12-31,Local Market,5499,Groceries,Specialty,-17.85,GBP,-138710.04,POS,London,GB,2219,user_002,,
5554c242-4944-448b-b0cc-7f2617559844,2029-12-29,2029-12-31,Uber UK,4121,Transport,Ride Hailing,-13.31,GBP,-138723.35,E-Com,London,GB,9074,user_002,,
1007d7c3-6153-41f3-8059-169b2dc05a7a,2029-12-30,2029-12-31,Uber UK,4121,Transport,Ride Hailing,-15.47,GBP,-138738.82,E-Com,London,GB,1045,user_002,,
224340e0-90f7-4580-97f3-0daf38c60e98,2029-12-30,2029-12-31,Airline Refund,4511,Travel,Refund,14.07,GBP,-138724.75,Credit,London,GB,1045,user_001,,Refund for Deliveroo
767f95ec-51d9-480c-96c2-cc8d1208efa9,2029-12-30,2030-01-01,Tesco,5411,Groceries,Supermarket,-77.03,GBP,-138801.78,POS,London,GB,9074,user_001,,
c3b0bff9-5b49-4ab3-a153-da8380cabb49,2029-12-30,2029-12-31,Deliveroo,5812,Food & Drink,Delivery,-13.69,GBP,-138815.47,E-Com,London,GB,4488,user_001,,
c8e3c474-dbb4-44a1-bb92-b451cb90bf81,2029-12-30,2030-01-01,Amazon UK,5942,Shopping,Online Retail,-85.32,GBP,-138900.79,E-Com,London,GB,9074,user_001,,
d5988bbd-117c-4151-8edc-137d3add59b3,2029-12-30,2029-12-31,Transport for London,4111,Transport,Transit,-3.78,GBP,-138904.57,POS,London,GB,9074,user_001,,
f5550912-0236-4891-b2e4-8efdb47caf19,2029-12-30,2029-12-31,Apple.com/bill,5734,Shopping,Electronics,-191.22,GBP,-139095.79,E-Com,Cupertino,US,2219,user_001,,
3d625c65-6dd8-4f3c-93be-86ed163a15fa,2029-12-31,2030-01-01,Transport for London,4111,Transport,Transit,-10.83,GBP,-139106.62,POS,London,GB,2219,user_001,,
6b9497c6-19f8-4bb9-b751-889a3e94193c,2029-12-31,2030-01-01,Uber UK,4121,Transport,Ride Hailing,-14.95,GBP,-139121.57,E-Com,London,GB,9074,user_001,,
b8930fbc-655c-488c-9a88-f857a47f4988,2029-12-31,2029-12-31,Apple.com/bill,5734,Shopping,Electronics,-94.8,GBP,-139216.37,E-Com,Cupertino,US,9074,user_001,,
585b9cce-d835-4eda-ad6b-1cf21ed706ff,2030-01-01,2030-01-02,Crown Estates Lettings,6513,Housing,Rent,-1523.1,GBP,-140739.47,POS,London,GB,2219,user_001,rec_19f70fbcce,
5b8dad50-9490-482d-820b-777ebc1b418e,2030-01-01,2030-01-01,Tesco,5411,Groceries,Supermarket,-80.6,GBP,-140820.07,POS,London,GB,2219,user_001,,
12da9904-a09e-4e0a-a715-84d0409093c6,2030-01-02,2030-01-03,Local Market,5499,Groceries,Specialty,-10.88,GBP,-140830.95,POS,London,GB,4488,user_001,,
4ecd948d-7880-4e98-8435-c08b9fe5195c,2030-01-02,2030-01-02,Transport for London,4111,Transport,Transit,-6.59,GBP,-140837.54,POS,London,GB,1045,user_001,,
f827f016-bbe1-4d62-a7a7-702303db06eb,2030-01-02,2030-01-03,Shell,5541,Transport,Fuel,-77.52,GBP,-140915.06,POS,London,GB,4488,user_001,,
5facf3f5-5871-44a7-a5e5-52a6d1d1336c,2030-01-03,2030-01-04,Pret A Manger,5814,Food & Drink,Eating Out,-6.9,GBP,-140921.96,POS,London,GB,9074,user_002,,
7af5db9f-3b95-411d-8776-7acf4ec16b07,2030-01-04,2030-01-07,Deliveroo,5812,Food & Drink,Delivery,-17.28,GBP,-140939.24,E-Com,London,GB,9074,user_001,,
161a65b6-68ee-4feb-a2fb-734b10d57a55,2030-01-05,2030-01-07,Pret A Manger,5814,Food & Drink,Eating Out,-8.85,GBP,-140948.09,POS,London,GB,4488,user_001,,
197b2614-ca68-4502-9307-4cfa03a3a764,2030-01-05,2030-01-07,Deliveroo,5812,Food & Drink,Delivery,-12.6,GBP,-140960.69,E-Com,London,GB,9074,user_002,,
6e0f0077-666f-466d-917b-216203a59f81,2030-01-05,2030-01-07,Shell,5541,Transport,Fuel,-92.63,GBP,-141053.32,POS,London,GB,9074,user_001,,
7582ea4a-c10a-4cae-a3bb-04f67f19b185,2030-01-05,2030-01-07,Uber UK,4121,Transport,Ride Hailing,-15.37,GBP,-141068.69,E-Com,London,GB,4488,user_001,,
1b63b64c-a78d-4447-bc1c-e7bbec04455b,2030-01-06,2030-01-08,Local Market,5499,Groceries,Specialty,-17.67,GBP,-141086.36,POS,London,GB,1045,user_001,,
3abaa531-47d3-4b20-a078-ac2ca58809f6,2030-01-06,2030-01-07,Shell,5541,Transport,Fuel,-73.15,GBP,-141159.51,POS,London,GB,1045,user_001,,
5ff417ab-383f-4015-9830-7f65c33e9b14,2030-01-06,2030-01-07,Apple.com/bill,5734,Shopping,Electronics,-195.25,USD,-141354.76,E-Com,Cupertino,US,9074,user_001,,FX purchase 235.14 USD @ rate 1.20
83bea45b-fa2e-4e0f-8d92-a387ef1288fe,2030-01-06,2030-01-07,Local Market,5499,Groceries,Specialty,-18.04,GBP,-141372.8,POS,London,GB,2219,user_001,,
84ccc199-9d5f-4783-8cad-22626ba15efc,2030-01-06,2030-01-07,Amazon UK,5942,Shopping,Online Retail,-118.02,GBP,-141490.82,E-Com,London,GB,2219,user_001,,
a447e7c2-36e5-4cb8-815b-3cf7617b8fe9,2030-01-06,2030-01-07,Transport for London,4111,Transport,Transit,-9.44,GBP,-141500.26,POS,London,GB,9074,user_001,,
b7d8eba8-9c91-467e-9004-fbd0c6fc82e5,2030-01-06,2030-01-07,Amazon UK,5942,Shopping,Online Retail,-92.32,GBP,-141592.58,E-Com,London,GB,2219,user_001,,
f09be573-6d60-4120-b667-d2a28e7710be,2030-01-06,2030-01-08,Sainsbury's,5411,Groceries,Supermarket,-57.56,GBP,-141650.14,POS,London,GB,2219,user_001,,
6a496b8a-d141-4d61-bf71-36b764997bc6,2030-01-07,2030-01-09,Shell,5541,Transport,Fuel,-86.74,GBP,-141736.88,POS,London,GB,4488,user_001,,
f74db367-d8ab-4143-86f5-44228906df7c,2030-01-07,2030-01-08,Octopus Energy,4900,Utilities,Electricity,-128.66,GBP,-141865.54,Direct Debit,London,GB,1045,user_002,rec_09c3f12b18,
5aa325c5-0340-4623-9bd9-a4e56be1a3bd,2030-01-08,2030-01-09,Deliveroo,5812,Food & Drink,Delivery,-29.09,GBP,-141894.63,E-Com,London,GB,9074,user_001,,
d9318f52-d824-4d67-84dd-cb8d09c36028,2030-01-08,2030-01-10,Transport for London,4111,Transport,Transit,-5.57,GBP,-141900.2,POS,London,GB,1045,user_001,,
fa378f08-eca4-4702-a852-44c6b488619d,2030-01-08,2030-01-10,Uber UK,4121,Transport,Ride Hailing,-21.79,GBP,-141921.99,E-Com,London,GB,4488,user_001,,
867c54f5-4dbb-4f25-ae4a-977d9f406507,2030-01-09,2030-01-09,Pret A Manger,5814,Food & Drink,Eating Out,-9.73,GBP,-141931.72,POS,London,GB,4488,user_001,,
97217f44-0922-4c70-8529-c34bf7d2edf1,2030-01-09,2030-01-09,Sainsbury's,5411,Groceries,Supermarket,-69.29,GBP,-142001.01,POS,London,GB,1045,user_001,,
bb787141-5507-4721-84f3-3332fbe5946c,2030-01-09,2030-01-10,Tesco,5411,Groceries,Supermarket,-35.08,GBP,-142036.09,POS,London,GB,4488,user_001,,
de0773a5-b7c3-4b5e-85af-922f0835077e,2030-01-09,2030-01-09,Amazon UK,5942,Shopping,Online Retail,-119.16,GBP,-142155.25,E-Com,London,GB,4488,user_001,,
223ef7bd-56bf-47dc-bf95-618692a08676,2030-01-10,2030-01-11,Sainsbury's,5411,Groceries,Supermarket,-40.02,GBP,-142195.27,POS,London,GB,2219,user_001,,
3ff322fa-3e52-476e-84a3-10049788c837,2030-01-10,2030-01-10,Shell,5541,Transport,Fuel,-55.8,GBP,-142251.07,POS,London,GB,1045,user_001,,
959d6088-b848-45bb-a443-16e175ec0880,2030-01-10,2030-01-10,Pret A Manger,5814,Food & Drink,Eating Out,-5.76,GBP,-142256.83,POS,London,GB,4488,user_001,,
22692302-dfa8-40c2-bb50-0734efe670f0,2030-01-11,2030-01-14,Thames Water,4900,Utilities,Water,-42.76,GBP,-142299.59,Direct Debit,Reading,GB,4488,user_001,rec_3a34d62842,
23578e44-9a05-44cf-a4a5-1c963415aa77,2030-01-11,2030-01-11,Transport for London,4111,Transport,Transit,-3.63,GBP,-142303.22,POS,London,GB,2219,user_001,,
d7de416a-a5da-4e81-a549-d9463c1c6ade,2030-01-11,2030-01-14,Pret A Manger,5814,Food & Drink,Eating Out,-10.17,GBP,-142313.39,POS,London,GB,1045,user_001,,
a4c1a9b6-7544-4291-9756-82e75d857a43,2030-01-12,2030-01-14,Sainsbury's,5411,Groceries,Supermarket,-15.74,GBP,-142329.13,POS,London,GB,2219,user_001,,
f0a868da-5d23-4ba0-92d1-6f1a91d1f563,2030-01-12,2030-01-14,ATM Withdrawal,6011,Cash,ATM,-105.93,GBP,-142435.06,ATM,London,GB,9074,user_001,,
274d644a-36c4-479a-a1c2-974276b258ad,2030-01-13,2030-01-14,Waitrose,5411,Groceries,Supermarket,-54.9,GBP,-142489.96,POS,London,GB,9074,user_001,,
684d04d4-7a1c-486e-96a5-07512297a6a6,2030-01-13,2030-01-14,Amazon UK,5942,Shopping,Online Retail,-81.46,GBP,-142571.42,E-Com,London,GB,4488,user_001,,
711608d2-633c-4d77-846d-dbe270edb20e,2030-01-13,2030-01-15,Shell,5541,Transport,Fuel,-83.9,GBP,-142655.32,POS,London,GB,4488,user_001,,
82e60300-ad5d-4162-a22d-3536bd63e2cf,2030-01-13,2030-01-14,Uber UK,4121,Transport,Ride Hailing,-10.39,GBP,-142665.71,E-Com,London,GB,4488,user_001,,
8901422d-821b-4158-b9de-04346f2d5490,2030-01-13,2030-01-15,Sainsbury's,5411,Groceries,Supermarket,-42.92,GBP,-142708.63,POS,London,GB,9074,user_001,,
ad5c5587-4e74-4976-9b7e-760785fcc927,2030-01-13,2030-01-15,Deliveroo,5812,Food & Drink,Delivery,-13.02,GBP,-142721.65,E-Com,London,GB,2219,user_001,,
bcddb8e2-d84f-4896-9388-337fb2ad3737,2030-01-13,2030-01-14,Transport for London,4111,Transport,Transit,-11.22,GBP,-142732.87,POS,London,GB,1045,user_002,,
da4ba13c-b328-4ee9-b40f-0b3343c3c21f,2030-01-13,2030-01-14,Transport for London,4111,Transport,Transit,-7.46,GBP,-142740.33,POS,London,GB,1045,user_001,,
e2a8f525-255d-4e29-be55-99a9343eddd3,2030-01-13,2030-01-14,Transport for London,4111,Transport,Transit,-4.1,GBP,-142744.43,POS,London,GB,4488,user_001,,
f0bf0572-2a7e-428f-8632-065f7c940269,2030-01-13,2030-01-14,Local Market,5499,Groceries,Specialty,-13.65,GBP,-142758.08,POS,London,GB,4488,user_001,,
2d292464-e886-4568-b8a7-e6bba5ff63a1,2030-01-14,2030-01-14,City Council Tax,9399,Utilities,Council Tax,-182.98,GBP,-142941.06,Direct Debit,London,GB,9074,user_002,rec_6feaa5d43f,
4d598ebc-fb5e-4d04-85d1-4c44e4d7922c,2030-01-14,2030-01-16,Shell,5541,Transport,Fuel,-42.77,GBP,-142983.83,POS,London,GB,4488,user_001,,
b415ddf1-919d-4907-8a15-406a8939a8bc,2030-01-14,2030-01-16,Waitrose,5411,Groceries,Supermarket,-71.11,GBP,-143054.94,POS,London,GB,9074,user_001,,
c79f9195-5399-47d5-b415-851a42fc7a50,2030-01-14,2030-01-15,Amazon UK,5942,Shopping,Online Retail,-57.43,GBP,-143112.37,E-Com,London,GB,9074,user_001,,
ea14c7ec-e922-464d-9750-66f8e3a3a5fc,2030-01-14,2030-01-15,Uber UK,4121,Transport,Ride Hailing,-9.97,GBP,-143122.34,E-Com,London,GB,4488,user_002,,
f30c149b-02e8-4763-977d-97a940062107,2030-01-14,2030-01-14,Sainsbury's,5411,Groceries,Supermarket,-64.04,GBP,-143186.38,POS,London,GB,4488,user_002,,
01e5ebd2-9cea-4683-b9a7-6202d894a7c4,2030-01-15,2030-01-16,O2 UK,4814,Bills,Mobile,-50.81,GBP,-143237.19,Direct Debit,Slough,GB,2219,user_002,rec_d2dce4c42f,
43742b19-b721-447d-8e49-6197629341e6,2030-01-15,2030-01-16,Transport for London,4111,Transport,Transit,-4.84,GBP,-143242.03,POS,London,GB,4488,user_001,,
4b09d7f8-d3ca-4001-98d0-14ea102c4faf,2030-01-16,2030-01-18,Pret A Manger,5814,Food & Drink,Eating Out,-6.9,GBP,-143248.93,POS,London,GB,4488,user_001,,
0c2addf3-fefd-4678-a2a9-de26fc608239,2030-01-17,2030-01-18,Deliveroo,5812,Food & Drink,Delivery,-20.91,GBP,-143269.84,E-Com,London,GB,2219,user_001,,
42c26a0e-c48b-409f-85f4-051d32fc9729,2030-01-17,2030-01-18,Tesco,5411,Groceries,Supermarket,-43.22,GBP,-143313.06,POS,London,GB,2219,user_001,,
6bd51e77-b5c6-494f-8fc7-daf1d6a8f854,2030-01-17,2030-01-18,GymBox,7997,Wellness,Gym,-64.01,GBP,-143377.07,Direct Debit,London,GB,2219,user_001,rec_3906953fd2,
c70e6453-0e07-4f9d-be49-042fb784b931,2030-01-17,2030-01-21,Waitrose,5411,Groceries,Supermarket,-27.46,GBP,-143404.53,POS,London,GB,9074,user_002,,
35d0ba5f-8e62-45c4-ba98-7d3d68dbf9b1,2030-01-18,2030-01-18,Waitrose,5411,Groceries,Supermarket,-53.64,GBP,-143458.17,POS,London,GB,1045,user_002,,
d73caa33-ef4b-419b-b3b1-995aa9f7b86b,2030-01-18,2030-01-18,Transport for London,4111,Transport,Transit,-9.68,GBP,-143467.85,POS,London,GB,9074,user_001,,
1a4fe662-d6a4-4272-9756-d5aeacc17ffe,2030-01-19,2030-01-21,Uber UK,4121,Transport,Ride Hailing,-28.1,GBP,-143495.95,E-Com,London,GB,4488,user_001,,
01705352-862a-4e42-bd69-ca93afbaf4f4,2030-01-20,2030-01-21,Shell,5541,Transport,Fuel,-36.13,GBP,-143532.08,POS,London,GB,9074,user_001,,
2ac4ca07-346c-4119-af01-07ff9a35ea5f,2030-01-20,2030-01-21,Tesco,5411,Groceries,Supermarket,-44.46,GBP,-143576.54,POS,London,GB,1045,user_001,,
4a8d7fb5-b1d9-4728-8bef-6927928c5cb4,2030-01-20,2030-01-21,Local Market,5499,Groceries,Specialty,-6.69,GBP,-143583.23,POS,London,GB,4488,user_001,,
679bbe7f-b0ac-431f-a9b6-aac9a07cc951,2030-01-20,2030-01-21,Tesco,5411,Groceries,Supermarket,-65.16,GBP,-143648.39,POS,London,GB,2219,user_002,,
2a6cdd9d-c079-49ce-be5b-cd259fa78704,2030-01-21,2030-01-21,Tesco,5411,Groceries,Supermarket,-51.52,GBP,-143699.91,POS,London,GB,4488,user_001,,
4b455ae1-3acb-40c3-bcc0-f75ec7f653eb,2030-01-21,2030-01-22,Apple.com/bill,5734,Shopping,Electronics,-182.82,GBP,-143882.73,E-Com,Cupertino,US,1045,user_001,,
5cec5a79-f642-47ba-a98a-9df31b12d550,2030-01-21,2030-01-21,Uber UK,4121,Transport,Ride Hailing,-22.06,GBP,-143904.79,E-Com,London,GB,1045,user_001,,
769adb66-324e-47af-830e-bc2e2fecd268,2030-01-21,2030-01-23,Netflix,7841,Entertainment,Subscriptions,-15.06,GBP,-143919.85,E-Com,Los Gatos,US,9074,user_001,rec_1bfe33738d,
7e98505a-c655-42a5-89db-7a429a97b536,2030-01-21,2030-01-23,Amazon UK,5942,Shopping,Online Retail,-88.77,GBP,-144008.62,E-Com,London,GB,1045,user_001,,
faa44f7d-77c7-4d51-8559-afd30c351f22,2030-01-21,2030-01-22,Spotify,5735,Entertainment,Subscriptions,-8.37,GBP,-144016.99,E-Com,Stockholm,SE,2219,user_001,rec_4c746d2c3b,
22a061c8-09a3-4552-906c-04656acace2c,2030-01-22,2030-01-22,Transport for London,4111,Transport,Transit,-11.76,GBP,-144028.75,POS,London,GB,4488,user_001,,
41e7ea36-ae83-42ce-820a-e11c147edbc8,2030-01-22,2030-01-24,Transport for London,4111,Transport,Transit,-3.65,GBP,-144032.4,POS,London,GB,4488,user_001,,
68902e33-4d4c-4be2-9820-d18deb7831c6,2030-01-22,2030-01-23,Shell,5541,Transport,Fuel,-45.15,GBP,-144077.55,POS,London,GB,2219,user_001,,
caf1735f-a36a-467e-ab9a-48772462ca26,2030-01-22,2030-01-22,Shell,5541,Transport,Fuel,-84.0,GBP,-144161.55,POS,London,GB,2219,user_001,,
098bca39-6675-4968-8be7-ad5814e04956,2030-01-24,2030-01-28,Amazon UK,5942,Shopping,Online Retail,-84.99,GBP,-144246.54,E-Com,London,GB,1045,user_001,,
2b5bd2af-b749-47a0-9932-96d23f7864da,2030-01-24,2030-01-25,Shell,5541,Transport,Fuel,-37.09,GBP,-144283.63,POS,London,GB,2219,user_001,,
c70a9475-ddd6-4aff-89cf-53b1eb57bbfb,2030-01-24,2030-01-24,Uber UK,4121,Transport,Ride Hailing,-25.82,GBP,-144309.45,E-Com,London,GB,9074,user_001,,
8b808500-c050-4d06-a54e-fba91e0d15c2,2030-01-25,2030-01-25,T212 Capital,6011,Income,Salary,2851.5,GBP,-141457.95,Credit,London,GB,9074,user_001,rec_2ff8f778d0,
f60d7496-e152-4961-b4d8-fc6789abd1a6,2030-01-25,2030-01-28,Local Market,5499,Groceries,Specialty,-19.71,GBP,-141477.66,POS,London,GB,9074,user_001,,
415d4137-1ab5-4e99-868d-8a81a9dcc981,2030-01-26,2030-01-28,Deliveroo,5812,Food & Drink,Delivery,-17.46,GBP,-141495.12,E-Com,London,GB,4488,user_001,,
64cd8d5a-f24a-456d-83f3-e43326426159,2030-01-26,2030-01-28,Transport for London,4111,Transport,Transit,-10.64,GBP,-141505.76,POS,London,GB,2219,user_001,,
667dade7-19cb-43ae-98c8-5322f96fd1cd,2030-01-26,2030-01-28,Local Market,5499,Groceries,Specialty,-14.97,GBP,-141520.73,POS,London,GB,4488,user_001,,
f9dc81ab-ef59-412b-a234-c06eea839dbc,2030-01-26,2030-01-28,Sainsbury's,5411,Groceries,Supermarket,-43.21,GBP,-141563.94,POS,London,GB,4488,user_001,,
4137bbf4-c85d-4b92-a013-0bee41b4462e,2030-01-27,2030-01-29,Shell,5541,Transport,Fuel,-65.46,GBP,-141629.4,POS,London,GB,4488,user_001,,
6224dce5-4cc9-4d2e-9d41-1fa8a71b94c6,2030-01-27,2030-01-28,Waitrose,5411,Groceries,Supermarket,-82.95,GBP,-141712.35,POS,London,GB,1045,user_001,,
5fdb3b33-8681-4f69-9e07-28dba6dbf9d5,2030-01-29,2030-01-29,Sainsbury's,5411,Groceries,Supermarket,-42.68,GBP,-141755.03,POS,London,GB,9074,user_001,,
6a68a233-fb36-498c-89b2-afae86b179b1,2030-01-30,2030-01-30,Uber UK,4121,Transport,Ride Hailing,-22.05,GBP,-141777.08,E-Com,London,GB,1045,user_001,,
532ffd7b-872b-437b-9876-39806dc4e7d3,2030-01-31,2030-02-01,Apple.com/bill,5734,Shopping,Electronics,-61.45,GBP,-141838.53,E-Com,Cupertino,US,9074,user_001,,
6eff05f9-4437-476d-a34e-61db80ad8bdf,2030-01-31,2030-01-31,Transport for London,4111,Transport,Transit,-6.16,GBP,-141844.69,POS,London,GB,2219,user_001,,
c1b24cff-f27a-4eda-8f63-3c02a695b47d,2030-01-31,2030-01-31,Sainsbury's,5411,Groceries,Supermarket,-35.83,GBP,-141880.52,POS,London,GB,1045,user_002,,
ee588b00-7e9d-40c1-b91c-ab697d1e8aba,2030-01-31,2030-01-31,Deliveroo,5812,Food & Drink,Delivery,-12.52,GBP,-141893.04,E-Com,London,GB,2219,user_001,,
0448d9bb-262f-4b48-bfed-7b3f31631548,2030-02-01,2030-02-04,Local Market,5499,Groceries,Specialty,-11.75,GBP,-141904.79,POS,London,GB,2219,user_001,,
0e3bd300-5b0b-4e67-8952-7aac68039b4e,2030-02-01,2030-02-04,ATM Withdrawal,6011,Cash,ATM,-63.89,GBP,-141968.68,ATM,London,GB,9074,user_001,,
93f2889a-1f56-46ef-a9c9-415f7239bd11,2030-02-01,2030-02-04,Crown Estates Lettings,6513,Housing,Rent,-1607.64,GBP,-143576.32,POS,London,GB,4488,user_001,rec_19f70fbcce,
25137592-5863-4781-a3a5-1de82a863a78,2030-02-02,2030-02-04,Pret A Manger,5814,Food & Drink,Eating Out,-10.94,GBP,-143587.26,POS,London,GB,4488,user_001,,
b975c660-3d1b-470f-9d5b-13346ff818f2,2030-02-02,2030-02-04,Waitrose,5411,Groceries,Supermarket,-32.84,GBP,-143620.1,POS,London,GB,2219,user_002,,
dddb508f-8a0a-46ab-bf13-162737ae3efa,2030-02-02,2030-02-04,Pret A Manger,5814,Food & Drink,Eating Out,-7.25,GBP,-143627.35,POS,London,GB,9074,user_001,,
3a97ee6d-1bd3-4ef1-9559-406944b1cf66,2030-02-03,2030-02-04,Transport for London,4111,Transport,Transit,-8.96,GBP,-143636.31,POS,London,GB,4488,user_001,,
474a7746-2c2c-4ee8-9e24-e55a5b9b98f7,2030-02-03,2030-02-04,Amazon UK,5942,Shopping,Online Retail,-39.67,GBP,-143675.98,E-Com,London,GB,9074,user_001,,
55337db1-dfcb-4146-b1c8-95f1454cf2f6,2030-02-03,2030-02-05,Waitrose,5411,Groceries,Supermarket,-47.13,GBP,-143723.11,POS,London,GB,2219,user_002,,
a6e10317-2856-4dcb-aed2-0a0937205374,2030-02-03,2030-02-04,Amazon UK,5942,Shopping,Online Retail,-19.7,GBP,-143742.81,E-Com,London,GB,1045,user_002,,
ad2f8373-748c-482d-a495-b9677cef5f7f,2030-02-03,2030-02-05,Sainsbury's,5411,Groceries,Supermarket,-42.98,GBP,-143785.79,POS,London,GB,9074,user_002,,
f1e30a97-a3e9-490a-8e00-b50929e214a4,2030-02-03,2030-02-04,Waitrose,5411,Groceries,Supermarket,-48.77,GBP,-143834.56,POS,London,GB,1045,user_001,,
3d478314-a4c4-4f14-ab4a-a107d0031cd4,2030-02-04,2030-02-04,Shell,5541,Transport,Fuel,-65.69,GBP,-143900.25,POS,London,GB,9074,user_001,,
a3b407ef-ebc2-4e0e-b0c4-53c4a0d0f129,2030-02-04,2030-02-05,Pret A Manger,5814,Food & Drink,Eating Out,-6.67,GBP,-143906.92,POS,London,GB,1045,user_001,,
a790f451-df88-43aa-9a71-276932815c60,2030-02-04,2030-02-04,Pret A Manger,5814,Food & Drink,Eating Out,-7.89,GBP,-143914.81,POS,London,GB,1045,user_001,,
ff02bcc1-e3ea-4c6d-9851-ed8fa11d044c,2030-02-04,2030-02-06,Uber UK,4121,Transport,Ride Hailing,-15.75,GBP,-143930.56,E-Com,London,GB,2219,user_001,,
a2f375a6-04f2-443f-8fd2-8fcc430c6247,2030-02-05,2030-02-06,Sainsbury's,5411,Groceries,Supermarket,-21.95,GBP,-143952.51,POS,London,GB,9074,user_002,,
1cb538e2-c5d6-4ffc-acf5-f92c60cf0eda,2030-02-06,2030-02-08,Waitrose,5411,Groceries,Supermarket,-80.69,GBP,-144033.2,POS,London,GB,4488,user_001,,
3a8ac3dc-dfd7-455d-8e27-6ac493dc9da7,2030-02-06,2030-02-07,Shell,5541,Transport,Fuel,-33.56,GBP,-144066.76,POS,London,GB,9074,user_001,,
4f044fa2-0767-49f6-bd0b-d25f12a50945,2030-02-07,2030-02-11,Sainsbury's,5411,Groceries,Supermarket,-62.83,GBP,-144129.59,POS,London,GB,4488,user_001,,
5e1eef14-e701-4226-8a6a-4d7c4d66b856,2030-02-07,2030-02-11,Transport for London,4111,Transport,Transit,-5.03,GBP,-144134.62,POS,London,GB,2219,user_002,,
c0fd537e-13aa-4e71-85b7-b2aaef2ab51d,2030-02-07,2030-02-11,Sainsbury's,5411,Groceries,Supermarket,-23.64,GBP,-144158.26,POS,London,GB,9074,user_002,,
f75a669b-1dfc-46ad-9975-84517b92ce57,2030-02-07,2030-02-07,Octopus Energy,4900,Utilities,Electricity,-141.57,GBP,-144299.83,Direct Debit,London,GB,9074,user_001,rec_141a4a0666,
2feda4ea-233c-4655-acc5-9aacc4a2f3a2,2030-02-08,2030-02-11,Transport for London,4111,Transport,Transit,-6.39,GBP,-144306.22,POS,London,GB,4488,user_001,,
086079d2-3411-4d39-a3b7-c07e8118d85b,2030-02-09,2030-02-11,Shell,5541,Transport,Fuel,-30.54,GBP,-144336.76,POS,London,GB,2219,user_001,,
480fe6bf-1349-45d8-a622-34f6fbadfb7d,2030-02-09,2030-02-11,Transport for London,4111,Transport,Transit,-10.33,GBP,-144347.09,POS,London,GB,2219,user_002,,
883635ba-0856-451d-a1dc-fc3bf624bd34,2030-02-09,2030-02-11,Pret A Manger,5814,Food & Drink,Eating Out,-6.92,GBP,-144354.01,POS,London,GB,4488,user_001,,
9ad471fc-0946-4e19-80c1-9d33f7e028ae,2030-02-09,2030-02-11,Pret A Manger,5814,Food & Drink,Eating Out,-6.21,GBP,-144360.22,POS,London,GB,9074,user_001,,
a90fa158-d6f3-4e5e-92a1-2a04b9d7a183,2030-02-09,2030-02-11,Deliveroo,5812,Food & Drink,Delivery,-30.81,GBP,-144391.03,E-Com,London,GB,2219,user_001,,
df07e996-0624-40a2-9312-e1a8826ec543,2030-02-09,2030-02-11,Transport for London,4111,Transport,Transit,-7.07,GBP,-144398.1,POS,London,GB,2219,user_001,,
6856fef4-8d6e-4df7-a7e9-3c1f8ece2036,2030-02-10,2030-02-12,Waitrose,5411,Groceries,Supermarket,-42.34,GBP,-144440.44,POS,London,GB,1045,user_001,,
d15c91fc-4b81-45dc-9b2e-f700981837c5,2030-02-10,2030-02-12,Tesco,5411,Groceries,Supermarket,-48.66,GBP,-144489.1,POS,London,GB,9074,user_001,,
506cf677-f96e-4ce1-82f7-af4cd66f2aa2,2030-02-11,2030-02-12,Deliveroo,5812,Food & Drink,Delivery,-13.47,GBP,-144502.57,E-Com,London,GB,2219,user_001,,
556ec9bb-0b14-4fe9-a211-47f627b298e0,2030-02-11,2030-02-11,Thames Water,4900,Utilities,Water,-41.05,GBP,-144543.62,Direct Debit,Reading,GB,9074,user_002,rec_954d02400c,
6df1da35-d393-41c5-bff1-0a4bc268d69b,2030-02-11,2030-02-11,Uber UK,4121,Transport,Ride Hailing,-35.66,GBP,-144579.28,E-Com,London,GB,9074,user_001,,
7fbbe1fe-4be4-4010-a623-7d8d4f5bbefa,2030-02-11,2030-02-11,Transport for London,4111,Transport,Transit,-7.94,GBP,-144587.22,POS,London,GB,9074,user_001,,
553267ac-764c-4737-8064-b7002ca705c1,2030-02-12,2030-02-13,Uber UK,4121,Transport,Ride Hailing,-9.0,GBP,-144596.22,E-Com,London,GB,2219,user_001,,
6dc408b2-3ecc-477a-b855-aaba6758725d,2030-02-12,2030-02-12,Uber UK,4121,Transport,Ride Hailing,-14.0,GBP,-144610.22,E-Com,London,GB,9074,user_002,,
dc7cae42-b99b-4864-b94a-a82ec78d2e67,2030-02-12,2030-02-13,Tesco,5411,Groceries,Supermarket,-27.62,GBP,-144637.84,POS,London,GB,2219,user_001,,
ef7e4cab-bbac-4d90-b9e4-df4d0321c67c,2030-02-12,2030-02-12,Deliveroo,5812,Food & Drink,Delivery,-31.03,GBP,-144668.87,E-Com,London,GB,9074,user_001,,
0fe2a6c8-28b9-4e42-a635-4cd637fe8832,2030-02-13,2030-02-15,City Council Tax,9399,Utilities,Council Tax,-150.48,GBP,-144819.35,Direct Debit,London,GB,4488,user_001,rec_f531495db5,
e05a450a-90a0-4f95-a81f-00db89152f1e,2030-02-13,2030-02-15,Transport for London,4111,Transport,Transit,-9.34,GBP,-144828.69,POS,London,GB,9074,user_001,,
1b52ce07-b9af-495f-bffd-d76536e0b2ad,2030-02-14,2030-02-15,Shell,5541,Transport,Fuel,-54.92,GBP,-144883.61,POS,London,GB,9074,user_001,,
81f33b24-b190-4c79-824b-6cac56e5d25e,2030-02-15,2030-02-18,O2 UK,4814,Bills,Mobile,-51.5,GBP,-144935.11,Direct Debit,Slough,GB,9074,user_001,rec_95042d8101,
ac2781ca-e0be-48d7-93fb-4a73a2cc4ff6,2030-02-15,2030-02-18,Sainsbury's,5411,Groceries,Supermarket,-25.76,GBP,-144960.87,POS,London,GB,2219,user_001,,
9a946f42-cada-4266-b06b-7fe2ff895f7c,2030-02-16,2030-02-18,Sainsbury's,5411,Groceries,Supermarket,-37.39,GBP,-144998.26,POS,London,GB,4488,user_001,,
b9d30505-be99-4892-864e-55c96490f48b,2030-02-16,2030-02-18,Uber UK,4121,Transport,Ride Hailing,-19.75,GBP,-145018.01,E-Com,London,GB,2219,user_001,,
c7ad11cc-f963-466c-b737-83d3195f608c,2030-02-16,2030-02-18,Amazon UK,5942,Shopping,Online Retail,-95.58,GBP,-145113.59,E-Com,London,GB,4488,user_001,,
6ef746ea-8598-48d5-854c-2f0b92036d99,2030-02-17,2030-02-19,Pret A Manger,5814,Food & Drink,Eating Out,-7.13,GBP,-145120.72,POS,London,GB,2219,user_002,,
837106fe-f7bd-4e42-b0d9-fa9c91112165,2030-02-17,2030-02-18,Sainsbury's,5411,Groceries,Supermarket,-54.15,GBP,-145174.87,POS,London,GB,2219,user_001,,
0b2e485d-322d-4400-9d23-335c164a6733,2030-02-18,2030-02-19,Local Market,5499,Groceries,Specialty,-6.14,GBP,-145181.01,POS,London,GB,9074,user_002,,
0fb62e6a-ddf0-4cf1-b7f7-0544defea1e8,2030-02-18,2030-02-20,GymBox,7997,Wellness,Gym,-51.31,GBP,-145232.32,Direct Debit,London,GB,1045,user_001,rec_3906953fd2,
2cdeae46-ef6d-4988-bff6-1cfa9bed4a98,2030-02-18,2030-02-19,Amazon UK,5942,Shopping,Online Retail,-22.19,GBP,-145254.51,E-Com,London,GB,2219,user_001,,
53d74915-4a0e-4932-bed1-466082b1b6d4,2030-02-19,2030-02-20,Spotify,5735,Entertainment,Subscriptions,-9.34,GBP,-145263.85,E-Com,Stockholm,SE,1045,user_001,rec_4c746d2c3b,
98b3a73b-cb34-449f-b651-7cac290f67a2,2030-02-19,2030-02-21,Shell,5541,Transport,Fuel,-84.69,GBP,-145348.54,POS,London,GB,9074,user_002,,
e9afc165-f5d9-460d-911b-24d8f9c38992,2030-02-19,2030-02-21,Pret A Manger,5814,Food & Drink,Eating Out,-5.71,GBP,-145354.25,POS,London,GB,2219,user_001,,
738f3f98-65cd-4c4c-9f9f-7cbe2b544807,2030-02-20,2030-02-21,Transport for London,4111,Transport,Transit,-10.84,GBP,-145365.09,POS,London,GB,9074,user_001,,
88d6298d-c9c5-481e-8eeb-44784b0da85d,2030-02-20,2030-02-21,Tesco,5411,Groceries,Supermarket,-51.23,GBP,-145416.32,POS,London,GB,9074,user_001,,
da7376d3-57e9-4cfb-b66c-8e06f270e658,2030-02-20,2030-02-20,Apple.com/bill,5734,Shopping,Electronics,-34.97,USD,-145451.29,E-Com,Cupertino,US,9074,user_001,,FX purchase 43.74 USD @ rate 1.25
f32c6dd1-ad14-4d4d-b288-acdd6a9ed7f0,2030-02-20,2030-02-20,Pret A Manger,5814,Food & Drink,Eating Out,-8.54,GBP,-145459.83,POS,London,GB,2219,user_001,,
05cf2d37-3633-4fbe-87c8-ee046ad610c4,2030-02-21,2030-02-22,Netflix,7841,Entertainment,Subscriptions,-15.78,GBP,-145475.61,E-Com,Los Gatos,US,9074,user_001,rec_1bfe33738d,
5c925458-07ee-434f-94c3-9ced1068f274,2030-02-21,2030-02-22,Waitrose,5411,Groceries,Supermarket,-42.85,GBP,-145518.46,POS,London,GB,4488,user_001,,
1c21bf84-9a46-474c-ac15-9c56ac111863,2030-02-22,2030-02-22,Transport for London,4111,Transport,Transit,-10.43,GBP,-145528.89,POS,London,GB,9074,user_001,,
d477d627-eaed-42e5-8226-bd3902829346,2030-02-22,2030-02-25,Deliveroo,5812,Food & Drink,Delivery,-32.52,GBP,-145561.41,E-Com,London,GB,9074,user_002,,
15562963-0fba-47dd-b38d-c6271ecc13b1,2030-02-23,2030-02-25,Uber UK,4121,Transport,Ride Hailing,-13.56,GBP,-145574.97,E-Com,London,GB,2219,user_001,,
2b377d55-0403-4119-bf59-cb22c7ab5e90,2030-02-23,2030-02-25,Apple.com/bill,5734,Shopping,Electronics,-61.71,GBP,-145636.68,E-Com,Cupertino,US,9074,user_001,,
bf3f6437-09ff-4cd0-8ca6-affc131a3ef2,2030-02-23,2030-02-25,Pret A Manger,5814,Food & Drink,Eating Out,-9.56,GBP,-145646.24,POS,London,GB,4488,user_001,,
d00ebfb5-1d7d-413b-9ecd-beb243d1ab23,2030-02-23,2030-02-25,Tesco,5411,Groceries,Supermarket,-56.84,GBP,-145703.08,POS,London,GB,2219,user_002,,
11906fbd-688c-4bbd-ac77-ce4089e36d76,2030-02-24,2030-02-25,Transport for London,4111,Transport,Transit,-11.56,GBP,-145714.64,POS,London,GB,2219,user_001,,
5eb4fe0a-ad43-4441-a914-c19716ea1664,2030-02-24,2030-02-26,Uber UK,4121,Transport,Ride Hailing,-18.84,GBP,-145733.48,E-Com,London,GB,4488,user_001,,
8349c8e2-137b-498a-bafd-e4fcff2a2b30,2030-02-24,2030-02-25,Local Market,5499,Groceries,Specialty,-13.91,GBP,-145747.39,POS,London,GB,9074,user_001,,
9b11f716-ac21-4d52-ae80-c64065fc7a72,2030-02-24,2030-02-25,Tesco,5411,Groceries,Supermarket,-42.41,GBP,-145789.8,POS,London,GB,2219,user_001,,
e44d3e72-0a5d-41fd-b83a-c54c6b123294,2030-02-24,2030-02-26,Pret A Manger,5814,Food & Drink,Eating Out,-9.48,GBP,-145799.28,POS,London,GB,9074,user_002,,
4a529ad2-da65-46c9-a58f-b4d0ceb2e528,2030-02-25,2030-02-25,Airline Refund,4511,Travel,Refund,29.04,GBP,-145770.24,Credit,London,GB,1045,user_001,,Refund for Tesco
91618e81-f8f9-4eb5-9fb2-ca080cddd62f,2030-02-25,2030-02-25,Transport for London,4111,Transport,Transit,-10.18,GBP,-145780.42,POS,London,GB,9074,user_001,,
e4333be6-2438-4cb7-8dee-bf25c3b7a194,2030-02-25,2030-02-25,T212 Capital,6011,Income,Salary,3356.81,GBP,-142423.61,Credit,London,GB,2219,user_001,rec_2ff8f778d0,
02610998-1f98-4f33-a4a2-7698702f552f,2030-02-26,2030-02-28,Pret A Manger,5814,Food & Drink,Eating Out,-6.01,GBP,-142429.62,POS,London,GB,1045,user_001,,
0bf2a4db-5872-41fe-b16b-5ddde60549a1,2030-02-27,2030-02-28,Apple.com/bill,5734,Shopping,Electronics,-67.44,USD,-142497.06,E-Com,Cupertino,US,9074,user_001,,FX purchase 84.7 USD @ rate 1.26
3b83f595-a4ea-45af-aa01-6b902f990f38,2030-02-27,2030-02-28,Amazon UK,5942,Shopping,Online Retail,-67.34,GBP,-142564.4,E-Com,London,GB,4488,user_001,,
42d5fec5-eb45-4802-a6b3-eb331d5d482c,2030-02-27,2030-02-28,Apple.com/bill,5734,Shopping,Electronics,-82.89,GBP,-142647.29,E-Com,Cupertino,US,9074,user_001,,
9b2109be-3672-477f-9681-9b656e837370,2030-02-27,2030-02-28,Tesco,5411,Groceries,Supermarket,-36.55,GBP,-142683.84,POS,London,GB,2219,user_001,,
e8a9b2f5-c34d-47cc-b66e-c06be43e1397,2030-02-27,2030-02-27,Uber UK,4121,Transport,Ride Hailing,-16.83,GBP,-142700.67,E-Com,London,GB,2219,user_001,,
02928c0d-0348-4d83-b282-f8023af2ef4e,2030-02-28,2030-02-28,Shell,5541,Transport,Fuel,-44.9,GBP,-142745.57,POS,London,GB,4488,user_001,,
2c8105c0-6f09-4602-a18c-c4648ff7d7d2,2030-02-28,2030-03-04,Amazon UK,5942,Shopping,Online Retail,-51.72,GBP,-142797.29,E-Com,London,GB,2219,user_001,,
653c4576-df0d-4ae8-95d9-e321d8b3f1a3,2030-03-01,2030-03-04,Shell,5541,Transport,Fuel,-77.36,GBP,-142874.65,POS,London,GB,2219,user_001,,
e4c467c4-0e87-43b3-8897-0680e8b38d33,2030-03-01,2030-03-01,Crown Estates Lettings,6513,Housing,Rent,-1483.23,GBP,-144357.88,POS,London,GB,1045,user_001,rec_19f70fbcce,
3cda4638-c3e9-4b42-88e3-dcd1524f1486,2030-03-02,2030-03-04,Apple.com/bill,5734,Shopping,Electronics,-72.88,GBP,-144430.76,E-Com,Cupertino,US,1045,user_001,,
41080832-30cc-4819-82bc-0d7d27e23197,2030-03-02,2030-03-04,Tesco,5411,Groceries,Supermarket,-22.86,GBP,-144453.62,POS,London,GB,2219,user_002,,
48e3b103-5972-4a15-b14f-ccb214176ea2,2030-03-02,2030-03-04,Tesco,5411,Groceries,Supermarket,-33.39,GBP,-144487.01,POS,London,GB,9074,user_001,,
999388a2-8a87-40d7-bb51-8d2fbece3fb1,2030-03-02,2030-03-04,Amazon UK,5942,Shopping,Online Retail,-70.71,GBP,-144557.72,E-Com,London,GB,1045,user_001,,
1c8cba8a-0ee7-4841-9e07-fb2ba37c76b4,2030-03-03,2030-03-05,Deliveroo,5812,Food & Drink,Delivery,-24.4,GBP,-144582.12,E-Com,London,GB,4488,user_001,,
584ee23a-f04f-45a6-a59e-4c9bb832b3db,2030-03-03,2030-03-04,Tesco,5411,Groceries,Supermarket,-28.47,GBP,-144610.59,POS,London,GB,2219,user_001,,
5ffadced-c76b-458f-a24b-04737ee0df21,2030-03-03,2030-03-04,Tesco,5411,Groceries,Supermarket,-71.38,GBP,-144681.97,POS,London,GB,4488,user_001,,
bb8182bf-9bb8-452a-a750-acc36441ad3b,2030-03-03,2030-03-04,Amazon UK,5942,Shopping,Online Retail,-84.42,GBP,-144766.39,E-Com,London,GB,1045,user_001,,
c58efc66-7971-41de-b067-4b909091d9bc,2030-03-03,2030-03-04,Pret A Manger,5814,Food & Drink,Eating Out,-6.15,GBP,-144772.54,POS,London,GB,1045,user_001,,
d49a0604-e504-4084-8d63-ce05139b2e25,2030-03-04,2030-03-06,Amazon UK,5942,Shopping,Online Retail,-67.4,GBP,-144839.94,E-Com,London,GB,9074,user_002,,
4a873d9d-e4e7-4aad-9de1-7cb48a7b4cd5,2030-03-06,2030-03-08,Local Market,5499,Groceries,Specialty,-11.57,GBP,-144851.51,POS,London,GB,4488,user_001,,
9d7c27f5-1bc5-48d4-b034-ead3f909d9cf,2030-03-06,2030-03-06,Sainsbury's,5411,Groceries,Supermarket,-26.52,GBP,-144878.03,POS,London,GB,1045,user_001,,
1b8d003c-0f4e-427f-993e-ec7f7a57c6a7,2030-03-07,2030-03-08,Pret A Manger,5814,Food & Drink,Eating Out,-7.32,GBP,-144885.35,POS,London,GB,2219,user_002,,
28765d4c-888a-46b6-9f48-c4c8ace95fea,2030-03-07,2030-03-08,Tesco,5411,Groceries,Supermarket,-55.5,GBP,-144940.85,POS,London,GB,9074,user_001,,
6289bc05-8882-423c-a326-6c6dc6ca70f6,2030-03-07,2030-03-08,Octopus Energy,4900,Utilities,Electricity,-110.94,GBP,-145051.79,Direct Debit,London,GB,1045,user_001,rec_141a4a0666,
67a8a046-cbac-4bb4-abca-776873e2d000,2030-03-07,2030-03-08,Shell,5541,Transport,Fuel,-85.95,GBP,-145137.74,POS,London,GB,1045,user_001,,
9fc25d7f-68e0-41c0-9082-6cdc391d1248,2030-03-07,2030-03-07,Waitrose,5411,Groceries,Supermarket,-61.77,GBP,-145199.51,POS,London,GB,2219,user_001,,
e57d01af-1a61-47a0-8321-ee1167b6a4b7,2030-03-07,2030-03-08,Shell,5541,Transport,Fuel,-85.15,GBP,-145284.66,POS,London,GB,1045,user_001,,
2a43b172-a280-40ef-9cb7-68cc9c7a90b4,2030-03-08,2030-03-11,Amazon UK,5942,Shopping,Online Retail,-118.95,GBP,-145403.61,E-Com,London,GB,9074,user_001,,
c890d74b-7895-436a-8397-d23fea80efb9,2030-03-08,2030-03-11,Shell,5541,Transport,Fuel,-42.86,GBP,-145446.47,POS,London,GB,4488,user_001,,
2e9f4309-d71f-4ce1-a3b7-232962929bc3,2030-03-09,2030-03-11,Uber UK,4121,Transport,Ride Hailing,-29.61,GBP,-145476.08,E-Com,London,GB,9074,user_001,,
8b5ffd90-4f5d-4958-af7a-759cc4ac8474,2030-03-09,2030-03-11,Amazon UK,5942,Shopping,Online Retail,-83.04,GBP,-145559.12,E-Com,London,GB,9074,user_001,,
8d306472-09ad-44bf-837a-ec1dc75cbf02,2030-03-09,2030-03-11,Deliveroo,5812,Food & Drink,Delivery,-23.92,GBP,-145583.04,E-Com,London,GB,4488,user_001,,
8e14b967-74fa-4be3-9594-ed2b8bd6e55f,2030-03-09,2030-03-11,Amazon UK,5942,Shopping,Online Retail,-50.88,GBP,-145633.92,E-Com,London,GB,2219,user_002,,
9e6b9851-43b8-4fbf-bb22-25d23f6029e4,2030-03-09,2030-03-11,Deliveroo,5812,Food & Drink,Delivery,-16.47,GBP,-145650.39,E-Com,London,GB,4488,user_001,,
d6be23d3-f171-4edc-a998-a7e2d150db63,2030-03-09,2030-03-11,Apple.com/bill,5734,Shopping,Electronics,-171.4,GBP,-145821.79,E-Com,Cupertino,US,9074,user_001,,
56bc18d6-0499-4d72-8acd-073aaf81cf09,2030-03-10,2030-03-11,Local Market,5499,Groceries,Specialty,-11.03,GBP,-145832.82,POS,London,GB,2219,user_001,,
7e258d6b-2ea3-4ecc-9be6-871484ed2219,2030-03-10,2030-03-11,Waitrose,5411,Groceries,Supermarket,-84.93,GBP,-145917.75,POS,London,GB,2219,user_001,,
83e60f95-2556-4f8d-a12f-4d3b9d29d366,2030-03-10,2030-03-11,Deliveroo,5812,Food & Drink,Delivery,-28.94,GBP,-145946.69,E-Com,London,GB,4488,user_002,,
1fd082ef-2192-46e3-92da-9a8a829e4ad7,2030-03-11,2030-03-11,Thames Water,4900,Utilities,Water,-33.62,GBP,-145980.31,Direct Debit,Reading,GB,9074,user_001,rec_3a34d62842,
2b1448d4-3c7d-484f-a2ce-2a13ccedaa8b,2030-03-11,2030-03-12,Apple.com/bill,5734,Shopping,Electronics,-168.9,GBP,-146149.21,E-Com,Cupertino,US,2219,user_002,,
99a903ae-6441-4361-9d93-b622fe304b27,2030-03-11,2030-03-12,Sainsbury's,5411,Groceries,Supermarket,-51.07,GBP,-146200.28,POS,London,GB,4488,user_001,,
5be4c30d-c890-487c-bc9f-0e8907a61e44,2030-03-12,2030-03-14,British Airways,4511,Travel,Flights,-397.94,GBP,-146598.22,E-Com,London,GB,9074,user_001,,Business travel
9ed78a71-f816-43ca-9fdd-4eb8c1317e89,2030-03-12,2030-03-12,Deliveroo,5812,Food & Drink,Delivery,-22.06,GBP,-146620.28,E-Com,London,GB,2219,user_002,,
2d21d829-18a4-472a-8741-352e3881b6bf,2030-03-13,2030-03-14,City Council Tax,9399,Utilities,Council Tax,-170.73,GBP,-146791.01,Direct Debit,London,GB,9074,user_001,rec_f531495db5,
fcc567b1-eef4-4b05-9503-ff7e18701a56,2030-03-13,2030-03-13,Tesco,5411,Groceries,Supermarket,-34.58,GBP,-146825.59,POS,London,GB,2219,user_001,,
6c399a4a-0af0-41ee-872e-473ffa3a7ac6,2030-03-14,2030-03-14,Airline Refund,4511,Travel,Refund,47.09,GBP,-146778.5,Credit,London,GB,4488,user_001,,Refund for Amazon UK
d8d923df-55bf-4906-a400-6ee8f43453c4,2030-03-14,2030-03-14,Shell,5541,Transport,Fuel,-61.98,GBP,-146840.48,POS,London,GB,9074,user_001,,
1b24d341-c081-4832-8800-b58e225072fd,2030-03-15,2030-03-18,Amazon UK,5942,Shopping,Online Retail,-64.61,GBP,-146905.09,E-Com,London,GB,4488,user_001,,
4ed66a97-3864-4577-a518-f8ed292da1ff,2030-03-15,2030-03-18,O2 UK,4814,Bills,Mobile,-45.22,GBP,-146950.31,Direct Debit,Slough,GB,9074,user_001,rec_95042d8101,
ece8c5e3-abf8-4515-986a-0e0996f591f2,2030-03-15,2030-03-18,Pret A Manger,5814,Food & Drink,Eating Out,-9.14,GBP,-146959.45,POS,London,GB,2219,user_001,,
dc4c7255-8f18-4956-bf6b-9bfe76f47ef6,2030-03-16,2030-03-18,Uber UK,4121,Transport,Ride Hailing,-14.06,GBP,-146973.51,E-Com,London,GB,9074,user_001,,
3430a122-f6d7-4e20-8adb-04223856aa33,2030-03-17,2030-03-18,Amazon UK,5942,Shopping,Online Retail,-90.81,GBP,-147064.32,E-Com,London,GB,9074,user_001,,
6b16038d-e7f9-4f8e-b573-dd8ddf80027c,2030-03-17,2030-03-18,Waitrose,5411,Groceries,Supermarket,-32.24,GBP,-147096.56,POS,London,GB,4488,user_001,,
e88af149-52ac-431d-b47f-dd384b2726d3,2030-03-17,2030-03-18,Tesco,5411,Groceries,Supermarket,-84.25,GBP,-147180.81,POS,London,GB,1045,user_001,,
0b404da2-0bff-4166-8f74-a2e22e4159a1,2030-03-18,2030-03-19,GymBox,7997,Wellness,Gym,-55.9,GBP,-147236.71,Direct Debit,London,GB,1045,user_001,rec_3906953fd2,
e2b775fc-15d0-41c1-9ff7-8a938e7e53c6,2030-03-18,2030-03-18,Pret A Manger,5814,Food & Drink,Eating Out,-8.86,GBP,-147245.57,POS,London,GB,9074,user_001,,
4984c4c3-5e45-4343-86e9-81e3c1c1dc03,2030-03-19,2030-03-20,Pret A Manger,5814,Food & Drink,Eating Out,-6.27,GBP,-147251.84,POS,London,GB,1045,user_001,,
58326a98-fb57-4a1e-8033-f5333d9dc41d,2030-03-19,2030-03-21,Spotify,5735,Entertainment,Subscriptions,-9.71,GBP,-147261.55,E-Com,Stockholm,SE,4488,user_001,rec_4c746d2c3b,
ca989c6b-51c6-4453-bcd9-0700b53a02ad,2030-03-19,2030-03-21,Shell,5541,Transport,Fuel,-33.74,GBP,-147295.29,POS,London,GB,1045,user_001,,
e3cee27a-89e4-4552-a988-1e66ade866e2,2030-03-19,2030-03-20,Amazon UK,5942,Shopping,Online Retail,-106.81,GBP,-147402.1,E-Com,London,GB,9074,user_001,,
f42531df-131b-4753-b398-ca5038f9fc6b,2030-03-19,2030-03-20,Waitrose,5411,Groceries,Supermarket,-69.16,GBP,-147471.26,POS,London,GB,9074,user_001,,
4bc20799-7f06-4190-90c7-adcf725cf4fd,2030-03-20,2030-03-20,Local Market,5499,Groceries,Specialty,-13.88,GBP,-147485.14,POS,London,GB,4488,user_002,,
6b4847d2-dd1d-4424-8cea-2228772b2a2c,2030-03-20,2030-03-20,Waitrose,5411,Groceries,Supermarket,-84.12,GBP,-147569.26,POS,London,GB,9074,user_001,,
979d7b8b-37c1-499c-b140-cbe56eeb27c4,2030-03-20,2030-03-20,Amazon UK,5942,Shopping,Online Retail,-101.52,GBP,-147670.78,E-Com,London,GB,9074,user_001,,
287b2c1d-9a7b-43f8-ab95-34d38213b7fa,2030-03-21,2030-03-25,Netflix,7841,Entertainment,Subscriptions,-10.46,GBP,-147681.24,E-Com,Los Gatos,US,9074,user_001,rec_1bfe33738d,
7f871ca9-784d-4fa4-bc9b-d606066431c6,2030-03-21,2030-03-25,Amazon UK,5942,Shopping,Online Retail,-73.54,GBP,-147754.78,E-Com,London,GB,4488,user_001,,
df48aa8e-2d4a-454f-94bc-29569b7032ab,2030-03-21,2030-03-22,Pret A Manger,5814,Food & Drink,Eating Out,-9.51,GBP,-147764.29,POS,London,GB,9074,user_001,,
dfd3c423-407f-41bb-b3fe-bd569af5e27f,2030-03-21,2030-03-21,Sainsbury's,5411,Groceries,Supermarket,-34.78,GBP,-147799.07,POS,London,GB,1045,user_001,,
f136313a-7b7c-4f2d-a87e-2f5036d93fd7,2030-03-21,2030-03-21,Sainsbury's,5411,Groceries,Supermarket,-38.78,GBP,-147837.85,POS,London,GB,1045,user_001,,
78f3f7c3-4919-43f1-a39a-dc3082bde84f,2030-03-22,2030-03-22,Amazon UK,5942,Shopping,Online Retail,-17.87,GBP,-147855.72,E-Com,London,GB,1045,user_001,,
7bea2cf7-cc96-46fd-bb30-60cd12311d8b,2030-03-22,2030-03-25,Uber UK,4121,Transport,Ride Hailing,-25.13,GBP,-147880.85,E-Com,London,GB,2219,user_001,,
91769d18-79ce-4b53-9572-1a543dc215a3,2030-03-23,2030-03-25,Amazon UK,5942,Shopping,Online Retail,-47.09,GBP,-147927.94,E-Com,London,GB,1045,user_001,,
c989bf85-3706-42d1-a508-a53741be6a22,2030-03-23,2030-03-25,Sainsbury's,5411,Groceries,Supermarket,-30.27,GBP,-147958.21,POS,London,GB,4488,user_001,,
d2a8f09e-64bd-4329-82f2-ab4c7c2fe58b,2030-03-23,2030-03-25,Uber UK,4121,Transport,Ride Hailing,-30.3,GBP,-147988.51,E-Com,London,GB,9074,user_001,,
df226ce9-49aa-46ec-abe6-f8a2055ac9f3,2030-03-23,2030-03-25,Deliveroo,5812,Food & Drink,Delivery,-23.61,GBP,-148012.12,E-Com,London,GB,1045,user_001,,
4a1e86d4-e6f1-4f62-9fb9-74f066bc1ce3,2030-03-24,2030-03-26,Shell,5541,Transport,Fuel,-39.24,GBP,-148051.36,POS,London,GB,9074,user_001,,
93e30291-2e22-4fba-85f4-2b7e404258ab,2030-03-24,2030-03-26,Pret A Manger,5814,Food & Drink,Eating Out,-11.72,GBP,-148063.08,POS,London,GB,1045,user_001,,
c673ab37-b186-4e1d-815f-1f155ea6670b,2030-03-24,2030-03-25,Shell,5541,Transport,Fuel,-88.52,GBP,-148151.6,POS,London,GB,2219,user_001,,
cdb0a6dc-e26c-4404-a303-efe799f9ba72,2030-03-24,2030-03-25,Pret A Manger,5814,Food & Drink,Eating Out,-10.67,GBP,-148162.27,POS,London,GB,9074,user_001,,
38eda9c6-be3d-4ff1-895c-3d66bdec737b,2030-03-25,2030-03-25,T212 Capital,6011,Income,Salary,3332.16,GBP,-144830.11,Credit,London,GB,9074,user_001,rec_2ff8f778d0,
81a26062-47ed-4189-89a8-8dbe4a9f46a1,2030-03-26,2030-03-27,Sainsbury's,5411,Groceries,Supermarket,-50.63,GBP,-144880.74,POS,London,GB,2219,user_001,,
05373ee2-ea84-452f-8e8f-970d464417f9,2030-03-27,2030-03-29,Local Market,5499,Groceries,Specialty,-13.23,GBP,-144893.97,POS,London,GB,9074,user_001,,
5ac212fc-4fe9-416f-828f-acdc5750bb8b,2030-03-27,2030-03-28,Local Market,5499,Groceries,Specialty,-19.1,GBP,-144913.07,POS,London,GB,1045,user_001,,
0bc4e446-4284-40ae-a881-b9e3fe7f88f3,2030-03-28,2030-03-29,Shell,5541,Transport,Fuel,-86.87,GBP,-144999.94,POS,London,GB,1045,user_001,,
681656c4-0169-480f-a36f-25891bda06eb,2030-03-28,2030-03-28,Waitrose,5411,Groceries,Supermarket,-34.34,GBP,-145034.28,POS,London,GB,2219,user_001,,
bfe92885-5c7b-4909-9d2d-2138dc32e379,2030-03-28,2030-04-01,Deliveroo,5812,Food & Drink,Delivery,-18.27,GBP,-145052.55,E-Com,London,GB,9074,user_002,,
d31bf95b-88a6-48a5-ae3d-e4f82ffea7bb,2030-03-29,2030-04-01,Amazon UK,5942,Shopping,Online Retail,-62.32,GBP,-145114.87,E-Com,London,GB,1045,user_002,,
481d035c-706a-4720-a616-81c817aabc09,2030-03-30,2030-04-01,Transport for London,4111,Transport,Transit,-5.09,GBP,-145119.96,POS,London,GB,9074,user_001,,
5d81e73a-2a1c-4410-8836-939edbbe5a63,2030-03-30,2030-04-01,Tesco,5411,Groceries,Supermarket,-48.27,GBP,-145168.23,POS,London,GB,2219,user_001,,
14e3b488-7b92-486b-aa53-f0a61ad418d2,2030-03-31,2030-04-01,Amazon UK,5942,Shopping,Online Retail,-101.79,GBP,-145270.02,E-Com,London,GB,9074,user_001,,
3125dfaf-b823-414a-a8ef-8eeab904a16e,2030-03-31,2030-04-02,Local Market,5499,Groceries,Specialty,-12.57,GBP,-145282.59,POS,London,GB,1045,user_001,,
7d3fd5b8-4b2b-490e-96cb-5bc57d3c5141,2030-03-31,2030-04-01,Tesco,5411,Groceries,Supermarket,-72.89,GBP,-145355.48,POS,London,GB,9074,user_001,,
f276c384-8005-429f-9def-d9b627b37dcc,2030-03-31,2030-04-02,Uber UK,4121,Transport,Ride Hailing,-9.89,GBP,-145365.37,E-Com,London,GB,1045,user_001,,
3a8fbcb8-4882-4666-bc67-75ca16ceee1d,2030-04-01,2030-04-02,Local Market,5499,Groceries,Specialty,-17.91,GBP,-145383.28,POS,London,GB,4488,user_001,,
40683b30-823b-4f8a-adb1-791769c89e23,2030-04-01,2030-04-03,Crown Estates Lettings,6513,Housing,Rent,-1510.77,GBP,-146894.05,POS,London,GB,9074,user_001,rec_19f70fbcce,
9f6be260-3458-424c-923c-60f43f5d3019,2030-04-01,2030-04-01,Transport for London,4111,Transport,Transit,-7.89,GBP,-146901.94,POS,London,GB,2219,user_001,,
e9bd54ae-5152-4bd5-8206-fd9ead4cbc28,2030-04-01,2030-04-02,Tesco,5411,Groceries,Supermarket,-28.95,GBP,-146930.89,POS,London,GB,1045,user_002,,
faa8e7bf-66c6-49a0-8f89-cb4363418b2e,2030-04-01,2030-04-03,Amazon UK,5942,Shopping,Online Retail,-89.88,GBP,-147020.77,E-Com,London,GB,2219,user_001,,
2efd40d3-4fc4-4176-ac27-324c6fdac8fd,2030-04-02,2030-04-02,Local Market,5499,Groceries,Specialty,-13.41,GBP,-147034.18,POS,London,GB,4488,user_001,,
43445485-1673-4a92-ac60-a95eddd29809,2030-04-02,2030-04-04,Amazon UK,5942,Shopping,Online Retail,-24.93,GBP,-147059.11,E-Com,London,GB,4488,user_002,,
9dbaf811-ad5e-4259-838f-a8fd4e44899f,2030-04-02,2030-04-03,Deliveroo,5812,Food & Drink,Delivery,-15.67,GBP,-147074.78,E-Com,London,GB,9074,user_001,,
9f1303b2-8754-48a7-ab52-23fa89114f6a,2030-04-02,2030-04-04,Transport for London,4111,Transport,Transit,-8.43,GBP,-147083.21,POS,London,GB,4488,user_002,,
b4eead9c-a603-4201-b82c-3e3bf423c236,2030-04-02,2030-04-03,Pret A Manger,5814,Food & Drink,Eating Out,-9.4,GBP,-147092.61,POS,London,GB,9074,user_001,,
b51bcfff-748b-4c89-b95d-f3f34959e7d7,2030-04-02,2030-04-03,ATM Withdrawal,6011,Cash,ATM,-115.0,GBP,-147207.61,ATM,London,GB,1045,user_001,,
4775992e-a326-4d98-bbdd-6cee131150a9,2030-04-03,2030-04-03,Shell,5541,Transport,Fuel,-84.0,GBP,-147291.61,POS,London,GB,2219,user_001,,
8630d5ce-1168-4e19-a196-00eac5d92330,2030-04-03,2030-04-05,Waitrose,5411,Groceries,Supermarket,-83.88,GBP,-147375.49,POS,London,GB,4488,user_001,,
b10494df-253a-4400-aabe-f3823912ce4b,2030-04-03,2030-04-03,Amazon UK,5942,Shopping,Online Retail,-41.57,GBP,-147417.06,E-Com,London,GB,4488,user_001,,
ed9a9219-aaf5-4602-a586-c2e93420d3f8,2030-04-04,2030-04-08,Shell,5541,Transport,Fuel,-76.73,GBP,-147493.79,POS,London,GB,2219,user_002,,
f8414b82-1fdc-48ae-abb6-afe782b38ae9,2030-04-04,2030-04-05,Transport for London,4111,Transport,Transit,-9.33,GBP,-147503.12,POS,London,GB,4488,user_001,,
1473de04-4f61-4b36-8992-398013737085,2030-04-05,2030-04-08,Waitrose,5411,Groceries,Supermarket,-66.79,GBP,-147569.91,POS,London,GB,2219,user_001,,
2ca2d8b9-e38a-4d14-9493-c4c40c8ac1c1,2030-04-05,2030-04-05,Airline Refund,4511,Travel,Refund,73.74,GBP,-147496.17,Credit,London,GB,9074,user_001,,Refund for Waitrose
4bac9a3a-fc37-4dcf-ad5c-baf2228d8db4,2030-04-06,2030-04-08,Sainsbury's,5411,Groceries,Supermarket,-31.66,GBP,-147527.83,POS,London,GB,4488,user_001,,
82ab5681-3c4f-4af7-ab77-d559be063439,2030-04-06,2030-04-08,Amazon UK,5942,Shopping,Online Retail,-29.64,GBP,-147557.47,E-Com,London,GB,2219,user_001,,
8a6a173d-0c59-4ce7-8ca3-43785232ccd3,2030-04-06,2030-04-08,Apple.com/bill,5734,Shopping,Electronics,-141.76,USD,-147699.23,E-Com,Cupertino,US,1045,user_001,,FX purchase 176.68 USD @ rate 1.25
9d7993d6-fb70-4908-b08d-230a842ad694,2030-04-06,2030-04-08,Apple.com/bill,5734,Shopping,Electronics,-10.15,GBP,-147709.38,E-Com,Cupertino,US,9074,user_002,,
d1a5b15a-5f1a-4bdf-8cf1-2a24f7319391,2030-04-06,2030-04-08,Deliveroo,5812,Food & Drink,Delivery,-26.27,GBP,-147735.65,E-Com,London,GB,1045,user_001,,
73c34423-f4a9-4e75-987c-b80dc4a23ee1,2030-04-07,2030-04-08,Apple.com/bill,5734,Shopping,Electronics,-77.02,GBP,-147812.67,E-Com,Cupertino,US,1045,user_002,,
a79a2ee8-3bf5-45f1-bcc6-a35b39337921,2030-04-07,2030-04-08,Tesco,5411,Groceries,Supermarket,-53.17,GBP,-147865.84,POS,London,GB,9074,user_001,,
bb09f690-5240-4178-92ee-6a7fdd857241,2030-04-07,2030-04-08,Waitrose,5411,Groceries,Supermarket,-55.04,GBP,-147920.88,POS,London,GB,2219,user_001,,
2fc3810a-ed7b-46ca-8ccc-a28a794e5b6f,2030-04-08,2030-04-09,Octopus Energy,4900,Utilities,Electricity,-125.37,GBP,-148046.25,Direct Debit,London,GB,1045,user_001,rec_141a4a0666,
f4a42828-eed7-48e7-9ede-e208f013f886,2030-04-10,2030-04-12,Tesco,5411,Groceries,Supermarket,-32.07,GBP,-148078.32,POS,London,GB,9074,user_001,,
1250b05e-2105-42f7-b04f-e13b9dbb2ab0,2030-04-11,2030-04-15,Apple.com/bill,5734,Shopping,Electronics,-24.64,GBP,-148102.96,E-Com,Cupertino,US,4488,user_001,,
6ea7bf6c-1859-4024-9eff-6efaddfb7b94,2030-04-11,2030-04-12,Thames Water,4900,Utilities,Water,-36.38,GBP,-148139.34,Direct Debit,Reading,GB,4488,user_001,rec_3a34d62842,
f7603d5d-48f7-4ba3-8797-3bd7dc1e8ae8,2030-04-11,2030-04-15,Transport for London,4111,Transport,Transit,-7.76,GBP,-148147.1,POS,London,GB,9074,user_002,,
c9066c68-822f-4b54-b6b5-b4c94afe63e8,2030-04-12,2030-04-15,Pret A Manger,5814,Food & Drink,Eating Out,-8.15,GBP,-148155.25,POS,London,GB,1045,user_001,,
3c3e8b3f-82e4-4ba2-99f7-af1778e74b39,2030-04-13,2030-04-15,Sainsbury's,5411,Groceries,Supermarket,-62.81,GBP,-148218.06,POS,London,GB,9074,user_001,,
7cb33f24-8482-435d-938f-0c35ab95e8be,2030-04-13,2030-04-15,Shell,5541,Transport,Fuel,-32.54,GBP,-148250.6,POS,London,GB,4488,user_001,,
094dbfb5-dc86-4308-b72e-3315215ccd24,2030-04-14,2030-04-16,Deliveroo,5812,Food & Drink,Delivery,-15.0,GBP,-148265.6,E-Com,London,GB,4488,user_001,,
bca0bc58-3dc8-43c0-9673-6046db9f5307,2030-04-14,2030-04-16,Sainsbury's,5411,Groceries,Supermarket,-14.13,GBP,-148279.73,POS,London,GB,1045,user_001,,
f768ae5b-52eb-4f24-bd0e-1d90cd7cf138,2030-04-14,2030-04-16,Tesco,5411,Groceries,Supermarket,-32.66,GBP,-148312.39,POS,London,GB,1045,user_002,,
1b7564e8-7d32-4d0a-9545-f278f3420744,2030-04-15,2030-04-17,City Council Tax,9399,Utilities,Council Tax,-185.19,GBP,-148497.58,Direct Debit,London,GB,4488,user_001,rec_f531495db5,
51958504-2abd-403a-9da5-a37ddb882616,2030-04-15,2030-04-16,Pret A Manger,5814,Food & Drink,Eating Out,-8.27,GBP,-148505.85,POS,London,GB,4488,user_001,,
83470210-1f1d-413e-888f-d01b70717704,2030-04-15,2030-04-16,O2 UK,4814,Bills,Mobile,-51.3,GBP,-148557.15,Direct Debit,Slough,GB,9074,user_001,rec_95042d8101,
e814ae96-2257-4b2e-9ecc-98729e43d581,2030-04-15,2030-04-16,Tesco,5411,Groceries,Supermarket,-79.89,GBP,-148637.04,POS,London,GB,1045,user_001,,
0ec70945-6c9c-49b4-bbd5-90f4b34d20e1,2030-04-16,2030-04-18,Pret A Manger,5814,Food & Drink,Eating Out,-8.03,GBP,-148645.07,POS,London,GB,2219,user_001,,
328123f8-2d0a-41fb-b5bb-cc3d071589a3,2030-04-16,2030-04-16,Shell,5541,Transport,Fuel,-79.27,GBP,-148724.34,POS,London,GB,1045,user_001,,
b3aecf0b-5440-4ec0-9560-179416e5c4d1,2030-04-16,2030-04-18,Deliveroo,5812,Food & Drink,Delivery,-25.79,GBP,-148750.13,E-Com,London,GB,1045,user_001,,
3457391c-5798-4ede-a010-3d2a07aab890,2030-04-17,2030-04-18,Amazon UK,5942,Shopping,Online Retail,-113.49,GBP,-148863.62,E-Com,London,GB,1045,user_002,,
b0426746-592b-4125-bd1d-11b5d4f453aa,2030-04-17,2030-04-18,GymBox,7997,Wellness,Gym,-62.34,GBP,-148925.96,Direct Debit,London,GB,9074,user_002,rec_19771e79cd,
ca241b17-3b6a-4c1b-b69a-467532d52e12,2030-04-17,2030-04-19,Pret A Manger,5814,Food & Drink,Eating Out,-7.95,GBP,-148933.91,POS,London,GB,2219,user_001,,
019c990b-9a33-4fa3-a48a-0b64bc21716a,2030-04-18,2030-04-22,Amazon UK,5942,Shopping,Online Retail,-9.88,GBP,-148943.79,E-Com,London,GB,4488,user_001,,
2d7a9012-d3ff-4dd2-be1a-0d8a8208e88d,2030-04-18,2030-04-18,Amazon UK,5942,Shopping,Online Retail,-72.04,GBP,-149015.83,E-Com,London,GB,1045,user_001,,
781fae9a-e1de-4b84-a35e-944b127e0602,2030-04-18,2030-04-19,Uber UK,4121,Transport,Ride Hailing,-29.8,GBP,-149045.63,E-Com,London,GB,1045,user_001,,
8dcaee49-fbc7-4acc-b903-46115452ad58,2030-04-18,2030-04-18,Deliveroo,5812,Food & Drink,Delivery,-32.13,GBP,-149077.76,E-Com,London,GB,9074,user_001,,
cd17a68e-bf6f-45a8-be93-f31105ecdaff,2030-04-18,2030-04-19,Transport for London,4111,Transport,Transit,-9.24,GBP,-149087.0,POS,London,GB,9074,user_001,,
6934ab98-944b-4dba-af7b-ce7eb2d53c84,2030-04-19,2030-04-22,Local Market,5499,Groceries,Specialty,-16.36,GBP,-149103.36,POS,London,GB,1045,user_001,,
be0b3fe1-d536-442a-aba5-6461838e28d2,2030-04-19,2030-04-19,Spotify,5735,Entertainment,Subscriptions,-9.62,GBP,-149112.98,E-Com,Stockholm,SE,4488,user_002,rec_34b6e9e33f,
63da38cd-bbbc-4f73-8f62-b06e7edc2d55,2030-04-20,2030-04-22,Pret A Manger,5814,Food & Drink,Eating Out,-9.14,GBP,-149122.12,POS,London,GB,1045,user_001,,
ce4f8c31-0fc7-48e2-bc04-9d6457c80308,2030-04-20,2030-04-22,Shell,5541,Transport,Fuel,-92.17,GBP,-149214.29,POS,London,GB,9074,user_001,,
dcd97e3e-6b82-4ca4-86e6-bd0e99fedafc,2030-04-20,2030-04-22,Pret A Manger,5814,Food & Drink,Eating Out,-6.69,GBP,-149220.98,POS,London,GB,1045,user_001,,
088eb766-2b2a-4416-bbc7-b100c543a2ba,2030-04-21,2030-04-22,Sainsbury's,5411,Groceries,Supermarket,-55.31,GBP,-149276.29,POS,London,GB,4488,user_002,,
3fdf43ac-0512-4b14-83d0-fa30faf9a6ce,2030-04-21,2030-04-23,Waitrose,5411,Groceries,Supermarket,-21.48,GBP,-149297.77,POS,London,GB,9074,user_001,,
8ec66b10-20c6-4aa5-ad22-3bb8deaea8f3,2030-04-21,2030-04-22,Waitrose,5411,Groceries,Supermarket,-21.09,GBP,-149318.86,POS,London,GB,2219,user_002,,
95cec80f-358e-425b-b9f5-219e886a3355,2030-04-21,2030-04-22,Tesco,5411,Groceries,Supermarket,-72.68,GBP,-149391.54,POS,London,GB,2219,user_001,,
7e5dfc51-5c92-46f0-8979-0c4b20e165b3,2030-04-22,2030-04-22,Deliveroo,5812,Food & Drink,Delivery,-24.31,GBP,-149415.85,E-Com,London,GB,1045,user_001,,
bbcc4229-7a5d-43d5-937c-2f105520a525,2030-04-22,2030-04-22,Waitrose,5411,Groceries,Supermarket,-31.81,GBP,-149447.66,POS,London,GB,9074,user_001,,
d3855a44-6d1a-44f2-88c3-d3ef8fb976cb,2030-04-22,2030-04-23,Netflix,7841,Entertainment,Subscriptions,-10.22,GBP,-149457.88,E-Com,Los Gatos,US,4488,user_001,rec_1bfe33738d,
00f7627f-35d8-45b0-93af-b130c2ec74fa,2030-04-23,2030-04-23,Uber UK,4121,Transport,Ride Hailing,-33.61,GBP,-149491.49,E-Com,London,GB,9074,user_002,,
f19a2699-9269-48c9-8de2-031b0ac0748c,2030-04-23,2030-04-23,Amazon UK,5942,Shopping,Online Retail,-48.54,GBP,-149540.03,E-Com,London,GB,9074,user_001,,
4517df39-541e-43fc-933c-6bd4097bd0b2,2030-04-24,2030-04-25,Deliveroo,5812,Food & Drink,Delivery,-23.59,GBP,-149563.62,E-Com,London,GB,9074,user_001,,
74fc75a9-b056-4316-84b0-4dbfb30246e8,2030-04-24,2030-04-25,Waitrose,5411,Groceries,Supermarket,-36.0,GBP,-149599.62,POS,London,GB,4488,user_001,,
a5b78f09-d390-4ffa-8109-a7771777488a,2030-04-24,2030-04-26,Pret A Manger,5814,Food & Drink,Eating Out,-6.4,GBP,-149606.02,POS,London,GB,2219,user_001,,
5f1ddc4a-99ef-45d5-9426-cda5e066a0b4,2030-04-25,2030-04-25,T212 Capital,6011,Income,Salary,3259.78,GBP,-146346.24,Credit,London,GB,4488,user_001,rec_2ff8f778d0,
063440ed-fa18-449e-ab2e-a7b44c7fce39,2030-04-26,2030-04-29,Tesco,5411,Groceries,Supermarket,-46.52,GBP,-146392.76,POS,London,GB,2219,user_001,,
09d53a6f-8512-48bf-be14-e9ee91bf378c,2030-04-26,2030-04-29,ATM Withdrawal,6011,Cash,ATM,-116.98,GBP,-146509.74,ATM,London,GB,2219,user_001,,
d2e13a46-2a4b-4352-8c59-20640e008916,2030-04-26,2030-04-29,Deliveroo,5812,Food & Drink,Delivery,-29.14,GBP,-146538.88,E-Com,London,GB,9074,user_001,,
4e549fb7-b7a2-4614-9689-56d8e111a58a,2030-04-27,2030-04-29,Shell,5541,Transport,Fuel,-42.19,GBP,-146581.07,POS,London,GB,4488,user_001,,
706cea29-0525-4c56-acbc-5ee39cf6e838,2030-04-27,2030-04-29,Sainsbury's,5411,Groceries,Supermarket,-47.53,GBP,-146628.6,POS,London,GB,1045,user_001,,
159acbcc-acef-492d-9c4b-e98ad45791ac,2030-04-28,2030-04-29,Tesco,5411,Groceries,Supermarket,-53.34,GBP,-146681.94,POS,London,GB,1045,user_002,,
2b0fa97c-3525-43f7-8d92-7be6709c9f87,2030-04-28,2030-04-29,Apple.com/bill,5734,Shopping,Electronics,-29.01,USD,-146710.95,E-Com,Cupertino,US,1045,user_001,,FX purchase 36.47 USD @ rate 1.26
5a50a49c-0716-4ad0-b5c9-85429508467d,2030-04-28,2030-04-29,Waitrose,5411,Groceries,Supermarket,-48.82,GBP,-146759.77,POS,London,GB,1045,user_001,,
5ecf5b39-3d8f-4e3d-a986-1bfafb00dc2e,2030-04-28,2030-04-30,Tesco,5411,Groceries,Supermarket,-73.12,GBP,-146832.89,POS,London,GB,4488,user_001,,
7e7b0a02-e722-4f84-8968-4e0e11b3e1b1,2030-04-28,2030-04-29,Amazon UK,5942,Shopping,Online Retail,-67.86,GBP,-146900.75,E-Com,London,GB,1045,user_001,,
c06cc539-83e4-4914-b53d-0ba22997d437,2030-04-28,2030-04-30,Local Market,5499,Groceries,Specialty,-21.94,GBP,-146922.69,POS,London,GB,9074,user_001,,
a633d2f1-c478-4eb7-ab51-5b8a061b777e,2030-04-29,2030-04-30,Local Market,5499,Groceries,Specialty,-15.66,GBP,-146938.35,POS,London,GB,4488,user_001,,
cd94dc81-65f5-41ac-a03c-a0c791609fa4,2030-04-29,2030-05-01,Amazon UK,5942,Shopping,Online Retail,-57.65,GBP,-146996.0,E-Com,London,GB,4488,user_002,,
ee2da995-8f39-4867-80f2-2d8f06598087,2030-04-29,2030-04-29,Sainsbury's,5411,Groceries,Supermarket,-32.14,GBP,-147028.14,POS,London,GB,9074,user_002,,
bb111bee-4a10-435f-aded-89d0456ecd4b,2030-04-30,2030-05-02,Amazon UK,5942,Shopping,Online Retail,-67.09,GBP,-147095.23,E-Com,London,GB,9074,user_001,,
c021db7c-2d3a-4d20-93db-d72c53855469,2030-04-30,2030-05-01,Shell,5541,Transport,Fuel,-62.77,GBP,-147158.0,POS,London,GB,4488,user_001,,
cc065e93-9dab-4818-aa8b-325c03c1c151,2030-04-30,2030-05-02,Shell,5541,Transport,Fuel,-42.24,GBP,-147200.24,POS,London,GB,1045,user_001,,
24e3285a-331d-48d6-9712-d245ea91f1ae,2030-05-01,2030-05-01,Crown Estates Lettings,6513,Housing,Rent,-1477.57,GBP,-148677.81,POS,London,GB,2219,user_001,rec_19f70fbcce,
779522c8-b3d1-4be7-aec8-7b62565cd173,2030-05-01,2030-05-03,Local Market,5499,Groceries,Specialty,-13.04,GBP,-148690.85,POS,London,GB,2219,user_001,,
a310de49-fcd2-4749-bcaf-d79cff288175,2030-05-01,2030-05-01,Uber UK,4121,Transport,Ride Hailing,-13.58,GBP,-148704.43,E-Com,London,GB,9074,user_001,,
f48a1627-8714-4eb6-8c2a-724ac6dd88ee,2030-05-01,2030-05-02,Transport for London,4111,Transport,Transit,-5.42,GBP,-148709.85,POS,London,GB,2219,user_001,,
48ed7e82-c614-442d-b12d-81c4945f75e6,2030-05-04,2030-05-06,Apple.com/bill,5734,Shopping,Electronics,-109.63,GBP,-148819.48,E-Com,Cupertino,US,1045,user_001,,
abc078a5-f6c0-4bb8-9cd8-967067821f62,2030-05-04,2030-05-06,Uber UK,4121,Transport,Ride Hailing,-27.24,GBP,-148846.72,E-Com,London,GB,2219,user_001,,
5c32775d-f7cb-4088-a51b-1e7755e660b2,2030-05-05,2030-05-07,Deliveroo,5812,Food & Drink,Delivery,-17.95,GBP,-148864.67,E-Com,London,GB,1045,user_001,,
96438397-cf88-434f-b058-20fd0092cf96,2030-05-05,2030-05-06,Transport for London,4111,Transport,Transit,-8.39,GBP,-148873.06,POS,London,GB,4488,user_001,,
acaa8f81-7272-4ca1-822f-9de8bc2ce921,2030-05-05,2030-05-06,Uber UK,4121,Transport,Ride Hailing,-27.74,GBP,-148900.8,E-Com,London,GB,4488,user_001,,
ad7a0572-09d7-4132-8fee-cde58ccc1d12,2030-05-05,2030-05-06,Sainsbury's,5411,Groceries,Supermarket,-61.74,GBP,-148962.54,POS,London,GB,2219,user_001,,
e735fc36-b97a-4776-91db-5e348dcf895e,2030-05-05,2030-05-07,Local Market,5499,Groceries,Specialty,-15.58,GBP,-148978.12,POS,London,GB,2219,user_002,,
60ee88df-2f52-48b3-9387-0aa4b1096913,2030-05-06,2030-05-07,Sainsbury's,5411,Groceries,Supermarket,-55.25,GBP,-149033.37,POS,London,GB,9074,user_001,,
8b6a9a41-20c3-4f9e-9bd6-53ac52a67dfe,2030-05-06,2030-05-06,Transport for London,4111,Transport,Transit,-4.87,GBP,-149038.24,POS,London,GB,1045,user_001,,
ab0dae3f-d7f9-424d-ac3c-5b410565316b,2030-05-06,2030-05-06,Tesco,5411,Groceries,Supermarket,-51.07,GBP,-149089.31,POS,London,GB,2219,user_001,,
c036412a-6e6b-4551-9cc8-41c9567b2ed9,2030-05-06,2030-05-08,Uber UK,4121,Transport,Ride Hailing,-21.02,GBP,-149110.33,E-Com,London,GB,4488,user_001,,
2f842228-4017-47be-b8d8-8b3f5ce948bb,2030-05-07,2030-05-09,Waitrose,5411,Groceries,Supermarket,-37.35,GBP,-149147.68,POS,London,GB,9074,user_001,,
59a75aa2-1e3a-4571-9fed-fb9fd8396d9b,2030-05-07,2030-05-09,Uber UK,4121,Transport,Ride Hailing,-26.9,GBP,-149174.58,E-Com,London,GB,4488,user_001,,
a64e5079-f77b-406a-b208-62b9d079c351,2030-05-07,2030-05-09,Amazon UK,5942,Shopping,Online Retail,-39.14,GBP,-149213.72,E-Com,London,GB,4488,user_002,,
d057b2d7-b4bb-4c9f-a44b-53e6b63ef7d8,2030-05-07,2030-05-08,Shell,5541,Transport,Fuel,-56.35,GBP,-149270.07,POS,London,GB,9074,user_002,,
ec894bc2-b95f-41d4-8e6f-4d84591b5006,2030-05-07,2030-05-09,Octopus Energy,4900,Utilities,Electricity,-132.09,GBP,-149402.16,Direct Debit,London,GB,4488,user_001,rec_141a4a0666,
083cb157-fe44-4af9-a624-d2a144d69f6b,2030-05-08,2030-05-10,Shell,5541,Transport,Fuel,-40.48,GBP,-149442.64,POS,London,GB,1045,user_001,,
3024230b-9326-4d5b-94a9-93533275ea16,2030-05-08,2030-05-09,Deliveroo,5812,Food & Drink,Delivery,-20.83,GBP,-149463.47,E-Com,London,GB,9074,user_001,,
9f9d3c4f-fbb3-4575-bd66-08afbfa58ab7,2030-05-08,2030-05-10,Deliveroo,5812,Food & Drink,Delivery,-26.59,GBP,-149490.06,E-Com,London,GB,1045,user_002,,
bff05996-28c5-4181-b525-3a3106e1f51d,2030-05-08,2030-05-09,Amazon UK,5942,Shopping,Online Retail,-113.36,GBP,-149603.42,E-Com,London,GB,1045,user_002,,
9619d217-b3eb-4c37-a234-2281f2f81e18,2030-05-09,2030-05-09,Sainsbury's,5411,Groceries,Supermarket,-29.42,GBP,-149632.84,POS,London,GB,9074,user_001,,
9d4bd451-2128-4b0b-8312-e3adbe74f7f4,2030-05-09,2030-05-13,Sainsbury's,5411,Groceries,Supermarket,-49.34,GBP,-149682.18,POS,London,GB,2219,user_001,,
0d4f446e-bd23-49d4-9985-368378db5806,2030-05-10,2030-05-13,Waitrose,5411,Groceries,Supermarket,-87.5,GBP,-149769.68,POS,London,GB,9074,user_001,,
7b107daa-20f1-432e-ade7-448e0fe4e53d,2030-05-10,2030-05-13,Tesco,5411,Groceries,Supermarket,-56.33,GBP,-149826.01,POS,London,GB,4488,user_001,,
8c9800be-f4fa-4788-9b65-be0b8154a161,2030-05-10,2030-05-13,Waitrose,5411,Groceries,Supermarket,-40.15,GBP,-149866.16,POS,London,GB,2219,user_001,,
97da180a-779e-4c07-9e71-b70aee782734,2030-05-10,2030-05-13,Uber UK,4121,Transport,Ride Hailing,-33.79,GBP,-149899.95,E-Com,London,GB,4488,user_002,,
c6231370-2360-46df-bcc4-4b2929ffd63a,2030-05-10,2030-05-13,Local Market,5499,Groceries,Specialty,-20.29,GBP,-149920.24,POS,London,GB,1045,user_001,,
4dee53be-ebb6-4e92-9a4b-563b80c53abd,2030-05-11,2030-05-13,Pret A Manger,5814,Food & Drink,Eating Out,-9.55,GBP,-149929.79,POS,London,GB,4488,user_001,,
6f689545-3fd1-4a23-8d50-9e2e4078934b,2030-05-11,2030-05-13,Deliveroo,5812,Food & Drink,Delivery,-14.81,GBP,-149944.6,E-Com,London,GB,9074,user_002,,
ac505e0e-fc4d-4d64-9d1e-3ff02b82b05e,2030-05-11,2030-05-13,Transport for London,4111,Transport,Transit,-7.9,GBP,-149952.5,POS,London,GB,2219,user_001,,
7f6ac56e-d0df-4b1a-9e02-aeaa635e75ce,2030-05-12,2030-05-13,Sainsbury's,5411,Groceries,Supermarket,-33.93,GBP,-149986.43,POS,London,GB,4488,user_001,,
af7f3e0e-ffe6-4388-914a-639f3fe8354a,2030-05-12,2030-05-14,Shell,5541,Transport,Fuel,-73.19,GBP,-150059.62,POS,London,GB,4488,user_001,,
b2e3946c-3657-465b-a9ad-45e5225b018f,2030-05-12,2030-05-13,Sainsbury's,5411,Groceries,Supermarket,-53.48,GBP,-150113.1,POS,London,GB,4488,user_001,,
c4687cf1-e1ea-46a9-ba89-4091eb3c9e7c,2030-05-12,2030-05-13,Apple.com/bill,5734,Shopping,Electronics,-176.64,GBP,-150289.74,E-Com,Cupertino,US,1045,user_001,,
cde9b564-09e9-4787-bfb7-fe493d38d125,2030-05-12,2030-05-14,Pret A Manger,5814,Food & Drink,Eating Out,-6.11,GBP,-150295.85,POS,London,GB,2219,user_001,,
d3b89c91-89f7-45d1-8b32-6d6d37510250,2030-05-12,2030-05-14,Uber UK,4121,Transport,Ride Hailing,-11.93,GBP,-150307.78,E-Com,London,GB,2219,user_001,,
03044ca3-6a5e-4aa8-af73-5a7b12a4092a,2030-05-13,2030-05-13,Deliveroo,5812,Food & Drink,Delivery,-21.41,GBP,-150329.19,E-Com,London,GB,1045,user_001,,
51992e4d-83cc-41ba-8d93-d5ac1b2f3234,2030-05-13,2030-05-13,Thames Water,4900,Utilities,Water,-38.66,GBP,-150367.85,Direct Debit,Reading,GB,1045,user_002,rec_954d02400c,
97c6039c-287a-443e-9e1a-e3fe6cdd75a8,2030-05-13,2030-05-13,Shell,5541,Transport,Fuel,-49.24,GBP,-150417.09,POS,London,GB,1045,user_001,,
9b259ff7-6d65-4582-8115-54e204f7b4bc,2030-05-13,2030-05-15,City Council Tax,9399,Utilities,Council Tax,-166.65,GBP,-150583.74,Direct Debit,London,GB,1045,user_001,rec_f531495db5,
ae42ddf8-018a-4ab2-9537-b6a8faff66b5,2030-05-13,2030-05-13,ATM Withdrawal,6011,Cash,ATM,-107.79,GBP,-150691.53,ATM,London,GB,9074,user_001,,
e8908d72-b0f6-4e90-9187-3dcc21324f3a,2030-05-13,2030-05-13,ATM Withdrawal,6011,Cash,ATM,-114.16,GBP,-150805.69,ATM,London,GB,4488,user_002,,
32416d27-5f7c-4028-8cd0-1d510f13c55d,2030-05-14,2030-05-14,Tesco,5411,Groceries,Supermarket,-31.58,GBP,-150837.27,POS,London,GB,2219,user_001,,
f686c1ee-18d3-4dbb-9eb4-b502297834f7,2030-05-14,2030-05-14,Uber UK,4121,Transport,Ride Hailing,-35.34,GBP,-150872.61,E-Com,London,GB,9074,user_001,,
141ecf26-2380-4af9-896a-6bb28cde32e5,2030-05-15,2030-05-16,Waitrose,5411,Groceries,Supermarket,-71.27,GBP,-150943.88,POS,London,GB,9074,user_001,,
767c3345-c343-470b-b39a-e3ba5591d6ef,2030-05-15,2030-05-15,O2 UK,4814,Bills,Mobile,-48.01,GBP,-150991.89,Direct Debit,Slough,GB,1045,user_001,rec_95042d8101,
d5779519-22b4-40bd-b387-cc953addaf4a,2030-05-15,2030-05-15,Deliveroo,5812,Food & Drink,Delivery,-18.82,GBP,-151010.71,E-Com,London,GB,2219,user_001,,
d22af142-622e-4af2-a87c-a3f82271d879,2030-05-16,2030-05-17,Amazon UK,5942,Shopping,Online Retail,-109.72,GBP,-151120.43,E-Com,London,GB,4488,user_001,,
5212d268-0a50-423a-b733-23f7c3575db1,2030-05-17,2030-05-17,Shell,5541,Transport,Fuel,-63.01,GBP,-151183.44,POS,London,GB,1045,user_001,,
a4525b3e-6de8-4747-a520-14afd9b2e362,2030-05-17,2030-05-17,GymBox,7997,Wellness,Gym,-63.97,GBP,-151247.41,Direct Debit,London,GB,1045,user_001,rec_3906953fd2,
cbaed77f-f213-4b90-942e-21ddc576f9ec,2030-05-17,2030-05-20,Shell,5541,Transport,Fuel,-66.88,GBP,-151314.29,POS,London,GB,1045,user_001,,
e6a505d9-2764-4e0f-a9e5-c0dcfe7193d4,2030-05-17,2030-05-20,Waitrose,5411,Groceries,Supermarket,-43.34,GBP,-151357.63,POS,London,GB,4488,user_001,,
1ae4254e-9e55-442b-a697-df352bc6e69f,2030-05-18,2030-05-20,Tesco,5411,Groceries,Supermarket,-65.26,GBP,-151422.89,POS,London,GB,1045,user_001,,
c0c5053a-3c7d-40f1-8c8a-1fe8de07c290,2030-05-18,2030-05-20,Transport for London,4111,Transport,Transit,-10.32,GBP,-151433.21,POS,London,GB,1045,user_001,,
b75c505c-30e5-463f-b1f5-13af483f25c9,2030-05-19,2030-05-20,Waitrose,5411,Groceries,Supermarket,-45.83,GBP,-151479.04,POS,London,GB,2219,user_001,,
70097fa0-1bcd-4bb0-9ea3-9ff39d3aece5,2030-05-20,2030-05-21,Uber UK,4121,Transport,Ride Hailing,-19.8,GBP,-151498.84,E-Com,London,GB,1045,user_001,,
9cb9199c-5406-478b-8468-ed49e37f02a7,2030-05-20,2030-05-22,Spotify,5735,Entertainment,Subscriptions,-9.44,GBP,-151508.28,E-Com,Stockholm,SE,1045,user_001,rec_4c746d2c3b,
ac267038-daba-47c6-ae15-2729b9ad600c,2030-05-20,2030-05-21,Deliveroo,5812,Food & Drink,Delivery,-16.7,GBP,-151524.98,E-Com,London,GB,1045,user_001,,
e25ef479-0975-4ccd-8f65-e18289314a7d,2030-05-20,2030-05-22,Pret A Manger,5814,Food & Drink,Eating Out,-5.71,GBP,-151530.69,POS,London,GB,9074,user_001,,
f733fb44-c185-4706-b3e7-83ca22fc641f,2030-05-20,2030-05-21,Waitrose,5411,Groceries,Supermarket,-32.12,GBP,-151562.81,POS,London,GB,1045,user_001,,
12ce9ee8-742b-46c3-ae97-10c4bad35e14,2030-05-21,2030-05-22,Deliveroo,5812,Food & Drink,Delivery,-17.77,GBP,-151580.58,E-Com,London,GB,4488,user_001,,
5c0173b1-bd7c-47ef-9fdb-8d7d126d2812,2030-05-21,2030-05-21,Uber UK,4121,Transport,Ride Hailing,-35.35,GBP,-151615.93,E-Com,London,GB,9074,user_001,,
c14f195f-cf94-4445-ae01-05b2bb5be5e9,2030-05-21,2030-05-23,Local Market,5499,Groceries,Specialty,-13.2,GBP,-151629.13,POS,London,GB,9074,user_001,,
d4af7eae-6f72-4a89-bcc7-be503e21a7ed,2030-05-21,2030-05-23,Transport for London,4111,Transport,Transit,-5.63,GBP,-151634.76,POS,London,GB,9074,user_001,,
fd608181-eb9c-45c0-a27b-5b571b7ce72f,2030-05-21,2030-05-21,Netflix,7841,Entertainment,Subscriptions,-11.65,USD,-151646.41,E-Com,Los Gatos,US,2219,user_001,rec_1bfe33738d,FX purchase 15.08 USD @ rate 1.29
09dcbef5-73c2-47b9-9d9a-57ac33a1d4e7,2030-05-23,2030-05-24,Deliveroo,5812,Food & Drink,Delivery,-23.97,GBP,-151670.38,E-Com,London,GB,1045,user_002,,
8dcbe847-530d-4e25-9c33-b7ec8e8e4ed5,2030-05-23,2030-05-27,Shell,5541,Transport,Fuel,-48.9,GBP,-151719.28,POS,London,GB,4488,user_001,,
2207ae50-42d2-43ce-9784-6650bfc7ccef,2030-05-24,2030-05-24,T212 Capital,6011,Income,Salary,3008.65,GBP,-148710.63,Credit,London,GB,9074,user_002,rec_c649d24d0f,
28c58bb4-9784-4ae9-aea8-5b30b48e1ae1,2030-05-24,2030-05-24,Amazon UK,5942,Shopping,Online Retail,-32.49,GBP,-148743.12,E-Com,London,GB,1045,user_001,,
b021b256-f5ca-46c8-8946-75bb1144443e,2030-05-24,2030-05-24,Apple.com/bill,5734,Shopping,Electronics,-136.29,GBP,-148879.41,E-Com,Cupertino,US,4488,user_001,,
3179e830-59a0-491f-ba22-965d2285fd2f,2030-05-25,2030-05-27,Apple.com/bill,5734,Shopping,Electronics,-62.62,GBP,-148942.03,E-Com,Cupertino,US,9074,user_001,,
40209e9c-c6ca-49c1-b5ed-577719f7330f,2030-05-25,2030-05-27,Shell,5541,Transport,Fuel,-34.61,GBP,-148976.64,POS,London,GB,9074,user_001,,
c1aa986d-1f9c-441a-a2ae-6f2cf9de7983,2030-05-25,2030-05-27,Sainsbury's,5411,Groceries,Supermarket,-69.32,GBP,-149045.96,POS,London,GB,1045,user_001,,
c81d151d-a314-4cc0-bf88-b6f6f31146a8,2030-05-25,2030-05-27,Amazon UK,5942,Shopping,Online Retail,-89.53,GBP,-149135.49,E-Com,London,GB,2219,user_001,,
4aff0475-7c7a-4d46-80ee-07217b927385,2030-05-26,2030-05-28,Local Market,5499,Groceries,Specialty,-12.78,GBP,-149148.27,POS,London,GB,4488,user_001,,
4cb267b1-6b54-4db0-abd4-7cacca34b96e,2030-05-26,2030-05-27,Shell,5541,Transport,Fuel,-77.5,GBP,-149225.77,POS,London,GB,9074,user_001,,
beddf241-0ca5-4037-8241-13a59bc299bf,2030-05-26,2030-05-27,Apple.com/bill,5734,Shopping,Electronics,-46.31,USD,-149272.08,E-Com,Cupertino,US,2219,user_002,,FX purchase 57.26 USD @ rate 1.24
815e9b8a-b034-4c61-91a2-cc72deb7b64f,2030-05-28,2030-05-28,Amazon UK,5942,Shopping,Online Retail,-75.13,GBP,-149347.21,E-Com,London,GB,1045,user_001,,
a5ea0445-7184-4d4c-b73a-7abd819930ff,2030-05-28,2030-05-30,Tesco,5411,Groceries,Supermarket,-64.69,GBP,-149411.9,POS,London,GB,2219,user_001,,
dc93eb28-c1ce-49da-8e48-397117d17129,2030-05-29,2030-05-30,Deliveroo,5812,Food & Drink,Delivery,-22.18,GBP,-149434.08,E-Com,London,GB,2219,user_001,,
ff3dd9e8-d55e-467e-b03d-1331d6f5dbe1,2030-05-29,2030-05-30,Waitrose,5411,Groceries,Supermarket,-54.54,GBP,-149488.62,POS,London,GB,9074,user_001,,
43705b89-9231-4308-a4e7-accc17e6cb03,2030-05-30,2030-05-30,Waitrose,5411,Groceries,Supermarket,-46.24,GBP,-149534.86,POS,London,GB,1045,user_002,,
6ce37b70-9dff-41dc-8705-04d812bd1e7d,2030-05-30,2030-05-31,Amazon UK,5942,Shopping,Online Retail,-77.14,GBP,-149612.0,E-Com,London,GB,4488,user_002,,
c11e1325-7977-44ce-8ac2-7374b5263bd0,2030-05-30,2030-06-03,Waitrose,5411,Groceries,Supermarket,-78.04,GBP,-149690.04,POS,London,GB,9074,user_001,,
247dc7df-932c-4fcb-b8f9-3286bad77462,2030-05-31,2030-06-03,Deliveroo,5812,Food & Drink,Delivery,-25.15,GBP,-149715.19,E-Com,London,GB,9074,user_001,,
349b2178-eeb5-4de6-816b-bdeffe74a07c,2030-06-01,2030-06-03,Deliveroo,5812,Food & Drink,Delivery,-14.55,GBP,-149729.74,E-Com,London,GB,4488,user_001,,
43013b8b-9f58-4e18-926a-e944c96957ec,2030-06-01,2030-06-03,Amazon UK,5942,Shopping,Online Retail,-113.07,GBP,-149842.81,E-Com,London,GB,9074,user_001,,
47ffd036-dbcb-4833-b0d8-adb18eacd6a8,2030-06-01,2030-06-03,Waitrose,5411,Groceries,Supermarket,-76.12,GBP,-149918.93,POS,London,GB,1045,user_001,,
ba8d14a6-d7da-46fd-8479-dcf772d20ff8,2030-06-01,2030-06-03,Waitrose,5411,Groceries,Supermarket,-64.64,GBP,-149983.57,POS,London,GB,4488,user_001,,
ee687024-e0e8-45bb-b32f-afd807303aac,2030-06-01,2030-06-03,Local Market,5499,Groceries,Specialty,-9.02,GBP,-149992.59,POS,London,GB,1045,user_001,,
fa5b6bce-42d2-4ef4-8c11-4449b2a48904,2030-06-01,2030-06-03,Pret A Manger,5814,Food & Drink,Eating Out,-5.87,GBP,-149998.46,POS,London,GB,2219,user_001,,
486e6968-d8a2-46f9-9381-a6f24aa842d6,2030-06-02,2030-06-03,Waitrose,5411,Groceries,Supermarket,-86.2,GBP,-150084.66,POS,London,GB,4488,user_001,,
48ba4ce2-4385-4b93-bace-99e0cbab292d,2030-06-02,2030-06-04,Deliveroo,5812,Food & Drink,Delivery,-14.19,GBP,-150098.85,E-Com,London,GB,2219,user_001,,
4e85c06a-f7b6-4b01-9ccd-bf9a34083e3c,2030-06-02,2030-06-03,Shell,5541,Transport,Fuel,-68.15,GBP,-150167.0,POS,London,GB,9074,user_001,,
a2a8c6de-c738-477c-a66b-e7059b6cd75d,2030-06-02,2030-06-03,Local Market,5499,Groceries,Specialty,-14.87,GBP,-150181.87,POS,London,GB,1045,user_001,,
a92e89ec-ffbe-470d-a2fd-9639f1d7e85a,2030-06-02,2030-06-03,Pret A Manger,5814,Food & Drink,Eating Out,-7.44,GBP,-150189.31,POS,London,GB,1045,user_001,,
c7a6d423-5f34-4db6-ad7b-b25692205186,2030-06-02,2030-06-04,Amazon UK,5942,Shopping,Online Retail,-78.88,GBP,-150268.19,E-Com,London,GB,1045,user_001,,
e935a86b-e807-4f75-9ce5-e73575155486,2030-06-02,2030-06-03,Transport for London,4111,Transport,Transit,-10.1,GBP,-150278.29,POS,London,GB,1045,user_002,,
fe016c26-1cf5-4755-bc15-dae33397bc70,2030-06-02,2030-06-03,Deliveroo,5812,Food & Drink,Delivery,-30.9,GBP,-150309.19,E-Com,London,GB,1045,user_002,,
5c2f2441-ceba-4788-8bd4-372534f95ab0,2030-06-03,2030-06-03,Local Market,5499,Groceries,Specialty,-18.89,GBP,-150328.08,POS,London,GB,4488,user_001,,
f3c5ee3e-966b-4d5f-90a8-ad1d2d451737,2030-06-03,2030-06-05,Crown Estates Lettings,6513,Housing,Rent,-1452.37,GBP,-151780.45,POS,London,GB,4488,user_001,rec_19f70fbcce,
20c00206-23ff-43f5-809e-0343411558a3,2030-06-04,2030-06-04,Local Market,5499,Groceries,Specialty,-14.85,GBP,-151795.3,POS,London,GB,1045,user_001,,
ac8c564a-9237-4dff-9d71-db6bee3eafb8,2030-06-04,2030-06-05,Pret A Manger,5814,Food & Drink,Eating Out,-7.04,GBP,-151802.34,POS,London,GB,2219,user_001,,
a8b354ba-7d46-4e00-b3bd-b4e00c0127e3,2030-06-05,2030-06-05,Shell,5541,Transport,Fuel,-66.05,GBP,-151868.39,POS,London,GB,1045,user_001,,
5a6080fa-5e0a-4238-b2eb-57b022be6697,2030-06-07,2030-06-10,Waitrose,5411,Groceries,Supermarket,-69.45,GBP,-151937.84,POS,London,GB,2219,user_002,,
e38579c4-9ddc-4c8e-9203-5d2d5135ad25,2030-06-07,2030-06-10,Octopus Energy,4900,Utilities,Electricity,-112.49,GBP,-152050.33,Direct Debit,London,GB,9074,user_001,rec_141a4a0666,
239e8613-773d-41d4-8aa4-ccf085dbfe4a,2030-06-08,2030-06-10,Shell,5541,Transport,Fuel,-35.22,GBP,-152085.55,POS,London,GB,4488,user_001,,
d301dee4-266c-4d05-9b36-c4f7f2ce3b68,2030-06-08,2030-06-10,Amazon UK,5942,Shopping,Online Retail,-17.57,GBP,-152103.12,E-Com,London,GB,4488,user_001,,
f6f0fe38-5fa0-4228-9a8e-b5446ffb6882,2030-06-08,2030-06-10,Transport for London,4111,Transport,Transit,-8.57,GBP,-152111.69,POS,London,GB,4488,user_001,,
c144b751-4512-41c9-9ba7-10ee862152be,2030-06-09,2030-06-11,Shell,5541,Transport,Fuel,-33.29,GBP,-152144.98,POS,London,GB,9074,user_001,,
fa75ed67-6547-4b5f-ba01-f6e3d3665feb,2030-06-09,2030-06-10,Amazon UK,5942,Shopping,Online Retail,-82.92,GBP,-152227.9,E-Com,London,GB,2219,user_002,,
25dffe98-9a96-40ba-8f44-48ac34c1603d,2030-06-10,2030-06-11,Pret A Manger,5814,Food & Drink,Eating Out,-8.38,GBP,-152236.28,POS,London,GB,1045,user_001,,
3468e67e-2e5c-4bed-9fd1-9bae455f6308,2030-06-10,2030-06-11,Local Market,5499,Groceries,Specialty,-12.95,GBP,-152249.23,POS,London,GB,2219,user_001,,
42746a4e-e7e2-4fa1-9d42-b647b8ac5f4b,2030-06-10,2030-06-10,Apple.com/bill,5734,Shopping,Electronics,-169.42,GBP,-152418.65,E-Com,Cupertino,US,4488,user_001,,
8c2788a4-a1e8-4998-bb4f-d866bea476da,2030-06-10,2030-06-12,Apple.com/bill,5734,Shopping,Electronics,-99.96,GBP,-152518.61,E-Com,Cupertino,US,9074,user_001,,
94a68bf7-5c1e-4029-a2ae-cd2053240858,2030-06-10,2030-06-10,Uber UK,4121,Transport,Ride Hailing,-34.82,GBP,-152553.43,E-Com,London,GB,9074,user_001,,
b652a28d-79c4-49c1-99fc-1c9d35395568,2030-06-10,2030-06-11,Local Market,5499,Groceries,Specialty,-7.74,GBP,-152561.17,POS,London,GB,2219,user_001,,
34ad2c5f-0ed4-43ed-8c69-4e1e5996353a,2030-06-11,2030-06-11,Thames Water,4900,Utilities,Water,-39.94,GBP,-152601.11,Direct Debit,Reading,GB,2219,user_001,rec_3a34d62842,
c060ceb0-aa12-48ad-ad70-2b69f13b00d8,2030-06-12,2030-06-12,Sainsbury's,5411,Groceries,Supermarket,-43.49,GBP,-152644.6,POS,London,GB,9074,user_001,,
2e4dd988-f403-43f0-9fad-35a16fb82ad9,2030-06-13,2030-06-17,City Council Tax,9399,Utilities,Council Tax,-167.21,GBP,-152811.81,Direct Debit,London,GB,9074,user_001,rec_f531495db5,
fb4479ca-29eb-4158-b3bf-4cb12471c871,2030-06-13,2030-06-14,Shell,5541,Transport,Fuel,-79.24,GBP,-152891.05,POS,London,GB,4488,user_001,,
362fa0fb-9509-4cab-9ae8-6c4ddfc09529,2030-06-14,2030-06-17,Tesco,5411,Groceries,Supermarket,-50.63,GBP,-152941.68,POS,London,GB,4488,user_001,,
9bd6037d-e3e5-4fc2-9096-4fc821c1d7a1,2030-06-14,2030-06-17,Transport for London,4111,Transport,Transit,-11.79,GBP,-152953.47,POS,London,GB,4488,user_001,,
260aafe4-9ee6-4e1b-a83b-bf23a71ecbab,2030-06-15,2030-06-17,Deliveroo,5812,Food & Drink,Delivery,-32.46,GBP,-152985.93,E-Com,London,GB,4488,user_001,,
4890e221-9456-45b9-9afb-37337d9563f4,2030-06-15,2030-06-17,Deliveroo,5812,Food & Drink,Delivery,-17.56,GBP,-153003.49,E-Com,London,GB,4488,user_002,,
502bc4b1-68df-4df3-ba50-f25c9062e228,2030-06-16,2030-06-17,Amazon UK,5942,Shopping,Online Retail,-22.7,GBP,-153026.19,E-Com,London,GB,9074,user_002,,
613cd62c-423c-4470-bafb-3c2690e13ad6,2030-06-16,2030-06-17,Local Market,5499,Groceries,Specialty,-19.14,GBP,-153045.33,POS,London,GB,1045,user_001,,
c876db03-cee4-4f27-96ed-58a795d8aea9,2030-06-16,2030-06-17,Uber UK,4121,Transport,Ride Hailing,-21.64,GBP,-153066.97,E-Com,London,GB,9074,user_002,,
d55b467f-d87b-495e-843b-cf5af72d97d5,2030-06-16,2030-06-18,Apple.com/bill,5734,Shopping,Electronics,-86.91,GBP,-153153.88,E-Com,Cupertino,US,2219,user_001,,
e82c7ee4-0c54-41e4-bd8d-90509e9c266e,2030-06-16,2030-06-17,Local Market,5499,Groceries,Specialty,-9.69,GBP,-153163.57,POS,London,GB,1045,user_001,,
1ce7bee2-c3e2-48be-8abf-479b7789fdf8,2030-06-17,2030-06-18,GymBox,7997,Wellness,Gym,-46.94,GBP,-153210.51,Direct Debit,London,GB,9074,user_002,rec_19771e79cd,
9fc0bfb1-4ed2-4d9b-a563-89e1a18671cc,2030-06-17,2030-06-18,Uber UK,4121,Transport,Ride Hailing,-18.16,GBP,-153228.67,E-Com,London,GB,1045,user_001,,
edce5760-affe-4300-9433-a7335432914a,2030-06-17,2030-06-17,O2 UK,4814,Bills,Mobile,-41.15,GBP,-153269.82,Direct Debit,Slough,GB,1045,user_001,rec_95042d8101,
40ad7cc6-a38f-441e-b23d-b2713ce3d4cb,2030-06-18,2030-06-18,Sainsbury's,5411,Groceries,Supermarket,-50.22,GBP,-153320.04,POS,London,GB,9074,user_001,,
c8a13e82-f670-474d-a612-3c45360bbf21,2030-06-18,2030-06-20,Pret A Manger,5814,Food & Drink,Eating Out,-11.21,GBP,-153331.25,POS,London,GB,4488,user_001,,
4b71c25f-6dff-4d82-a4e8-5921451d9f0c,2030-06-19,2030-06-20,Tesco,5411,Groceries,Supermarket,-41.68,GBP,-153372.93,POS,London,GB,4488,user_001,,
611798c8-3e78-4fa3-8806-1fc3c6ebc4ea,2030-06-19,2030-06-19,Spotify,5735,Entertainment,Subscriptions,-9.8,GBP,-153382.73,E-Com,Stockholm,SE,1045,user_001,rec_4c746d2c3b,
6ec967be-a7cf-45f9-ac0a-1c8bd8b4b354,2030-06-19,2030-06-19,Airline Refund,4511,Travel,Refund,6.34,GBP,-153376.39,Credit,London,GB,2219,user_002,,Refund for Transport for London
16b4b7b7-d0c2-4072-a915-f1d25298ce28,2030-06-20,2030-06-24,Tesco,5411,Groceries,Supermarket,-76.19,GBP,-153452.58,POS,London,GB,4488,user_001,,
21744adb-ec5f-4ba1-9a9d-40d1ace182c1,2030-06-20,2030-06-20,Apple.com/bill,5734,Shopping,Electronics,-98.44,GBP,-153551.02,E-Com,Cupertino,US,1045,user_001,,
4ccae4b7-ec63-439c-b285-cc33b1c4a7b2,2030-06-20,2030-06-20,Pret A Manger,5814,Food & Drink,Eating Out,-7.71,GBP,-153558.73,POS,London,GB,1045,user_001,,
7bac7ed0-2639-4258-ae39-3aa02e2896be,2030-06-21,2030-06-21,Netflix,7841,Entertainment,Subscriptions,-12.78,GBP,-153571.51,E-Com,Los Gatos,US,2219,user_001,rec_1bfe33738d,
532b76f1-711f-4793-84da-458640e05ae0,2030-06-22,2030-06-24,Transport for London,4111,Transport,Transit,-4.44,GBP,-153575.95,POS,London,GB,9074,user_001,,
da0cb0d7-99a8-4f20-8c7e-afe8008696cc,2030-06-22,2030-06-24,Transport for London,4111,Transport,Transit,-3.55,GBP,-153579.5,POS,London,GB,1045,user_001,,
edd30709-5475-4151-b9e4-f78eb909c8b2,2030-06-22,2030-06-24,Sainsbury's,5411,Groceries,Supermarket,-48.29,GBP,-153627.79,POS,London,GB,9074,user_001,,
0da20e1a-111c-4b35-a4a6-95005a5b728b,2030-06-23,2030-06-24,Amazon UK,5942,Shopping,Online Retail,-91.9,GBP,-153719.69,E-Com,London,GB,2219,user_001,,
5e1ff662-06f8-44d6-ba5c-47d58ec6be6d,2030-06-23,2030-06-25,Waitrose,5411,Groceries,Supermarket,-40.89,GBP,-153760.58,POS,London,GB,2219,user_001,,
600758a2-08b4-4850-a155-5a5ef230e417,2030-06-23,2030-06-24,Sainsbury's,5411,Groceries,Supermarket,-17.63,GBP,-153778.21,POS,London,GB,1045,user_002,,
c2ee3d02-af55-442b-819f-ead857404832,2030-06-24,2030-06-25,Pret A Manger,5814,Food & Drink,Eating Out,-8.68,GBP,-153786.89,POS,London,GB,4488,user_001,,
cc60483d-42c4-40f7-a5ef-9dd6560bb31b,2030-06-24,2030-06-24,Airline Refund,4511,Travel,Refund,52.42,GBP,-153734.47,Credit,London,GB,2219,user_002,,Refund for Waitrose
025753b2-3f02-4cb3-9c76-22cc4a5746a5,2030-06-25,2030-06-25,T212 Capital,6011,Income,Salary,2979.42,GBP,-150755.05,Credit,London,GB,1045,user_001,rec_2ff8f778d0,
a6a0d5ca-c322-4db8-a1c0-de53e28d6a28,2030-06-25,2030-06-27,Deliveroo,5812,Food & Drink,Delivery,-33.62,GBP,-150788.67,E-Com,London,GB,1045,user_001,,
eb12d3d4-d250-4b5f-807a-6176b02d0324,2030-06-26,2030-06-28,Tesco,5411,Groceries,Supermarket,-27.47,GBP,-150816.14,POS,London,GB,9074,user_001,,
793be9b8-3b54-4e67-b820-540d9c9fc908,2030-06-27,2030-06-27,Tesco,5411,Groceries,Supermarket,-58.87,GBP,-150875.01,POS,London,GB,9074,user_001,,
8d3a767f-ef03-4d4d-8c4d-0957a2813b13,2030-06-27,2030-06-28,Tesco,5411,Groceries,Supermarket,-78.07,GBP,-150953.08,POS,London,GB,2219,user_001,,
4e9e29f1-e2b0-4b4c-9129-b2e68ef910eb,2030-06-28,2030-06-28,Waitrose,5411,Groceries,Supermarket,-55.95,GBP,-151009.03,POS,London,GB,1045,user_001,,
a5995a11-bf09-4150-8f8e-c03aa395c047,2030-06-28,2030-06-28,Deliveroo,5812,Food & Drink,Delivery,-13.99,GBP,-151023.02,E-Com,London,GB,2219,user_001,,
cf5fb529-c999-4ced-8751-6dbde5fe6c62,2030-06-28,2030-07-01,Tesco,5411,Groceries,Supermarket,-71.64,GBP,-151094.66,POS,London,GB,1045,user_002,,
0b18aafd-29db-4427-9b32-57f7495e7161,2030-06-29,2030-07-01,Pret A Manger,5814,Food & Drink,Eating Out,-5.9,GBP,-151100.56,POS,London,GB,9074,user_001,,
0e935f72-1701-4470-b7ea-f3f5f7a4f74c,2030-06-29,2030-07-01,Local Market,5499,Groceries,Specialty,-12.49,GBP,-151113.05,POS,London,GB,9074,user_001,,
0fb6d7e0-a472-4325-9e6a-3200104e6162,2030-06-29,2030-07-01,Apple.com/bill,5734,Shopping,Electronics,-61.29,GBP,-151174.34,E-Com,Cupertino,US,1045,user_001,,
200c9402-d7e7-4134-91cb-4dfc1036e25d,2030-06-29,2030-07-01,Uber UK,4121,Transport,Ride Hailing,-16.73,GBP,-151191.07,E-Com,London,GB,9074,user_002,,
7dd3488a-cd4b-42a7-ae83-1849e8bcb63b,2030-06-29,2030-07-01,Local Market,5499,Groceries,Specialty,-15.56,GBP,-151206.63,POS,London,GB,1045,user_001,,
8af61f62-6d6d-4679-8a14-2818f25a43d3,2030-06-29,2030-07-01,Local Market,5499,Groceries,Specialty,-12.01,GBP,-151218.64,POS,London,GB,9074,user_001,,
1d77a60e-66ab-4048-9380-c125a719d649,2030-06-30,2030-07-01,Local Market,5499,Groceries,Specialty,-14.58,GBP,-151233.22,POS,London,GB,2219,user_001,,
2ef7f7e1-1318-4110-a677-e3eb93c463d6,2030-06-30,2030-07-01,Amazon UK,5942,Shopping,Online Retail,-108.96,GBP,-151342.18,E-Com,London,GB,2219,user_001,,
5718e4c5-97ba-47dc-a1b8-a74cbc30eb79,2030-06-30,2030-07-02,Uber UK,4121,Transport,Ride Hailing,-11.04,GBP,-151353.22,E-Com,London,GB,1045,user_001,,
5fdbd7cc-4283-4785-b208-6df6e4d71e5e,2030-06-30,2030-07-02,Shell,5541,Transport,Fuel,-87.46,GBP,-151440.68,POS,London,GB,2219,user_001,,
2a5e93f5-3423-4c36-a31c-9b0913b20183,2030-07-01,2030-07-02,Amazon UK,5942,Shopping,Online Retail,-88.94,GBP,-151529.62,E-Com,London,GB,1045,user_001,,
5732a1d0-5865-457f-98e9-e2cd48e0e7c1,2030-07-01,2030-07-01,Crown Estates Lettings,6513,Housing,Rent,-1499.39,GBP,-153029.01,POS,London,GB,1045,user_001,rec_19f70fbcce,
6d443b10-c701-422f-925d-a2ba4be105be,2030-07-01,2030-07-02,Deliveroo,5812,Food & Drink,Delivery,-13.01,GBP,-153042.02,E-Com,London,GB,1045,user_001,,
b88b0266-b818-4010-8e40-f9f8f2fc2710,2030-07-01,2030-07-03,Local Market,5499,Groceries,Specialty,-15.23,GBP,-153057.25,POS,London,GB,1045,user_001,,
2558f93a-d3a1-46e1-981f-8a0ab787a2c2,2030-07-02,2030-07-04,Amazon UK,5942,Shopping,Online Retail,-119.56,GBP,-153176.81,E-Com,London,GB,2219,user_001,,
3de15d22-17b1-4af3-8cda-6722996ddcf5,2030-07-02,2030-07-02,Shell,5541,Transport,Fuel,-44.31,GBP,-153221.12,POS,London,GB,2219,user_001,,
3e109bbd-dabb-4453-a2e0-49f05420047c,2030-07-02,2030-07-04,Amazon UK,5942,Shopping,Online Retail,-83.44,GBP,-153304.56,E-Com,London,GB,9074,user_001,,
ea8bca33-e263-4aa9-98f9-bc233c957f1e,2030-07-03,2030-07-03,Tesco,5411,Groceries,Supermarket,-50.56,GBP,-153355.12,POS,London,GB,9074,user_001,,
06a2bfd2-7fd9-40e6-b68c-2ee7eb76a438,2030-07-04,2030-07-05,Shell,5541,Transport,Fuel,-32.78,GBP,-153387.9,POS,London,GB,2219,user_001,,
0a375ae3-4f90-4309-b2c0-e0096d8da07c,2030-07-05,2030-07-08,Shell,5541,Transport,Fuel,-77.24,GBP,-153465.14,POS,London,GB,9074,user_001,,
2542dd73-1b7c-4f4a-8314-8cef7a357d21,2030-07-05,2030-07-08,Uber UK,4121,Transport,Ride Hailing,-23.38,GBP,-153488.52,E-Com,London,GB,2219,user_001,,
9ba7a22b-38de-46a3-aff5-40c30739b84c,2030-07-05,2030-07-08,Local Market,5499,Groceries,Specialty,-7.0,GBP,-153495.52,POS,London,GB,2219,user_001,,
ce7a9fee-77ba-4389-9424-ec9241178a39,2030-07-05,2030-07-08,Apple.com/bill,5734,Shopping,Electronics,-11.44,GBP,-153506.96,E-Com,Cupertino,US,2219,user_002,,
18f3c25c-297e-44ba-98d7-e748b2b83cae,2030-07-06,2030-07-08,Local Market,5499,Groceries,Specialty,-10.87,GBP,-153517.83,POS,London,GB,4488,user_002,,
266d8aec-1505-4137-a7c5-aff73f18a938,2030-07-06,2030-07-08,Amazon UK,5942,Shopping,Online Retail,-12.05,GBP,-153529.88,E-Com,London,GB,9074,user_001,,
4e0b834f-dd85-4043-9157-34c0e630401c,2030-07-06,2030-07-08,Transport for London,4111,Transport,Transit,-10.69,GBP,-153540.57,POS,London,GB,9074,user_001,,
8b29c33a-32fc-46b7-8a22-ee5f9b7eb092,2030-07-06,2030-07-08,Uber UK,4121,Transport,Ride Hailing,-12.45,GBP,-153553.02,E-Com,London,GB,1045,user_001,,
e8cbf4b3-3c5f-48af-80d7-77b32b44e1aa,2030-07-06,2030-07-08,Local Market,5499,Groceries,Specialty,-16.51,GBP,-153569.53,POS,London,GB,1045,user_001,,
e7e2c56a-bd66-4c28-abb6-ea5aabb016b6,2030-07-07,2030-07-09,Tesco,5411,Groceries,Supermarket,-78.13,GBP,-153647.66,POS,London,GB,9074,user_001,,
95ae745d-c00d-4b01-ab68-63e8e9c64c12,2030-07-08,2030-07-09,Octopus Energy,4900,Utilities,Electricity,-130.01,GBP,-153777.67,Direct Debit,London,GB,2219,user_001,rec_141a4a0666,
45476d32-8891-4e33-8909-d56fc1198003,2030-07-10,2030-07-12,Deliveroo,5812,Food & Drink,Delivery,-26.62,GBP,-153804.29,E-Com,London,GB,2219,user_001,,
527086d6-1448-49bf-a749-31b723c0d3ab,2030-07-10,2030-07-11,Sainsbury's,5411,Groceries,Supermarket,-31.8,GBP,-153836.09,POS,London,GB,2219,user_001,,
96d5a197-e8a7-4b45-99fc-a6a881caab7e,2030-07-10,2030-07-12,Shell,5541,Transport,Fuel,-72.78,GBP,-153908.87,POS,London,GB,9074,user_001,,
af9f8854-f3e7-431e-8e18-dd44474eddc4,2030-07-10,2030-07-10,Uber UK,4121,Transport,Ride Hailing,-18.76,GBP,-153927.63,E-Com,London,GB,2219,user_001,,
fa4435ba-7ab2-468e-9044-840719f3342f,2030-07-10,2030-07-11,Pret A Manger,5814,Food & Drink,Eating Out,-7.85,GBP,-153935.48,POS,London,GB,4488,user_002,,
8e794a5b-8f3a-4397-b33e-337465005243,2030-07-11,2030-07-12,Thames Water,4900,Utilities,Water,-34.04,GBP,-153969.52,Direct Debit,Reading,GB,1045,user_001,rec_3a34d62842,
941e5b35-50a5-4213-81a7-49653253ca60,2030-07-12,2030-07-12,Uber UK,4121,Transport,Ride Hailing,-10.25,GBP,-153979.77,E-Com,London,GB,1045,user_001,,
fc4a4431-0f4e-4894-a0ca-828f5332a719,2030-07-12,2030-07-15,Pret A Manger,5814,Food & Drink,Eating Out,-7.23,GBP,-153987.0,POS,London,GB,9074,user_001,,
1070cc06-f058-42d1-9573-9f414ef47b53,2030-07-13,2030-07-15,Apple.com/bill,5734,Shopping,Electronics,-203.19,GBP,-154190.19,E-Com,Cupertino,US,9074,user_001,,
13086080-23f2-4a01-ab98-f3a5f2bdd43e,2030-07-13,2030-07-15,Tesco,5411,Groceries,Supermarket,-49.38,GBP,-154239.57,POS,London,GB,2219,user_001,,
1cf6545a-3d3b-472b-9aa0-3c696e66d7b7,2030-07-13,2030-07-15,Waitrose,5411,Groceries,Supermarket,-45.12,GBP,-154284.69,POS,London,GB,1045,user_001,,
b52bc2da-38e7-4010-a565-2ff80e4efd93,2030-07-13,2030-07-15,Tesco,5411,Groceries,Supermarket,-60.02,GBP,-154344.71,POS,London,GB,4488,user_001,,
e7756cbb-42a4-410b-96cf-a9a54922d9a0,2030-07-13,2030-07-15,Amazon UK,5942,Shopping,Online Retail,-32.49,GBP,-154377.2,E-Com,London,GB,1045,user_001,,
3a97148a-7243-427f-ba73-c1efdbc4b2e5,2030-07-14,2030-07-15,Transport for London,4111,Transport,Transit,-8.6,GBP,-154385.8,POS,London,GB,2219,user_001,,
94fb9320-0bd0-4f77-a7c7-b557c41d8aed,2030-07-14,2030-07-15,Amazon UK,5942,Shopping,Online Retail,-113.7,GBP,-154499.5,E-Com,London,GB,4488,user_001,,
a6a902f6-1598-4e90-af62-1ed1f43fabf4,2030-07-14,2030-07-16,Deliveroo,5812,Food & Drink,Delivery,-17.71,GBP,-154517.21,E-Com,London,GB,9074,user_001,,
12fd6c2d-bf75-4485-b816-fa7e8f55e366,2030-07-15,2030-07-15,Transport for London,4111,Transport,Transit,-5.82,GBP,-154523.03,POS,London,GB,4488,user_001,,
152774d2-b6bd-40d9-af7c-6423da2b4a1b,2030-07-15,2030-07-17,O2 UK,4814,Bills,Mobile,-43.45,GBP,-154566.48,Direct Debit,Slough,GB,2219,user_002,rec_d2dce4c42f,
1f98af67-b5ae-4bc3-bca0-209398b2eccb,2030-07-15,2030-07-16,Local Market,5499,Groceries,Specialty,-11.64,GBP,-154578.12,POS,London,GB,9074,user_001,,
2b52429f-47e5-4a2d-8263-2a2336058adb,2030-07-15,2030-07-16,City Council Tax,9399,Utilities,Council Tax,-170.35,GBP,-154748.47,Direct Debit,London,GB,4488,user_001,rec_f531495db5,
961abd62-72bd-46d1-be79-6d916294617d,2030-07-15,2030-07-15,Pret A Manger,5814,Food & Drink,Eating Out,-8.06,GBP,-154756.53,POS,London,GB,4488,user_001,,
2096257c-2936-42c2-8362-3eba909230b0,2030-07-16,2030-07-17,Deliveroo,5812,Food & Drink,Delivery,-33.82,GBP,-154790.35,E-Com,London,GB,2219,user_001,,
96900e35-7f0c-4135-aae7-1de07d08bc1c,2030-07-16,2030-07-18,Tesco,5411,Groceries,Supermarket,-38.53,GBP,-154828.88,POS,London,GB,9074,user_001,,
3b9306d7-798f-4908-9e22-26eef73a213b,2030-07-17,2030-07-17,Amazon UK,5942,Shopping,Online Retail,-73.77,GBP,-154902.65,E-Com,London,GB,1045,user_001,,
4a7fba40-a3d5-4a2b-9bfe-5c6bd93695d3,2030-07-17,2030-07-18,Amazon UK,5942,Shopping,Online Retail,-31.67,GBP,-154934.32,E-Com,London,GB,1045,user_001,,
c885d753-b21d-4ea2-8754-10cf6a77be0c,2030-07-17,2030-07-18,GymBox,7997,Wellness,Gym,-50.78,GBP,-154985.1,Direct Debit,London,GB,2219,user_001,rec_3906953fd2,
00087d1f-00fc-4359-acff-9800f302074c,2030-07-18,2030-07-22,Tesco,5411,Groceries,Supermarket,-69.12,GBP,-155054.22,POS,London,GB,1045,user_002,,
3d11610f-dd83-49d7-90c5-bb3dd6738fea,2030-07-18,2030-07-18,Pret A Manger,5814,Food & Drink,Eating Out,-9.17,GBP,-155063.39,POS,London,GB,2219,user_001,,
54d7f7e9-1596-47f1-be8d-3de9abe17fd0,2030-07-18,2030-07-22,Shell,5541,Transport,Fuel,-79.36,GBP,-155142.75,POS,London,GB,2219,user_001,,
750a4bd6-49a6-4e35-8b03-eff3324526e3,2030-07-18,2030-07-22,Sainsbury's,5411,Groceries,Supermarket,-53.04,GBP,-155195.79,POS,London,GB,9074,user_001,,
e5498e4d-0812-4873-99e4-acca2a1479eb,2030-07-18,2030-07-19,Shell,5541,Transport,Fuel,-86.7,GBP,-155282.49,POS,London,GB,2219,user_001,,
02e3b157-f80a-463e-b903-670446aa4e4f,2030-07-19,2030-07-22,Sainsbury's,5411,Groceries,Supermarket,-18.58,GBP,-155301.07,POS,London,GB,9074,user_001,,
62d9d0ea-0cbf-48ed-b601-59e4ca9883e6,2030-07-19,2030-07-22,Sainsbury's,5411,Groceries,Supermarket,-68.81,GBP,-155369.88,POS,London,GB,1045,user_001,,
f9c6654d-134b-40d9-98b1-42ab11a346c0,2030-07-19,2030-07-19,Spotify,5735,Entertainment,Subscriptions,-8.96,GBP,-155378.84,E-Com,Stockholm,SE,1045,user_001,rec_4c746d2c3b,
fa53eb53-dc19-4804-a470-0a685045f996,2030-07-19,2030-07-19,Sainsbury's,5411,Groceries,Supermarket,-26.24,GBP,-155405.08,POS,London,GB,1045,user_001,,
0212a463-ac35-4dde-bab6-556e379703ca,2030-07-20,2030-07-22,Local Market,5499,Groceries,Specialty,-12.23,GBP,-155417.31,POS,London,GB,2219,user_001,,
3dcb8dc7-57d2-498d-a0d4-fe3544d541e2,2030-07-20,2030-07-22,Waitrose,5411,Groceries,Supermarket,-66.47,GBP,-155483.78,POS,London,GB,9074,user_001,,
8fd71a9f-c40f-4a55-8ce4-5bc9a39f3074,2030-07-20,2030-07-22,Waitrose,5411,Groceries,Supermarket,-34.62,GBP,-155518.4,POS,London,GB,1045,user_001,,
383ba0ad-6057-4b1f-893c-56c424dde021,2030-07-21,2030-07-22,Tesco,5411,Groceries,Supermarket,-25.51,GBP,-155543.91,POS,London,GB,2219,user_001,,
95b3b500-d9a9-4eb7-8578-7475b65b828e,2030-07-21,2030-07-23,Local Market,5499,Groceries,Specialty,-20.29,GBP,-155564.2,POS,London,GB,4488,user_001,,
95f26a0a-825d-4e59-979f-6931df52a66b,2030-07-21,2030-07-22,Uber UK,4121,Transport,Ride Hailing,-19.45,GBP,-155583.65,E-Com,London,GB,1045,user_001,,
ec3c554d-d026-47c8-b055-5ac4b6971bdb,2030-07-21,2030-07-22,Deliveroo,5812,Food & Drink,Delivery,-19.38,GBP,-155603.03,E-Com,London,GB,1045,user_001,,
fbe4c24c-ce6c-4399-a365-8e9e0a6fe1c4,2030-07-21,2030-07-23,Uber UK,4121,Transport,Ride Hailing,-35.6,GBP,-155638.63,E-Com,London,GB,4488,user_002,,
340ed892-11d0-473b-878c-534688f7d8b8,2030-07-22,2030-07-22,Uber UK,4121,Transport,Ride Hailing,-28.47,GBP,-155667.1,E-Com,London,GB,1045,user_001,,
82e5d245-e6f1-4ff0-bf30-a61d07beaf0a,2030-07-22,2030-07-23,Sainsbury's,5411,Groceries,Supermarket,-67.04,GBP,-155734.14,POS,London,GB,1045,user_001,,
9decbe3b-10b2-4290-b01f-3e0fa098288b,2030-07-22,2030-07-22,Deliveroo,5812,Food & Drink,Delivery,-13.88,GBP,-155748.02,E-Com,London,GB,4488,user_001,,
b3722fbb-bf35-4f59-be0c-91d2db0ba2b7,2030-07-22,2030-07-22,Sainsbury's,5411,Groceries,Supermarket,-51.83,GBP,-155799.85,POS,London,GB,9074,user_001,,
dd72b5fe-d36a-46d2-b5ca-0c05e90bd18e,2030-07-22,2030-07-22,Transport for London,4111,Transport,Transit,-6.12,GBP,-155805.97,POS,London,GB,4488,user_001,,
e9068b52-dea6-4404-8131-6a4157c752ae,2030-07-22,2030-07-23,Netflix,7841,Entertainment,Subscriptions,-10.26,USD,-155816.23,E-Com,Los Gatos,US,4488,user_001,rec_1bfe33738d,FX purchase 12.36 USD @ rate 1.20
7c3bdd8a-4306-40e1-9a69-f8e9bf8bf8d0,2030-07-23,2030-07-24,Transport for London,4111,Transport,Transit,-10.06,GBP,-155826.29,POS,London,GB,9074,user_001,,
c8071875-e2de-42eb-a95b-a85e6c09a3a2,2030-07-23,2030-07-23,Transport for London,4111,Transport,Transit,-6.05,GBP,-155832.34,POS,London,GB,1045,user_002,,
d47db5d8-722e-49b9-9c81-9c613db67040,2030-07-24,2030-07-25,Pret A Manger,5814,Food & Drink,Eating Out,-6.03,GBP,-155838.37,POS,London,GB,2219,user_002,,
23a81e23-1958-4fdc-8a1c-979d7ae66a0d,2030-07-25,2030-07-25,T212 Capital,6011,Income,Salary,3029.18,GBP,-152809.19,Credit,London,GB,4488,user_001,rec_2ff8f778d0,
5fb37829-f389-4e67-be00-304089caf44b,2030-07-25,2030-07-26,Pret A Manger,5814,Food & Drink,Eating Out,-7.89,GBP,-152817.08,POS,London,GB,9074,user_001,,
fa9d7a17-4ad4-4801-a889-e935bd12df81,2030-07-25,2030-07-25,Transport for London,4111,Transport,Transit,-10.43,GBP,-152827.51,POS,London,GB,1045,user_002,,
25cbbba5-9936-4d98-a188-4cd9b4fe5d64,2030-07-26,2030-07-29,Tesco,5411,Groceries,Supermarket,-60.87,GBP,-152888.38,POS,London,GB,2219,user_001,,
d83f811b-44f8-4cf3-9936-df904bec3dba,2030-07-26,2030-07-29,Transport for London,4111,Transport,Transit,-8.71,GBP,-152897.09,POS,London,GB,4488,user_001,,
38ef64a9-cbe9-469f-8864-9db059cca938,2030-07-27,2030-07-29,Sainsbury's,5411,Groceries,Supermarket,-24.96,GBP,-152922.05,POS,London,GB,2219,user_001,,
f7e7ff26-722f-48ec-9f91-446a97ebb1bc,2030-07-27,2030-07-29,Pret A Manger,5814,Food & Drink,Eating Out,-6.14,GBP,-152928.19,POS,London,GB,2219,user_001,,
0ebe5f46-192b-47d7-a212-1b59fc2d4a18,2030-07-28,2030-07-29,Pret A Manger,5814,Food & Drink,Eating Out,-8.63,GBP,-152936.82,POS,London,GB,9074,user_001,,
a20fc4b8-8fa4-4f77-8240-7527e7102765,2030-07-28,2030-07-29,Uber UK,4121,Transport,Ride Hailing,-31.72,GBP,-152968.54,E-Com,London,GB,4488,user_001,,
bead80cc-9974-4da1-88e4-94da9665ffae,2030-07-28,2030-07-29,Shell,5541,Transport,Fuel,-48.6,GBP,-153017.14,POS,London,GB,1045,user_001,,
44b49ba2-7fbe-4737-94cf-7bd291735f0a,2030-07-29,2030-07-30,Pret A Manger,5814,Food & Drink,Eating Out,-10.92,GBP,-153028.06,POS,London,GB,4488,user_001,,
ed77720c-3faa-466a-ba43-88419c51981d,2030-07-29,2030-07-30,Uber UK,4121,Transport,Ride Hailing,-28.77,GBP,-153056.83,E-Com,London,GB,2219,user_001,,
b2a05728-c283-40e6-93af-28626ff58158,2030-07-30,2030-07-31,Uber UK,4121,Transport,Ride Hailing,-10.99,GBP,-153067.82,E-Com,London,GB,4488,user_001,,
016de73d-2149-47ee-8dea-58c2f0312512,2030-07-31,2030-08-02,Transport for London,4111,Transport,Transit,-6.42,GBP,-153074.24,POS,London,GB,9074,user_001,,
d8b7249c-0186-4131-9c31-0c2e90e4d427,2030-07-31,2030-08-01,Deliveroo,5812,Food & Drink,Delivery,-22.59,GBP,-153096.83,E-Com,London,GB,2219,user_002,,
6acd48ef-3bd0-4840-99c2-110fb9dffc56,2030-08-01,2030-08-05,Local Market,5499,Groceries,Specialty,-18.49,GBP,-153115.32,POS,London,GB,4488,user_001,,
6fea37c0-a1e1-4076-b65b-bff5c1ef01ac,2030-08-01,2030-08-05,Pret A Manger,5814,Food & Drink,Eating Out,-7.43,GBP,-153122.75,POS,London,GB,2219,user_001,,
abc69169-0ac0-4a74-9b82-6f4de6d046f9,2030-08-01,2030-08-01,Crown Estates Lettings,6513,Housing,Rent,-1602.23,GBP,-154724.98,POS,London,GB,2219,user_001,rec_19f70fbcce,
9265c80b-f97f-48fe-857d-b3c0946dcc8f,2030-08-02,2030-08-02,Apple.com/bill,5734,Shopping,Electronics,-194.08,GBP,-154919.06,E-Com,Cupertino,US,2219,user_001,,
aa16f37b-5c3c-4a97-b225-71e6d21c4bf7,2030-08-02,2030-08-02,Pret A Manger,5814,Food & Drink,Eating Out,-6.12,GBP,-154925.18,POS,London,GB,9074,user_001,,
c4ff8b5f-ac22-472b-99bf-f940c5151069,2030-08-02,2030-08-02,Waitrose,5411,Groceries,Supermarket,-76.82,GBP,-155002.0,POS,London,GB,9074,user_001,,
aa4fcf63-4fa0-4088-a94b-5c9f9b7e1e3d,2030-08-03,2030-08-05,Transport for London,4111,Transport,Transit,-9.43,GBP,-155011.43,POS,London,GB,2219,user_002,,
c2c32705-f51e-472e-a4bb-ac4329958ff2,2030-08-03,2030-08-05,Sainsbury's,5411,Groceries,Supermarket,-31.08,GBP,-155042.51,POS,London,GB,2219,user_001,,
f540c1c4-4a88-46b9-a06a-23a81b37bd1f,2030-08-03,2030-08-05,Shell,5541,Transport,Fuel,-63.17,GBP,-155105.68,POS,London,GB,9074,user_001,,
3a92d50b-5627-4da3-a497-c77ebad1784f,2030-08-04,2030-08-05,Transport for London,4111,Transport,Transit,-11.33,GBP,-155117.01,POS,London,GB,1045,user_001,,
404bcc6a-900b-4583-baba-bb6fc33a8a34,2030-08-04,2030-08-05,Sainsbury's,5411,Groceries,Supermarket,-33.54,GBP,-155150.55,POS,London,GB,1045,user_001,,
58a87b35-f615-4571-bda4-763536e440de,2030-08-04,2030-08-06,Amazon UK,5942,Shopping,Online Retail,-18.23,GBP,-155168.78,E-Com,London,GB,4488,user_001,,
75045b22-c4b3-4329-8338-24cad63eaf40,2030-08-04,2030-08-05,Sainsbury's,5411,Groceries,Supermarket,-15.49,GBP,-155184.27,POS,London,GB,4488,user_001,,
f9ddf95d-4ba1-4eda-8135-796f11907442,2030-08-04,2030-08-05,Uber UK,4121,Transport,Ride Hailing,-17.31,GBP,-155201.58,E-Com,London,GB,2219,user_002,,
72cd719c-df65-4a1b-ad93-03bb041590ea,2030-08-05,2030-08-06,Tesco,5411,Groceries,Supermarket,-68.51,GBP,-155270.09,POS,London,GB,1045,user_002,,
76a1f67d-60d1-482d-a793-a85e82af6dd8,2030-08-06,2030-08-07,Apple.com/bill,5734,Shopping,Electronics,-126.63,USD,-155396.72,E-Com,Cupertino,US,9074,user_001,,FX purchase 161.24 USD @ rate 1.27
bef50ed1-eb8f-4ba9-ae42-6674d53f066f,2030-08-06,2030-08-07,Waitrose,5411,Groceries,Supermarket,-42.32,GBP,-155439.04,POS,London,GB,1045,user_002,,
91e1fdc4-fef5-4958-b1cd-f510068fe611,2030-08-07,2030-08-08,Tesco,5411,Groceries,Supermarket,-28.96,GBP,-155468.0,POS,London,GB,9074,user_001,,
dc812820-04b3-4cfc-8da6-abff51a2164d,2030-08-07,2030-08-09,Octopus Energy,4900,Utilities,Electricity,-110.36,GBP,-155578.36,Direct Debit,London,GB,2219,user_001,rec_141a4a0666,
e76faa7b-74d4-4929-aac3-f51ebfff9847,2030-08-07,2030-08-09,Transport for London,4111,Transport,Transit,-11.28,GBP,-155589.64,POS,London,GB,1045,user_001,,
337c92df-9b91-4937-9feb-2166b4f47577,2030-08-09,2030-08-12,Transport for London,4111,Transport,Transit,-5.63,GBP,-155595.27,POS,London,GB,4488,user_001,,
ac050273-2e6d-4986-81d9-479073000fef,2030-08-09,2030-08-12,Transport for London,4111,Transport,Transit,-5.4,GBP,-155600.67,POS,London,GB,9074,user_001,,
0ebab668-59e2-49f3-82ad-cd0640f4a1ca,2030-08-10,2030-08-12,Pret A Manger,5814,Food & Drink,Eating Out,-7.7,GBP,-155608.37,POS,London,GB,9074,user_001,,
3c847c30-614b-4010-9799-2cc4c332da10,2030-08-10,2030-08-12,Deliveroo,5812,Food & Drink,Delivery,-15.77,GBP,-155624.14,E-Com,London,GB,2219,user_001,,
108fbaf3-c892-436e-b5e9-43263303de0c,2030-08-11,2030-08-12,Airline Refund,4511,Travel,Refund,9.34,GBP,-155614.8,Credit,London,GB,4488,user_001,,Refund for Netflix
8a77afad-f781-4f01-9f8f-df49b79ba516,2030-08-11,2030-08-12,Deliveroo,5812,Food & Drink,Delivery,-26.69,GBP,-155641.49,E-Com,London,GB,9074,user_002,,
e3c41cc7-c979-4c24-a9dc-b8067c383e08,2030-08-11,2030-08-12,Pret A Manger,5814,Food & Drink,Eating Out,-7.84,GBP,-155649.33,POS,London,GB,9074,user_002,,
358ec836-7efd-462a-80a7-3c96de0d49a9,2030-08-12,2030-08-13,Thames Water,4900,Utilities,Water,-41.09,GBP,-155690.42,Direct Debit,Reading,GB,4488,user_001,rec_3a34d62842,
76501fb9-6238-477b-83e5-935caf84f5a1,2030-08-12,2030-08-13,Tesco,5411,Groceries,Supermarket,-75.0,GBP,-155765.42,POS,London,GB,1045,user_001,,
144c3c10-05cb-4da8-8b76-73239386b8b7,2030-08-13,2030-08-13,Transport for London,4111,Transport,Transit,-10.88,GBP,-155776.3,POS,London,GB,2219,user_001,,
3636fcc1-e27d-4da3-bf66-d449eb07421a,2030-08-13,2030-08-13,City Council Tax,9399,Utilities,Council Tax,-167.5,GBP,-155943.8,Direct Debit,London,GB,4488,user_001,rec_f531495db5,
c0bdb895-e775-4aed-8cd5-7418dd51085d,2030-08-13,2030-08-14,Pret A Manger,5814,Food & Drink,Eating Out,-8.19,GBP,-155951.99,POS,London,GB,4488,user_002,,
1885c384-55ea-488e-a97b-66f85de1eb4c,2030-08-14,2030-08-14,Deliveroo,5812,Food & Drink,Delivery,-15.7,GBP,-155967.69,E-Com,London,GB,4488,user_001,,
eb04b0aa-ec9e-4622-bb2a-6abab6ce630e,2030-08-14,2030-08-14,Pret A Manger,5814,Food & Drink,Eating Out,-9.65,GBP,-155977.34,POS,London,GB,1045,user_002,,
022bc071-79f1-4c30-a2b7-284c5e9e439f,2030-08-15,2030-08-16,O2 UK,4814,Bills,Mobile,-51.08,GBP,-156028.42,Direct Debit,Slough,GB,9074,user_002,rec_d2dce4c42f,
62ad290d-4097-4106-91c8-8936936b8f92,2030-08-15,2030-08-15,HM Revenue & Customs,9311,Income,Tax Refund,20.91,GBP,-156007.51,Credit,London,GB,2219,user_001,,Refund for Sainsbury's
925af341-637b-4615-86db-e8a6a85cc5a8,2030-08-16,2030-08-16,Tesco,5411,Groceries,Supermarket,-28.0,GBP,-156035.51,POS,London,GB,4488,user_001,,
4880985c-b86d-405b-b26a-065f1ddc09e5,2030-08-17,2030-08-19,Deliveroo,5812,Food & Drink,Delivery,-28.8,GBP,-156064.31,E-Com,London,GB,9074,user_002,,
9c6b4eb7-b69a-4a53-a17b-328687c92187,2030-08-17,2030-08-19,Tesco,5411,Groceries,Supermarket,-22.18,GBP,-156086.49,POS,London,GB,4488,user_002,,
ceb935e0-99cc-4079-b7b2-2be8e3514314,2030-08-17,2030-08-19,Apple.com/bill,5734,Shopping,Electronics,-208.02,GBP,-156294.51,E-Com,Cupertino,US,1045,user_001,,
e166704b-0dbe-4ac4-b806-99290cb59a5c,2030-08-17,2030-08-19,Deliveroo,5812,Food & Drink,Delivery,-26.64,GBP,-156321.15,E-Com,London,GB,9074,user_001,,
3772c8a2-c7a1-4242-96df-b1ac709fefb1,2030-08-18,2030-08-19,Sainsbury's,5411,Groceries,Supermarket,-35.06,GBP,-156356.21,POS,London,GB,1045,user_001,,
5ab7e679-a4eb-4810-8667-13653b594e47,2030-08-18,2030-08-19,Pret A Manger,5814,Food & Drink,Eating Out,-7.66,GBP,-156363.87,POS,London,GB,9074,user_001,,
66fced2b-f385-41c3-84e0-5bcc3ac491dd,2030-08-18,2030-08-19,Airline Refund,4511,Travel,Refund,128.65,GBP,-156235.22,Credit,London,GB,4488,user_001,,Refund for Apple.com/bill
cba4d82e-0ad9-420f-994e-790b1ab55772,2030-08-18,2030-08-19,Sainsbury's,5411,Groceries,Supermarket,-45.71,GBP,-156280.93,POS,London,GB,2219,user_001,,
411902c9-3a80-4eaa-bab6-151fb123aa8b,2030-08-19,2030-08-21,Spotify,5735,Entertainment,Subscriptions,-8.48,EUR,-156289.41,E-Com,Stockholm,SE,9074,user_001,rec_4c746d2c3b,FX purchase 9.85 EUR @ rate 1.16
5fc227d8-bded-4804-bf88-ad1abebfd15e,2030-08-19,2030-08-19,Transport for London,4111,Transport,Transit,-9.94,GBP,-156299.35,POS,London,GB,4488,user_001,,
dcc594cd-d609-4535-9cd7-c0a4ba2367ad,2030-08-19,2030-08-19,GymBox,7997,Wellness,Gym,-58.99,GBP,-156358.34,Direct Debit,London,GB,2219,user_002,rec_19771e79cd,
5dec7845-2be6-4ef0-b3f9-a7fc17345853,2030-08-20,2030-08-21,Pret A Manger,5814,Food & Drink,Eating Out,-9.89,GBP,-156368.23,POS,London,GB,2219,user_001,,
955da0c7-bc7b-426e-9f38-1564edf563de,2030-08-20,2030-08-22,Sainsbury's,5411,Groceries,Supermarket,-51.78,GBP,-156420.01,POS,London,GB,9074,user_001,,
e9efe8ac-8d77-4f23-b72b-bba175dd97d2,2030-08-20,2030-08-21,Sainsbury's,5411,Groceries,Supermarket,-62.05,GBP,-156482.06,POS,London,GB,1045,user_001,,
52dc0b2c-a090-4e3e-ad0e-4c733c05717e,2030-08-21,2030-08-22,Netflix,7841,Entertainment,Subscriptions,-11.79,GBP,-156493.85,E-Com,Los Gatos,US,2219,user_002,rec_d9322c1382,
a1059ac1-c4a5-4345-a272-0a9c7f2d61e6,2030-08-21,2030-08-23,Transport for London,4111,Transport,Transit,-10.4,GBP,-156504.25,POS,London,GB,4488,user_001,,
28383e97-95a9-4473-8e70-d3e4860dc666,2030-08-22,2030-08-22,Uber UK,4121,Transport,Ride Hailing,-19.28,GBP,-156523.53,E-Com,London,GB,1045,user_001,,
84c3aa11-6265-4abf-9136-5cf1c1590d1f,2030-08-23,2030-08-23,T212 Capital,6011,Income,Salary,3121.54,GBP,-153401.99,Credit,London,GB,4488,user_001,rec_2ff8f778d0,
0062eb55-7a18-4963-a4a0-3f4cb10b96c9,2030-08-24,2030-08-26,Local Market,5499,Groceries,Specialty,-6.06,GBP,-153408.05,POS,London,GB,9074,user_001,,
ce8ad87d-3042-4906-b544-3d350d4e77dc,2030-08-24,2030-08-26,Sainsbury's,5411,Groceries,Supermarket,-68.56,GBP,-153476.61,POS,London,GB,9074,user_001,,
1d273935-5363-490a-8836-a6373c5e95ce,2030-08-25,2030-08-26,Pret A Manger,5814,Food & Drink,Eating Out,-6.44,GBP,-153483.05,POS,London,GB,4488,user_001,,
88b37b31-14b3-44fc-b82f-084498d44c3a,2030-08-25,2030-08-26,Apple.com/bill,5734,Shopping,Electronics,-198.15,GBP,-153681.2,E-Com,Cupertino,US,1045,user_001,,
b41ed0c0-4a03-4b9e-82cc-5c52d5b7df0b,2030-08-25,2030-08-27,Deliveroo,5812,Food & Drink,Delivery,-16.74,GBP,-153697.94,E-Com,London,GB,2219,user_001,,
ea030d27-feda-4cbe-855b-6bd6db2e4d6f,2030-08-26,2030-08-28,Shell,5541,Transport,Fuel,-57.74,GBP,-153755.68,POS,London,GB,1045,user_002,,
4bf15e7c-f23a-4bad-9cf7-51cb093e7006,2030-08-27,2030-08-28,Amazon UK,5942,Shopping,Online Retail,-14.54,GBP,-153770.22,E-Com,London,GB,4488,user_001,,
84c88dec-03f7-4e24-bb74-7740a7e57a30,2030-08-27,2030-08-28,Waitrose,5411,Groceries,Supermarket,-69.96,GBP,-153840.18,POS,London,GB,1045,user_001,,
45ca3300-c813-411d-98b2-72bcdbaf91de,2030-08-28,2030-08-30,Apple.com/bill,5734,Shopping,Electronics,-97.83,GBP,-153938.01,E-Com,Cupertino,US,1045,user_001,,
115dde31-ae94-4e68-b450-e21a0802a057,2030-08-29,2030-09-02,Uber UK,4121,Transport,Ride Hailing,-29.58,GBP,-153967.59,E-Com,London,GB,2219,user_001,,
d9c7b0f3-d586-4cb0-a5c6-02fa96a59357,2030-08-29,2030-08-29,Waitrose,5411,Groceries,Supermarket,-21.28,GBP,-153988.87,POS,London,GB,9074,user_001,,
1ec53d11-fa88-48e2-814d-eb98646fc393,2030-08-30,2030-09-02,Amazon UK,5942,Shopping,Online Retail,-58.04,GBP,-154046.91,E-Com,London,GB,4488,user_001,,
1a997aea-fc92-469c-85a9-b732f460cfc6,2030-08-31,2030-09-02,Sainsbury's,5411,Groceries,Supermarket,-51.63,GBP,-154098.54,POS,London,GB,9074,user_001,,
a92205e1-9ab8-4604-bae6-5dc7af56a011,2030-08-31,2030-09-02,Transport for London,4111,Transport,Transit,-5.08,GBP,-154103.62,POS,London,GB,4488,user_001,,
ccb32305-1683-4c5f-81b5-fc96a1566a75,2030-08-31,2030-09-02,Sainsbury's,5411,Groceries,Supermarket,-23.41,GBP,-154127.03,POS,London,GB,4488,user_001,,
40304be5-6afd-40ec-9e78-1eacf1780f90,2030-09-01,2030-09-02,Shell,5541,Transport,Fuel,-70.75,GBP,-154197.78,POS,London,GB,9074,user_001,,
548aba1a-a509-4a21-939b-cb76e56e18d8,2030-09-01,2030-09-02,Uber UK,4121,Transport,Ride Hailing,-31.09,GBP,-154228.87,E-Com,London,GB,9074,user_001,,
7538f956-29bc-4102-b7ba-c4366d8200ab,2030-09-01,2030-09-02,Tesco,5411,Groceries,Supermarket,-29.79,GBP,-154258.66,POS,London,GB,4488,user_002,,
59a589c5-77de-44a5-8c15-5a8e66bc6e91,2030-09-02,2030-09-02,Shell,5541,Transport,Fuel,-32.85,GBP,-154291.51,POS,London,GB,4488,user_001,,
bdc703cd-2eaa-4213-ab53-8471503d5422,2030-09-02,2030-09-04,Crown Estates Lettings,6513,Housing,Rent,-1568.88,GBP,-155860.39,POS,London,GB,2219,user_001,rec_19f70fbcce,
fa0cc603-0c47-4835-8098-325458679991,2030-09-02,2030-09-03,Local Market,5499,Groceries,Specialty,-16.12,GBP,-155876.51,POS,London,GB,2219,user_001,,
1abc837b-0377-4802-b2f1-58b233fc3755,2030-09-03,2030-09-05,Transport for London,4111,Transport,Transit,-4.79,GBP,-155881.3,POS,London,GB,2219,user_002,,
2b4ba8c9-cc3e-4b23-bd9e-4191e674c514,2030-09-04,2030-09-05,Sainsbury's,5411,Groceries,Supermarket,-22.2,GBP,-155903.5,POS,London,GB,4488,user_001,,
795ca059-51db-44a8-9dba-14fe44ae1b5d,2030-09-04,2030-09-06,Amazon UK,5942,Shopping,Online Retail,-79.81,GBP,-155983.31,E-Com,London,GB,1045,user_002,,
fdef106c-7f5b-42c2-8a6e-b6457d1ecbff,2030-09-04,2030-09-06,Tesco,5411,Groceries,Supermarket,-74.34,GBP,-156057.65,POS,London,GB,4488,user_001,,
ff36c16d-4aae-4071-b0fe-67ad73d207e5,2030-09-05,2030-09-06,Deliveroo,5812,Food & Drink,Delivery,-14.13,GBP,-156071.78,E-Com,London,GB,2219,user_002,,
00dfeac5-834e-4eae-b56d-6f3c799bfbbf,2030-09-06,2030-09-09,Uber UK,4121,Transport,Ride Hailing,-17.3,GBP,-156089.08,E-Com,London,GB,4488,user_001,,
130e5579-5524-449f-9443-1021686746db,2030-09-07,2030-09-09,Uber UK,4121,Transport,Ride Hailing,-27.56,GBP,-156116.64,E-Com,London,GB,4488,user_001,,
570e663c-378e-4c74-91fb-a1db3399f4ba,2030-09-07,2030-09-09,Uber UK,4121,Transport,Ride Hailing,-28.9,GBP,-156145.54,E-Com,London,GB,1045,user_001,,
931ef84e-d837-47de-8cba-e07a8a519dfb,2030-09-07,2030-09-09,Transport for London,4111,Transport,Transit,-6.78,GBP,-156152.32,POS,London,GB,2219,user_001,,
afbb7481-804a-4a9e-9e1f-a0766197ceba,2030-09-07,2030-09-09,Local Market,5499,Groceries,Specialty,-15.2,GBP,-156167.52,POS,London,GB,1045,user_001,,
44870073-689a-420c-97d1-24e87960fbe8,2030-09-08,2030-09-10,Local Market,5499,Groceries,Specialty,-17.94,GBP,-156185.46,POS,London,GB,4488,user_001,,
57359971-764a-4f71-9bf9-37ca8f67c8a6,2030-09-08,2030-09-09,Tesco,5411,Groceries,Supermarket,-26.57,GBP,-156212.03,POS,London,GB,2219,user_001,,
896428c5-7fe6-4285-ab21-303ab7038fd1,2030-09-08,2030-09-09,Uber UK,4121,Transport,Ride Hailing,-9.96,GBP,-156221.99,E-Com,London,GB,4488,user_001,,
3065f814-2358-4f72-8eac-4450cd2e56e6,2030-09-09,2030-09-11,Octopus Energy,4900,Utilities,Electricity,-113.02,GBP,-156335.01,Direct Debit,London,GB,4488,user_001,rec_141a4a0666,
bbcec767-dc24-4902-8282-b61f381b5bef,2030-09-09,2030-09-10,Deliveroo,5812,Food & Drink,Delivery,-29.74,GBP,-156364.75,E-Com,London,GB,4488,user_001,,
c1db2318-ed49-41f3-b7c5-5bbe4c84df67,2030-09-09,2030-09-10,Tesco,5411,Groceries,Supermarket,-74.0,GBP,-156438.75,POS,London,GB,9074,user_001,,
d9b315d7-4600-41b0-8cd2-5e2b0c7f66bc,2030-09-09,2030-09-10,Local Market,5499,Groceries,Specialty,-18.4,GBP,-156457.15,POS,London,GB,4488,user_001,,
f7508ded-3bff-4047-9a26-e5986703118f,2030-09-09,2030-09-09,Amazon UK,5942,Shopping,Online Retail,-69.43,GBP,-156526.58,E-Com,London,GB,4488,user_001,,
ccec7fe0-6948-489e-916a-010099a39f34,2030-09-10,2030-09-11,Waitrose,5411,Groceries,Supermarket,-41.55,GBP,-156568.13,POS,London,GB,2219,user_001,,
2ddaf3c5-fa32-4ed0-804d-c00ecbaf64e9,2030-09-11,2030-09-13,Thames Water,4900,Utilities,Water,-35.97,GBP,-156604.1,Direct Debit,Reading,GB,4488,user_001,rec_3a34d62842,
3743354f-0dff-404c-8509-42843710b2f3,2030-09-11,2030-09-13,Transport for London,4111,Transport,Transit,-8.32,GBP,-156612.42,POS,London,GB,4488,user_001,,
bf9d85cd-b28c-4d64-b2e2-b73a203eab6a,2030-09-11,2030-09-11,Tesco,5411,Groceries,Supermarket,-76.26,GBP,-156688.68,POS,London,GB,9074,user_002,,
715e2609-e14f-40ee-b741-2edc2be3912f,2030-09-12,2030-09-13,Sainsbury's,5411,Groceries,Supermarket,-34.43,GBP,-156723.11,POS,London,GB,9074,user_001,,
d446330d-5a16-4e1d-8f6c-ffe85e5a4ae7,2030-09-12,2030-09-12,Sainsbury's,5411,Groceries,Supermarket,-48.46,GBP,-156771.57,POS,London,GB,1045,user_001,,
38bda75c-7dd6-48cc-9740-9898dfac2038,2030-09-13,2030-09-13,Amazon UK,5942,Shopping,Online Retail,-28.29,GBP,-156799.86,E-Com,London,GB,4488,user_001,,
55f5d020-46c0-405b-b417-980a1caca10f,2030-09-13,2030-09-16,City Council Tax,9399,Utilities,Council Tax,-165.45,GBP,-156965.31,Direct Debit,London,GB,2219,user_001,rec_f531495db5,
6cd1109d-579f-462f-bf68-5bec68490c74,2030-09-13,2030-09-16,Pret A Manger,5814,Food & Drink,Eating Out,-7.07,GBP,-156972.38,POS,London,GB,9074,user_002,,
b7322c92-64da-4719-aefe-616dbba087ba,2030-09-13,2030-09-16,Transport for London,4111,Transport,Transit,-10.18,GBP,-156982.56,POS,London,GB,9074,user_002,,
0e01a5b6-3ba3-42df-81b0-3656c9f65637,2030-09-14,2030-09-16,Apple.com/bill,5734,Shopping,Electronics,-38.72,USD,-157021.28,E-Com,Cupertino,US,2219,user_001,,FX purchase 48.9 USD @ rate 1.26
80da3049-04ec-42e5-b72c-262aa0e0fcdb,2030-09-14,2030-09-16,Sainsbury's,5411,Groceries,Supermarket,-46.37,GBP,-157067.65,POS,London,GB,4488,user_001,,
38314a04-1ae1-426d-ad2c-282ad49328d5,2030-09-15,2030-09-16,Pret A Manger,5814,Food & Drink,Eating Out,-6.23,GBP,-157073.88,POS,London,GB,2219,user_002,,
4ce8a1ff-31de-47f3-9bbe-77ee34787823,2030-09-15,2030-09-17,Amazon UK,5942,Shopping,Online Retail,-67.37,GBP,-157141.25,E-Com,London,GB,4488,user_001,,
9ff7d85c-9e2b-4454-b8d6-ab9e992f0bb3,2030-09-15,2030-09-16,Transport for London,4111,Transport,Transit,-3.91,GBP,-157145.16,POS,London,GB,1045,user_001,,
7440e143-66ee-4a21-99fd-da2946307269,2030-09-16,2030-09-16,Local Market,5499,Groceries,Specialty,-13.01,GBP,-157158.17,POS,London,GB,9074,user_002,,
74df605c-d320-44a5-9d99-8724aa692825,2030-09-16,2030-09-17,Apple.com/bill,5734,Shopping,Electronics,-143.98,USD,-157302.15,E-Com,Cupertino,US,4488,user_001,,FX purchase 176.37 USD @ rate 1.22
cd5dae5d-a811-4e1c-bea5-d8f903e30a73,2030-09-16,2030-09-17,O2 UK,4814,Bills,Mobile,-51.45,GBP,-157353.6,Direct Debit,Slough,GB,2219,user_002,rec_d2dce4c42f,
72eeb8df-e577-4925-b73a-1a03e196273e,2030-09-17,2030-09-19,GymBox,7997,Wellness,Gym,-53.56,GBP,-157407.16,Direct Debit,London,GB,4488,user_001,rec_3906953fd2,
2d099417-c26e-4c37-a6f3-561027f67cb5,2030-09-18,2030-09-18,Uber UK,4121,Transport,Ride Hailing,-24.19,GBP,-157431.35,E-Com,London,GB,9074,user_001,,
bb29875d-e563-45ca-8d5c-ab5c73a7968f,2030-09-18,2030-09-18,Sainsbury's,5411,Groceries,Supermarket,-22.13,GBP,-157453.48,POS,London,GB,2219,user_001,,
612ebc0e-e91f-438c-ab99-a0b43d9aa9dc,2030-09-19,2030-09-20,Uber UK,4121,Transport,Ride Hailing,-16.84,GBP,-157470.32,E-Com,London,GB,4488,user_002,,
c6052b22-9bb8-4eea-b7d1-2683a92f58b4,2030-09-19,2030-09-19,Pret A Manger,5814,Food & Drink,Eating Out,-11.17,GBP,-157481.49,POS,London,GB,2219,user_001,,
d6b9d7c9-b05f-439e-a124-e06a428953c3,2030-09-19,2030-09-23,Amazon UK,5942,Shopping,Online Retail,-62.0,GBP,-157543.49,E-Com,London,GB,1045,user_001,,
e7b84121-c7e5-4587-afe4-153251eea600,2030-09-19,2030-09-20,Spotify,5735,Entertainment,Subscriptions,-8.18,GBP,-157551.67,E-Com,Stockholm,SE,9074,user_001,rec_4c746d2c3b,
0e775099-1406-484e-86a6-13cccad9d1d2,2030-09-21,2030-09-23,Uber UK,4121,Transport,Ride Hailing,-26.81,GBP,-157578.48,E-Com,London,GB,9074,user_001,,
59f1dfde-b54d-4dba-9ac9-2da353d3ac62,2030-09-21,2030-09-23,Pret A Manger,5814,Food & Drink,Eating Out,-8.94,GBP,-157587.42,POS,London,GB,2219,user_001,,
8337948b-942c-4307-b095-98514649baee,2030-09-21,2030-09-23,Shell,5541,Transport,Fuel,-50.35,GBP,-157637.77,POS,London,GB,2219,user_001,,
a91c1e2c-2ffb-4ddc-8228-c07bb7cf35d4,2030-09-21,2030-09-23,Local Market,5499,Groceries,Specialty,-18.62,GBP,-157656.39,POS,London,GB,2219,user_001,,
a9412c05-200a-4069-8448-db4519147ab3,2030-09-21,2030-09-23,Uber UK,4121,Transport,Ride Hailing,-11.97,GBP,-157668.36,E-Com,London,GB,2219,user_001,,
b9df95c9-88df-439d-aa1c-8fbe68739f77,2030-09-21,2030-09-23,Local Market,5499,Groceries,Specialty,-17.04,GBP,-157685.4,POS,London,GB,9074,user_001,,
57f3ad8c-b409-498a-800e-c64fe9dec076,2030-09-22,2030-09-23,Tesco,5411,Groceries,Supermarket,-42.14,GBP,-157727.54,POS,London,GB,1045,user_002,,
7df41fe3-64de-4fe2-9bc3-a815c81904f4,2030-09-22,2030-09-24,Transport for London,4111,Transport,Transit,-3.6,GBP,-157731.14,POS,London,GB,4488,user_001,,
9b36b6be-fbc0-401b-81cf-b91ed1bc00f1,2030-09-22,2030-09-23,Deliveroo,5812,Food & Drink,Delivery,-25.8,GBP,-157756.94,E-Com,London,GB,9074,user_001,,
b0ee5abb-68ab-4b44-8f20-67c70d870325,2030-09-22,2030-09-24,Pret A Manger,5814,Food & Drink,Eating Out,-9.97,GBP,-157766.91,POS,London,GB,9074,user_002,,
bdc630a6-981a-4aa7-bc7f-99e939b033d6,2030-09-23,2030-09-24,Netflix,7841,Entertainment,Subscriptions,-11.65,USD,-157778.56,E-Com,Los Gatos,US,4488,user_001,rec_1bfe33738d,FX purchase 14.52 USD @ rate 1.25
5405a236-c497-4890-972a-95c805909696,2030-09-25,2030-09-27,Deliveroo,5812,Food & Drink,Delivery,-31.74,GBP,-157810.3,E-Com,London,GB,2219,user_002,,
c6d9fcfc-41cc-408b-9b3f-52decf43534c,2030-09-25,2030-09-25,T212 Capital,6011,Income,Salary,3081.17,GBP,-154729.13,Credit,London,GB,9074,user_001,rec_2ff8f778d0,
509991d8-5ae8-49f8-9e9a-454d00932847,2030-09-26,2030-09-30,Uber UK,4121,Transport,Ride Hailing,-17.98,GBP,-154747.11,E-Com,London,GB,9074,user_001,,
28216553-93f0-42d1-adfd-e1c258fe7220,2030-09-28,2030-09-30,Transport for London,4111,Transport,Transit,-4.5,GBP,-154751.61,POS,London,GB,2219,user_001,,
92503271-2947-4747-821d-981ea8b96fd6,2030-09-28,2030-09-30,Local Market,5499,Groceries,Specialty,-18.42,GBP,-154770.03,POS,London,GB,4488,user_001,,
ab246a35-35b5-4855-9366-8f83490a3a41,2030-09-28,2030-09-30,Uber UK,4121,Transport,Ride Hailing,-13.12,GBP,-154783.15,E-Com,London,GB,1045,user_002,,
cf26cca4-747f-45c4-a624-fb913f687001,2030-09-28,2030-09-30,Shell,5541,Transport,Fuel,-88.94,GBP,-154872.09,POS,London,GB,9074,user_001,,
e4372c39-9161-4e28-8eb6-c937766c39cf,2030-09-28,2030-09-30,Shell,5541,Transport,Fuel,-94.96,GBP,-154967.05,POS,London,GB,2219,user_001,,
0409f499-b7ea-42c4-8b89-a01b22cbd82c,2030-09-29,2030-09-30,Deliveroo,5812,Food & Drink,Delivery,-21.66,GBP,-154988.71,E-Com,London,GB,9074,user_001,,
53bbaee9-0243-42fb-9897-5e609bd72680,2030-09-29,2030-09-30,Apple.com/bill,5734,Shopping,Electronics,-117.07,GBP,-155105.78,E-Com,Cupertino,US,1045,user_001,,
684ccda5-47fe-4c45-b5f3-3985536b0b8b,2030-09-29,2030-10-01,Apple.com/bill,5734,Shopping,Electronics,-86.26,GBP,-155192.04,E-Com,Cupertino,US,2219,user_001,,
9d771598-083b-4d5f-8fc9-9856313a2786,2030-09-29,2030-09-30,Transport for London,4111,Transport,Transit,-10.16,GBP,-155202.2,POS,London,GB,4488,user_001,,
b7535cfa-4fdb-4372-8f97-7abaff4e7c2a,2030-09-29,2030-09-30,Waitrose,5411,Groceries,Supermarket,-63.69,GBP,-155265.89,POS,London,GB,1045,user_001,,
17c83315-84d1-4531-9aa3-5f1acac5ddd5,2030-09-30,2030-10-01,Waitrose,5411,Groceries,Supermarket,-54.26,GBP,-155320.15,POS,London,GB,9074,user_002,,
6419a454-0518-4405-92e5-c22863ebfac7,2030-09-30,2030-10-02,ATM Withdrawal,6011,Cash,ATM,-103.6,GBP,-155423.75,ATM,London,GB,4488,user_001,,
85424586-f461-42db-8be5-74f9339d7bb7,2030-10-01,2030-10-01,Sainsbury's,5411,Groceries,Supermarket,-63.83,GBP,-155487.58,POS,London,GB,2219,user_001,,
bcb7b8ab-e999-4f42-8303-5c096511ff22,2030-10-01,2030-10-01,Shell,5541,Transport,Fuel,-80.74,GBP,-155568.32,POS,London,GB,4488,user_002,,
dce1df31-cf2e-48fb-9f22-506fe76c0450,2030-10-01,2030-10-02,Crown Estates Lettings,6513,Housing,Rent,-1617.55,GBP,-157185.87,POS,London,GB,4488,user_001,rec_19f70fbcce,
3d0af5da-c09e-4bb7-85d7-bb1356362c8c,2030-10-02,2030-10-03,Uber UK,4121,Transport,Ride Hailing,-19.47,GBP,-157205.34,E-Com,London,GB,1045,user_002,,
7cf9b2f9-3b6c-458f-941e-29e1215f0ccb,2030-10-02,2030-10-04,Transport for London,4111,Transport,Transit,-7.44,GBP,-157212.78,POS,London,GB,1045,user_001,,
949c7664-03c8-4d24-a28f-dbd153b468a0,2030-10-03,2030-10-04,ATM Withdrawal,6011,Cash,ATM,-71.24,GBP,-157284.02,ATM,London,GB,1045,user_001,,
628186a0-df87-4bbe-b54c-0a0402045839,2030-10-04,2030-10-07,Uber UK,4121,Transport,Ride Hailing,-12.79,GBP,-157296.81,E-Com,London,GB,1045,user_001,,
d5bcaf20-6728-4302-a746-2a7362d2cd83,2030-10-04,2030-10-04,Sainsbury's,5411,Groceries,Supermarket,-24.69,GBP,-157321.5,POS,London,GB,9074,user_001,,
2c822d80-b3ac-495d-80c2-99164c874876,2030-10-05,2030-10-07,Amazon UK,5942,Shopping,Online Retail,-48.09,GBP,-157369.59,E-Com,London,GB,4488,user_001,,
4316ec73-dc92-4769-880e-875eca9ac2ec,2030-10-05,2030-10-07,Shell,5541,Transport,Fuel,-91.54,GBP,-157461.13,POS,London,GB,9074,user_001,,
4a577f74-818b-4e66-93de-dc4da330c812,2030-10-05,2030-10-07,Waitrose,5411,Groceries,Supermarket,-69.58,GBP,-157530.71,POS,London,GB,4488,user_001,,
5ef1d876-db93-41b3-a55e-4e65ac29c7e9,2030-10-05,2030-10-07,Sainsbury's,5411,Groceries,Supermarket,-64.96,GBP,-157595.67,POS,London,GB,2219,user_001,,
fa8c5056-84b3-4882-a2bb-54b04574dc2e,2030-10-05,2030-10-07,Shell,5541,Transport,Fuel,-83.02,GBP,-157678.69,POS,London,GB,2219,user_001,,
33d52e14-5c21-49f0-b1f9-5799939a838c,2030-10-06,2030-10-08,Pret A Manger,5814,Food & Drink,Eating Out,-7.92,GBP,-157686.61,POS,London,GB,4488,user_001,,
3fd15de7-8c92-4baa-ae68-66742e9a2c0e,2030-10-06,2030-10-08,ATM Withdrawal,6011,Cash,ATM,-117.21,GBP,-157803.82,ATM,London,GB,4488,user_002,,
432777aa-ee56-4664-91e4-1c766bc80e8e,2030-10-06,2030-10-07,Deliveroo,5812,Food & Drink,Delivery,-21.79,GBP,-157825.61,E-Com,London,GB,4488,user_001,,
36f2e123-a819-4591-861c-d34149103498,2030-10-07,2030-10-09,Local Market,5499,Groceries,Specialty,-19.9,GBP,-157845.51,POS,London,GB,9074,user_001,,
42e4063f-c5c0-4248-9ac7-d1f0a820f25c,2030-10-07,2030-10-07,Octopus Energy,4900,Utilities,Electricity,-142.29,GBP,-157987.8,Direct Debit,London,GB,2219,user_001,rec_141a4a0666,
59a26451-5812-4581-bbcd-ed09d7e79d1c,2030-10-07,2030-10-08,Local Market,5499,Groceries,Specialty,-11.37,GBP,-157999.17,POS,London,GB,9074,user_001,,
43c7412f-d481-402f-a5fb-43ea64cb8221,2030-10-08,2030-10-09,Local Market,5499,Groceries,Specialty,-7.52,GBP,-158006.69,POS,London,GB,2219,user_001,,
64e5d3f3-7b88-4536-af5d-a84600872357,2030-10-08,2030-10-09,Local Market,5499,Groceries,Specialty,-9.25,GBP,-158015.94,POS,London,GB,2219,user_001,,
986f62aa-23ed-4afb-b74c-6c4a3ab4277f,2030-10-08,2030-10-08,Uber UK,4121,Transport,Ride Hailing,-16.8,GBP,-158032.74,E-Com,London,GB,1045,user_001,,
c3a04398-60ab-4ef8-ad04-0e051d8794be,2030-10-08,2030-10-08,Transport for London,4111,Transport,Transit,-11.79,GBP,-158044.53,POS,London,GB,9074,user_001,,
5693d31e-ffc7-4d58-af56-91a3ea999efa,2030-10-10,2030-10-10,Tesco,5411,Groceries,Supermarket,-48.57,GBP,-158093.1,POS,London,GB,4488,user_001,,
af9ed0ee-21ba-4191-9492-5cec7e935552,2030-10-11,2030-10-14,Thames Water,4900,Utilities,Water,-44.0,GBP,-158137.1,Direct Debit,Reading,GB,1045,user_001,rec_3a34d62842,
1acbe85e-99cc-4f5e-871a-fa707bdec882,2030-10-12,2030-10-14,Apple.com/bill,5734,Shopping,Electronics,-10.33,USD,-158147.43,E-Com,Cupertino,US,9074,user_001,,FX purchase 12.69 USD @ rate 1.23
1b2208b4-42a6-4081-a49b-1981651a9c2a,2030-10-12,2030-10-14,Waitrose,5411,Groceries,Supermarket,-53.99,GBP,-158201.42,POS,London,GB,1045,user_002,,
2dcc2416-2e9d-40e1-bdd3-234b2322ce35,2030-10-12,2030-10-14,Shell,5541,Transport,Fuel,-32.91,GBP,-158234.33,POS,London,GB,1045,user_001,,
9759118f-3e76-46b2-86b3-a5b43aaaf17d,2030-10-12,2030-10-14,Waitrose,5411,Groceries,Supermarket,-22.93,GBP,-158257.26,POS,London,GB,1045,user_001,,
9b9e82f2-e2f1-4fe9-8b67-135ad460e993,2030-10-12,2030-10-14,Pret A Manger,5814,Food & Drink,Eating Out,-11.39,GBP,-158268.65,POS,London,GB,2219,user_001,,
a64b4598-1c33-44a4-a9ca-2d5828478a3b,2030-10-12,2030-10-14,Shell,5541,Transport,Fuel,-57.22,GBP,-158325.87,POS,London,GB,4488,user_001,,
af80a3eb-a666-44a7-8fe5-fb3f8dc58cbc,2030-10-13,2030-10-15,Deliveroo,5812,Food & Drink,Delivery,-17.53,GBP,-158343.4,E-Com,London,GB,1045,user_001,,
c16f41c8-9318-4cdf-9fe2-e540ec7a12b8,2030-10-13,2030-10-14,Transport for London,4111,Transport,Transit,-6.83,GBP,-158350.23,POS,London,GB,2219,user_001,,
f06fd648-447d-44ed-9f3f-0ffff11ac4f3,2030-10-13,2030-10-14,Pret A Manger,5814,Food & Drink,Eating Out,-11.02,GBP,-158361.25,POS,London,GB,4488,user_001,,
f458bac8-e01e-4938-a9e2-c5891fb29443,2030-10-13,2030-10-15,Shell,5541,Transport,Fuel,-86.88,GBP,-158448.13,POS,London,GB,1045,user_002,,
3860b722-6d90-4258-b195-1880b9f34701,2030-10-14,2030-10-16,City Council Tax,9399,Utilities,Council Tax,-181.94,GBP,-158630.07,Direct Debit,London,GB,4488,user_001,rec_f531495db5,
67f3f28d-9bea-4600-9e04-d35db789fb68,2030-10-14,2030-10-14,Amazon UK,5942,Shopping,Online Retail,-63.59,GBP,-158693.66,E-Com,London,GB,1045,user_001,,
09ca3d7f-a216-47c7-b8f0-03213acec658,2030-10-15,2030-10-15,O2 UK,4814,Bills,Mobile,-37.11,GBP,-158730.77,Direct Debit,Slough,GB,9074,user_001,rec_95042d8101,
6938b1d5-73c2-4e74-b54e-84bcbf1cb18a,2030-10-15,2030-10-15,Sainsbury's,5411,Groceries,Supermarket,-25.23,GBP,-158756.0,POS,London,GB,1045,user_002,,
cc6fe41b-7884-4d4d-9525-2091414fd71a,2030-10-16,2030-10-17,Deliveroo,5812,Food & Drink,Delivery,-33.05,GBP,-158789.05,E-Com,London,GB,1045,user_001,,
8a219abb-05dc-4eb7-a03a-a523cc3c4d80,2030-10-17,2030-10-17,Local Market,5499,Groceries,Specialty,-21.13,GBP,-158810.18,POS,London,GB,9074,user_002,,
ca94789d-915f-4cc8-9a1b-c77764166642,2030-10-17,2030-10-21,GymBox,7997,Wellness,Gym,-51.47,GBP,-158861.65,Direct Debit,London,GB,1045,user_001,rec_3906953fd2,
44b06f75-1e71-453c-86b0-40dbaab312e9,2030-10-18,2030-10-18,Waitrose,5411,Groceries,Supermarket,-56.99,GBP,-158918.64,POS,London,GB,1045,user_001,,
906430e5-3b0a-4118-a23d-c6faea2927dd,2030-10-18,2030-10-21,Local Market,5499,Groceries,Specialty,-13.72,GBP,-158932.36,POS,London,GB,9074,user_001,,
0ace46bc-9f6b-4a7f-a564-f32d9e853f11,2030-10-19,2030-10-21,Amazon UK,5942,Shopping,Online Retail,-104.64,GBP,-159037.0,E-Com,London,GB,1045,user_001,,
1cbc2797-7d6e-4cfd-836c-e98a9c9ca2d8,2030-10-19,2030-10-21,HM Revenue & Customs,9311,Income,Tax Refund,51.68,GBP,-158985.32,Credit,London,GB,4488,user_001,,Refund for Sainsbury's
9d07beb8-d778-4a0d-a52d-c0d3c53c7335,2030-10-19,2030-10-21,Local Market,5499,Groceries,Specialty,-20.73,GBP,-159006.05,POS,London,GB,9074,user_001,,
ab45c1ce-6b00-4c40-bf55-ad2039fcb265,2030-10-19,2030-10-21,Uber UK,4121,Transport,Ride Hailing,-23.41,GBP,-159029.46,E-Com,London,GB,2219,user_002,,
c0d15c41-6423-46d3-a24a-e371a31a8bb0,2030-10-19,2030-10-21,Transport for London,4111,Transport,Transit,-7.92,GBP,-159037.38,POS,London,GB,9074,user_001,,
c1e642fe-63f1-4650-abcf-68695b4cb428,2030-10-19,2030-10-21,Uber UK,4121,Transport,Ride Hailing,-19.01,GBP,-159056.39,E-Com,London,GB,2219,user_002,,
dacc9b31-8b77-4887-8365-68096e1bd3e8,2030-10-19,2030-10-21,Airline Refund,4511,Travel,Refund,46.89,GBP,-159009.5,Credit,London,GB,9074,user_002,,Refund for ATM Withdrawal
de2da2a5-a00b-4b1a-bf9c-9653cfbb7e81,2030-10-19,2030-10-21,Amazon UK,5942,Shopping,Online Retail,-71.97,GBP,-159081.47,E-Com,London,GB,2219,user_002,,
e704474f-5838-474e-8983-c554d0b78dc6,2030-10-19,2030-10-21,Pret A Manger,5814,Food & Drink,Eating Out,-11.45,GBP,-159092.92,POS,London,GB,1045,user_001,,
26518589-de84-4713-bb08-da8c69f7dd97,2030-10-20,2030-10-21,Airline Refund,4511,Travel,Refund,4.87,GBP,-159088.05,Credit,London,GB,9074,user_001,,Refund for Transport for London
e06293e2-801c-4e1c-b40e-15b42ec3cc18,2030-10-20,2030-10-21,Transport for London,4111,Transport,Transit,-3.83,GBP,-159091.88,POS,London,GB,9074,user_001,,
22c1ce7f-1be0-42f5-9288-2769d4c3d4e9,2030-10-21,2030-10-21,Tesco,5411,Groceries,Supermarket,-33.2,GBP,-159125.08,POS,London,GB,4488,user_002,,
a5676434-fde2-403b-a504-ca9bb6f99b41,2030-10-21,2030-10-21,Spotify,5735,Entertainment,Subscriptions,-8.98,GBP,-159134.06,E-Com,Stockholm,SE,2219,user_001,rec_4c746d2c3b,
af5a0009-ee52-4017-9df6-dbd7887e04d5,2030-10-21,2030-10-22,Netflix,7841,Entertainment,Subscriptions,-15.68,GBP,-159149.74,E-Com,Los Gatos,US,1045,user_001,rec_1bfe33738d,
214d98f9-476c-471a-b824-3b1d47fa874e,2030-10-22,2030-10-22,Transport for London,4111,Transport,Transit,-5.88,GBP,-159155.62,POS,London,GB,1045,user_001,,
41e0d2ac-7523-415b-8532-969c39104cd3,2030-10-22,2030-10-23,Uber UK,4121,Transport,Ride Hailing,-21.65,GBP,-159177.27,E-Com,London,GB,1045,user_001,,
9ec2e1fc-6fc5-4904-b732-6b43ab47a89a,2030-10-22,2030-10-23,Pret A Manger,5814,Food & Drink,Eating Out,-11.68,GBP,-159188.95,POS,London,GB,2219,user_001,,
2840a80d-5d4f-43dc-9d80-00cccd5bc0ad,2030-10-23,2030-10-25,Transport for London,4111,Transport,Transit,-8.46,GBP,-159197.41,POS,London,GB,1045,user_001,,
6dbd6086-f90b-422b-9efc-e7d6d1d0c40c,2030-10-23,2030-10-25,Waitrose,5411,Groceries,Supermarket,-89.76,GBP,-159287.17,POS,London,GB,1045,user_001,,
9ad7c4b1-86a6-4868-ba3f-ad8e12da1216,2030-10-24,2030-10-25,Local Market,5499,Groceries,Specialty,-16.93,GBP,-159304.1,POS,London,GB,4488,user_001,,
fdddeb71-76c7-4a8e-aaeb-d16f82ac3c95,2030-10-24,2030-10-25,Apple.com/bill,5734,Shopping,Electronics,-38.44,USD,-159342.54,E-Com,Cupertino,US,9074,user_002,,FX purchase 48.33 USD @ rate 1.26
41c37926-e18c-4d6d-82f5-94245d1189cd,2030-10-25,2030-10-25,T212 Capital,6011,Income,Salary,2998.34,GBP,-156344.2,Credit,London,GB,9074,user_002,rec_c649d24d0f,
b7f6625c-f02d-4528-8d75-bbe1a0a72eaa,2030-10-25,2030-10-25,Apple.com/bill,5734,Shopping,Electronics,-192.35,GBP,-156536.55,E-Com,Cupertino,US,2219,user_001,,
fe4982ac-df6d-4d33-bbc5-1716e512d0d0,2030-10-25,2030-10-25,Pret A Manger,5814,Food & Drink,Eating Out,-5.51,GBP,-156542.06,POS,London,GB,2219,user_002,,
44d120ae-e8a2-43a4-82ba-e178da901978,2030-10-26,2030-10-28,Sainsbury's,5411,Groceries,Supermarket,-52.0,GBP,-156594.06,POS,London,GB,1045,user_001,,
5e699c50-fb77-48b6-b823-d9bc7495c04d,2030-10-26,2030-10-28,ATM Withdrawal,6011,Cash,ATM,-87.4,GBP,-156681.46,ATM,London,GB,1045,user_001,,
af5bc04b-0e77-472a-be76-ac749bd64c74,2030-10-26,2030-10-28,Deliveroo,5812,Food & Drink,Delivery,-31.47,GBP,-156712.93,E-Com,London,GB,9074,user_001,,
b14ac2e0-a68c-4699-bd39-8056db52b839,2030-10-26,2030-10-28,Amazon UK,5942,Shopping,Online Retail,-111.5,GBP,-156824.43,E-Com,London,GB,9074,user_001,,
c7d0e679-18c0-442e-9319-c967ce055c34,2030-10-26,2030-10-28,Apple.com/bill,5734,Shopping,Electronics,-78.3,GBP,-156902.73,E-Com,Cupertino,US,2219,user_001,,
061ef28b-0a22-46d0-8dd7-7497adb9347d,2030-10-27,2030-10-28,Amazon UK,5942,Shopping,Online Retail,-77.96,GBP,-156980.69,E-Com,London,GB,4488,user_001,,
5b6cc210-59b8-4ad5-b573-b263e5de2ff6,2030-10-27,2030-10-28,Tesco,5411,Groceries,Supermarket,-39.27,GBP,-157019.96,POS,London,GB,4488,user_001,,
92da6a8b-707d-4496-b3b4-a323c7120897,2030-10-27,2030-10-28,Tesco,5411,Groceries,Supermarket,-30.71,GBP,-157050.67,POS,London,GB,9074,user_001,,
9b6e6b2d-d3af-47e4-b5be-aaad226882b5,2030-10-27,2030-10-28,Pret A Manger,5814,Food & Drink,Eating Out,-6.65,GBP,-157057.32,POS,London,GB,9074,user_002,,
df17a197-cb25-48a7-b15c-68681d7474ab,2030-10-27,2030-10-28,Amazon UK,5942,Shopping,Online Retail,-54.2,GBP,-157111.52,E-Com,London,GB,1045,user_002,,
8cbbcf6b-b1b8-4393-8252-f3abe5e79c70,2030-10-28,2030-10-30,Tesco,5411,Groceries,Supermarket,-61.01,GBP,-157172.53,POS,London,GB,2219,user_001,,
bef3fb15-7c12-47be-9bef-725c857a4ae4,2030-10-28,2030-10-30,Amazon UK,5942,Shopping,Online Retail,-94.68,GBP,-157267.21,E-Com,London,GB,9074,user_001,,
42271c38-b888-4201-9c6b-edec02f10aa2,2030-10-29,2030-10-29,Local Market,5499,Groceries,Specialty,-8.75,GBP,-157275.96,POS,London,GB,9074,user_001,,
4757c3ed-7f3d-4f5b-a2dc-472f1d1b5743,2030-10-30,2030-11-01,Shell,5541,Transport,Fuel,-61.58,GBP,-157337.54,POS,London,GB,1045,user_001,,
1776e77f-1dc2-4d6c-a6e9-a145880bad25,2030-10-31,2030-11-04,Apple.com/bill,5734,Shopping,Electronics,-74.37,GBP,-157411.91,E-Com,Cupertino,US,2219,user_001,,
05845195-85d9-4b00-a761-7b2ae89e4772,2030-11-01,2030-11-04,Crown Estates Lettings,6513,Housing,Rent,-1520.08,GBP,-158931.99,POS,London,GB,2219,user_001,rec_19f70fbcce,
5d2ddf96-fe6d-4134-b486-09e9685ba998,2030-11-01,2030-11-04,Deliveroo,5812,Food & Drink,Delivery,-29.73,GBP,-158961.72,E-Com,London,GB,4488,user_001,,
021bd898-7382-423e-9bb8-cd2ab25d0745,2030-11-02,2030-11-04,Pret A Manger,5814,Food & Drink,Eating Out,-5.87,GBP,-158967.59,POS,London,GB,4488,user_002,,
e0c4d1ee-f517-472a-9e07-1ae219eea902,2030-11-02,2030-11-04,Pret A Manger,5814,Food & Drink,Eating Out,-8.05,GBP,-158975.64,POS,London,GB,4488,user_001,,
e65a4a23-f845-4081-aca0-bd77ca0e5230,2030-11-02,2030-11-04,Tesco,5411,Groceries,Supermarket,-39.14,GBP,-159014.78,POS,London,GB,4488,user_001,,
3978c04e-ea99-49f2-bf35-572d11dcff21,2030-11-03,2030-11-04,Pret A Manger,5814,Food & Drink,Eating Out,-10.07,GBP,-159024.85,POS,London,GB,4488,user_001,,
4169dbd8-18af-46fd-966b-24a2dbd79084,2030-11-03,2030-11-04,Sainsbury's,5411,Groceries,Supermarket,-52.65,GBP,-159077.5,POS,London,GB,4488,user_001,,
f6db2e99-3826-4260-91b5-d9d226fb72fe,2030-11-03,2030-11-04,Sainsbury's,5411,Groceries,Supermarket,-60.28,GBP,-159137.78,POS,London,GB,9074,user_001,,
fe938886-266a-4d93-9507-1021b54bc6e2,2030-11-03,2030-11-04,Tesco,5411,Groceries,Supermarket,-76.28,GBP,-159214.06,POS,London,GB,1045,user_002,,
184d4f4d-0ad3-40d5-a2aa-5b3bdcab5410,2030-11-04,2030-11-06,Pret A Manger,5814,Food & Drink,Eating Out,-7.14,GBP,-159221.2,POS,London,GB,4488,user_001,,
f6420695-6b80-4676-976d-b90cc919b364,2030-11-05,2030-11-06,ATM Withdrawal,6011,Cash,ATM,-87.58,GBP,-159308.78,ATM,London,GB,2219,user_001,,
1fdc9b53-538c-4c8b-ad4e-bc197d19e569,2030-11-06,2030-11-08,Amazon UK,5942,Shopping,Online Retail,-29.16,GBP,-159337.94,E-Com,London,GB,9074,user_001,,
bee9a17f-2023-4596-bb72-a4f461ce0ea5,2030-11-06,2030-11-08,Tesco,5411,Groceries,Supermarket,-24.88,GBP,-159362.82,POS,London,GB,4488,user_001,,
e8c7d632-ac53-4f1e-9cb5-a83bf0168661,2030-11-06,2030-11-07,Deliveroo,5812,Food & Drink,Delivery,-22.94,GBP,-159385.76,E-Com,London,GB,1045,user_001,,
9fa3a561-5c4b-4104-86ee-39702b8832ce,2030-11-07,2030-11-08,Octopus Energy,4900,Utilities,Electricity,-139.25,GBP,-159525.01,Direct Debit,London,GB,4488,user_001,rec_141a4a0666,
02f1aadc-2ca5-455e-a417-d202dd749ba3,2030-11-08,2030-11-08,Airbnb,7011,Travel,Accommodation,-166.07,USD,-159691.08,E-Com,Dublin,IE,9074,user_001,,Holiday booking
083e0613-7303-488a-b985-9bd7142df787,2030-11-08,2030-11-08,Waitrose,5411,Groceries,Supermarket,-71.84,GBP,-159762.92,POS,London,GB,2219,user_001,,
83247ebb-a6b5-4931-adc6-d8b4fca2f284,2030-11-08,2030-11-08,Waitrose,5411,Groceries,Supermarket,-83.15,GBP,-159846.07,POS,London,GB,1045,user_002,,
cc171a98-a20a-420f-9ebe-17a2a6219e1d,2030-11-08,2030-11-08,Amazon UK,5942,Shopping,Online Retail,-58.23,GBP,-159904.3,E-Com,London,GB,9074,user_001,,
29af0964-ed5f-4e90-9f7f-d32cfd8f0e86,2030-11-09,2030-11-11,Deliveroo,5812,Food & Drink,Delivery,-29.32,GBP,-159933.62,E-Com,London,GB,1045,user_001,,
4cf1f0e1-dfcb-49d2-b2b0-0ebcf95a54e5,2030-11-09,2030-11-11,Tesco,5411,Groceries,Supermarket,-19.41,GBP,-159953.03,POS,London,GB,2219,user_001,,
72d05b84-1ab5-435a-83e0-a8e09707af15,2030-11-09,2030-11-11,Tesco,5411,Groceries,Supermarket,-27.35,GBP,-159980.38,POS,London,GB,4488,user_001,,
86abb710-17e8-4916-9f9d-543bb0cce667,2030-11-09,2030-11-11,Shell,5541,Transport,Fuel,-85.17,GBP,-160065.55,POS,London,GB,9074,user_001,,
df04310e-6c40-481c-af81-7e7c0767c821,2030-11-09,2030-11-11,Pret A Manger,5814,Food & Drink,Eating Out,-11.46,GBP,-160077.01,POS,London,GB,1045,user_001,,
597671b0-8840-4d1d-ad6d-a6e159d34c7a,2030-11-10,2030-11-12,Transport for London,4111,Transport,Transit,-5.81,GBP,-160082.82,POS,London,GB,1045,user_001,,
83031f2e-2f47-4191-a561-85dbae7deae2,2030-11-10,2030-11-11,Deliveroo,5812,Food & Drink,Delivery,-33.03,GBP,-160115.85,E-Com,London,GB,9074,user_001,,
9ebc3ba9-e02b-4e27-a01b-a0e6d7bcb7e1,2030-11-10,2030-11-11,Waitrose,5411,Groceries,Supermarket,-66.69,GBP,-160182.54,POS,London,GB,9074,user_001,,
0daabf82-ce50-4f3e-8558-d2bad0b4df6d,2030-11-11,2030-11-11,Thames Water,4900,Utilities,Water,-32.7,GBP,-160215.24,Direct Debit,Reading,GB,9074,user_001,rec_3a34d62842,
93994350-53a3-4262-bf66-4a9d4f69eb55,2030-11-11,2030-11-13,Tesco,5411,Groceries,Supermarket,-67.48,GBP,-160282.72,POS,London,GB,9074,user_001,,
a3c4e5d9-9568-40ea-85c6-02eed58837c7,2030-11-11,2030-11-11,Local Market,5499,Groceries,Specialty,-16.76,GBP,-160299.48,POS,London,GB,9074,user_001,,
123a50a6-d56f-4925-9207-fb9b53ddc10a,2030-11-12,2030-11-12,Transport for London,4111,Transport,Transit,-10.5,GBP,-160309.98,POS,London,GB,4488,user_001,,
144ceb50-0de3-466f-9d27-f683323c26a9,2030-11-12,2030-11-12,Waitrose,5411,Groceries,Supermarket,-52.03,GBP,-160362.01,POS,London,GB,2219,user_001,,
e1b90458-8836-497f-a557-25ca983f9c7b,2030-11-12,2030-11-13,Amazon UK,5942,Shopping,Online Retail,-57.44,GBP,-160419.45,E-Com,London,GB,4488,user_001,,
92844217-1c5d-4220-aa24-cd5a9fbde95b,2030-11-13,2030-11-13,City Council Tax,9399,Utilities,Council Tax,-188.39,GBP,-160607.84,Direct Debit,London,GB,1045,user_001,rec_f531495db5,
368417f1-43a2-43af-aac0-d5c859ebc099,2030-11-14,2030-11-15,Transport for London,4111,Transport,Transit,-11.46,GBP,-160619.3,POS,London,GB,2219,user_001,,
42bbf8e0-b022-4558-b5dc-0ffa1c3c426f,2030-11-14,2030-11-18,Pret A Manger,5814,Food & Drink,Eating Out,-11.38,GBP,-160630.68,POS,London,GB,4488,user_001,,
72878798-62f7-42c1-9594-c303898a147e,2030-11-14,2030-11-14,Tesco,5411,Groceries,Supermarket,-50.62,GBP,-160681.3,POS,London,GB,1045,user_001,,
bf8cfa82-158e-4854-b439-24606a361929,2030-11-14,2030-11-14,Uber UK,4121,Transport,Ride Hailing,-15.4,GBP,-160696.7,E-Com,London,GB,2219,user_001,,
43be9133-f00c-44ba-818b-0d55531ade35,2030-11-15,2030-11-18,ATM Withdrawal,6011,Cash,ATM,-69.92,GBP,-160766.62,ATM,London,GB,4488,user_001,,
501459ad-90ae-4bb9-9b6a-1408168abbe7,2030-11-15,2030-11-18,Shell,5541,Transport,Fuel,-54.57,GBP,-160821.19,POS,London,GB,4488,user_001,,
6d8db357-5eae-4764-aafc-36a384cafe96,2030-11-15,2030-11-18,O2 UK,4814,Bills,Mobile,-36.02,GBP,-160857.21,Direct Debit,Slough,GB,1045,user_001,rec_95042d8101,
77f0ad47-ba5a-4b49-9e97-8bafb59ab011,2030-11-15,2030-11-18,Waitrose,5411,Groceries,Supermarket,-31.86,GBP,-160889.07,POS,London,GB,4488,user_001,,
b71e7ea7-4988-46f9-b47a-ca28297143b1,2030-11-15,2030-11-18,Apple.com/bill,5734,Shopping,Electronics,-159.97,GBP,-161049.04,E-Com,Cupertino,US,2219,user_001,,
394ad748-f813-4c72-9c0d-69021c2b420f,2030-11-16,2030-11-18,Sainsbury's,5411,Groceries,Supermarket,-51.04,GBP,-161100.08,POS,London,GB,9074,user_002,,
999234a5-cbd1-4953-8075-ebd649f3a5e6,2030-11-16,2030-11-18,Uber UK,4121,Transport,Ride Hailing,-26.9,GBP,-161126.98,E-Com,London,GB,1045,user_001,,
9f5452ba-7fa5-41bf-9e1a-931d61da7d6c,2030-11-16,2030-11-18,Tesco,5411,Groceries,Supermarket,-27.72,GBP,-161154.7,POS,London,GB,1045,user_002,,
2eb15888-ed67-4237-81fa-ead6f41bcd66,2030-11-17,2030-11-19,Local Market,5499,Groceries,Specialty,-20.31,GBP,-161175.01,POS,London,GB,4488,user_001,,
9b53154b-9580-4285-b489-8ae85e3b996c,2030-11-17,2030-11-19,Shell,5541,Transport,Fuel,-65.31,GBP,-161240.32,POS,London,GB,9074,user_002,,
b2d12046-7e5b-4233-8567-c4b85b8a25e6,2030-11-17,2030-11-19,Deliveroo,5812,Food & Drink,Delivery,-13.09,GBP,-161253.41,E-Com,London,GB,1045,user_001,,
ec216cad-6518-42bf-b2ed-b251dcbd567e,2030-11-17,2030-11-18,Waitrose,5411,Groceries,Supermarket,-62.7,GBP,-161316.11,POS,London,GB,2219,user_001,,
4facdde4-8b92-4d15-ade8-41ce1f1cbaa6,2030-11-18,2030-11-19,Transport for London,4111,Transport,Transit,-7.43,GBP,-161323.54,POS,London,GB,4488,user_001,,
85521108-49d1-484f-8282-5e223a1073e7,2030-11-18,2030-11-19,Apple.com/bill,5734,Shopping,Electronics,-86.89,GBP,-161410.43,E-Com,Cupertino,US,9074,user_001,,
91dadfe3-e7c4-42ed-a25b-6633fa0a624e,2030-11-18,2030-11-19,Pret A Manger,5814,Food & Drink,Eating Out,-11.38,GBP,-161421.81,POS,London,GB,1045,user_001,,
fe608df5-c621-40e7-b49c-a60075443607,2030-11-18,2030-11-18,GymBox,7997,Wellness,Gym,-58.87,GBP,-161480.68,Direct Debit,London,GB,2219,user_001,rec_3906953fd2,
2a6af844-387a-4562-ad57-a2f7149095f1,2030-11-19,2030-11-19,Spotify,5735,Entertainment,Subscriptions,-9.79,EUR,-161490.47,E-Com,Stockholm,SE,9074,user_001,rec_4c746d2c3b,FX purchase 11.28 EUR @ rate 1.15
9b1638df-9d60-405c-bca9-155b7d2b68dd,2030-11-19,2030-11-19,Apple.com/bill,5734,Shopping,Electronics,-194.88,GBP,-161685.35,E-Com,Cupertino,US,1045,user_001,,
f625d555-9933-48f6-8fdd-18ebe677bb13,2030-11-19,2030-11-19,Uber UK,4121,Transport,Ride Hailing,-24.17,GBP,-161709.52,E-Com,London,GB,9074,user_001,,
fec3dd5f-ad9e-426d-8094-431f9b726e7d,2030-11-19,2030-11-19,Waitrose,5411,Groceries,Supermarket,-66.39,GBP,-161775.91,POS,London,GB,1045,user_001,,
4e65d16a-8b2e-43e3-a474-dd3394c6979c,2030-11-20,2030-11-22,Deliveroo,5812,Food & Drink,Delivery,-30.68,GBP,-161806.59,E-Com,London,GB,2219,user_001,,
743d5edf-2466-4f69-9eeb-319d12d11e01,2030-11-20,2030-11-20,ATM Withdrawal,6011,Cash,ATM,-81.93,GBP,-161888.52,ATM,London,GB,1045,user_001,,
a1596b53-7d6e-4574-b90e-d4a6cd437450,2030-11-20,2030-11-22,Pret A Manger,5814,Food & Drink,Eating Out,-10.29,GBP,-161898.81,POS,London,GB,9074,user_001,,
0b255ce9-b285-4fb5-8ceb-04acdb1a3bd4,2030-11-21,2030-11-22,Local Market,5499,Groceries,Specialty,-20.61,GBP,-161919.42,POS,London,GB,1045,user_001,,
3514ef29-607b-4e4e-9d5a-4e4c061a5e70,2030-11-21,2030-11-21,Uber UK,4121,Transport,Ride Hailing,-23.22,GBP,-161942.64,E-Com,London,GB,4488,user_001,,
4c45910b-2169-4c1e-8a4d-d29aa722e662,2030-11-21,2030-11-21,Uber UK,4121,Transport,Ride Hailing,-9.63,GBP,-161952.27,E-Com,London,GB,4488,user_002,,
6dbd3a0b-d5f9-4586-b9ae-6313e8d8e39c,2030-11-21,2030-11-25,Apple.com/bill,5734,Shopping,Electronics,-143.7,GBP,-162095.97,E-Com,Cupertino,US,4488,user_001,,
d5a55b53-5c34-4c1a-a70a-560eaa9dcf12,2030-11-21,2030-11-22,Netflix,7841,Entertainment,Subscriptions,-10.76,USD,-162106.73,E-Com,Los Gatos,US,2219,user_001,rec_1bfe33738d,FX purchase 12.65 USD @ rate 1.18
9a256a9a-8503-4474-9e44-de181fdd888d,2030-11-22,2030-11-25,Waitrose,5411,Groceries,Supermarket,-31.19,GBP,-162137.92,POS,London,GB,1045,user_001,,
c21b8c34-04de-4b4c-841c-7bd353be0633,2030-11-22,2030-11-25,Apple.com/bill,5734,Shopping,Electronics,-111.84,GBP,-162249.76,E-Com,Cupertino,US,1045,user_001,,
5d2ff14e-fa0c-4421-9fad-95e31bfcd762,2030-11-23,2030-11-25,Local Market,5499,Groceries,Specialty,-16.19,GBP,-162265.95,POS,London,GB,4488,user_001,,
d33f634a-0bf5-42d4-8b95-31f86c3e3c5e,2030-11-23,2030-11-25,Sainsbury's,5411,Groceries,Supermarket,-41.97,GBP,-162307.92,POS,London,GB,2219,user_001,,
42b279a7-e733-412f-8e10-35e700c12243,2030-11-24,2030-11-26,Waitrose,5411,Groceries,Supermarket,-80.61,GBP,-162388.53,POS,London,GB,9074,user_001,,
61013372-ae28-4ffa-82a8-99816fbc9d02,2030-11-24,2030-11-25,Shell,5541,Transport,Fuel,-54.66,GBP,-162443.19,POS,London,GB,9074,user_002,,
bfca5f39-db37-451b-be30-e293898117d6,2030-11-24,2030-11-26,Apple.com/bill,5734,Shopping,Electronics,-133.4,GBP,-162576.59,E-Com,Cupertino,US,9074,user_001,,
a609b00b-9c36-4063-b789-075a2b421b18,2030-11-25,2030-11-25,T212 Capital,6011,Income,Salary,3042.4,GBP,-159534.19,Credit,London,GB,1045,user_001,rec_2ff8f778d0,
fba29c58-3889-46d2-b83b-c4988a77909d,2030-11-25,2030-11-26,Uber UK,4121,Transport,Ride Hailing,-28.55,GBP,-159562.74,E-Com,London,GB,9074,user_001,,
0c10b2ab-843e-48b7-ad5a-0f0f1462c0c7,2030-11-26,2030-11-28,Amazon UK,5942,Shopping,Online Retail,-15.77,GBP,-159578.51,E-Com,London,GB,4488,user_001,,
6ff64354-f47c-4655-9736-c5cbb736d53b,2030-11-26,2030-11-28,Deliveroo,5812,Food & Drink,Delivery,-24.91,GBP,-159603.42,E-Com,London,GB,1045,user_002,,
ea5f585e-a326-4ebe-b428-6f0b0c62c6e5,2030-11-26,2030-11-27,Transport for London,4111,Transport,Transit,-5.15,GBP,-159608.57,POS,London,GB,2219,user_002,,
2927bd03-6189-464b-8209-32437032b496,2030-11-27,2030-11-29,Uber UK,4121,Transport,Ride Hailing,-26.92,GBP,-159635.49,E-Com,London,GB,9074,user_001,,
df9baa52-642d-4826-b8d7-d0e9edb57bd8,2030-11-27,2030-11-29,Uber UK,4121,Transport,Ride Hailing,-20.79,GBP,-159656.28,E-Com,London,GB,9074,user_001,,
3b1b72e9-c7be-4b4b-b865-bfc58981540b,2030-11-28,2030-11-29,Uber UK,4121,Transport,Ride Hailing,-22.35,GBP,-159678.63,E-Com,London,GB,9074,user_001,,
44addf3c-1ff7-4c42-9237-5ecfbb00cd20,2030-11-28,2030-11-28,Sainsbury's,5411,Groceries,Supermarket,-61.93,GBP,-159740.56,POS,London,GB,2219,user_001,,
9d5b1187-6d98-4799-a87e-5c06991c5836,2030-11-29,2030-11-29,Deliveroo,5812,Food & Drink,Delivery,-29.97,GBP,-159770.53,E-Com,London,GB,2219,user_002,,
b570fdf9-a6c6-4700-89ad-5d65928222ff,2030-11-29,2030-12-02,Uber UK,4121,Transport,Ride Hailing,-29.84,GBP,-159800.37,E-Com,London,GB,1045,user_001,,
98d84fc5-bad0-4562-bdb5-de3279fcb9a2,2030-11-30,2030-12-02,Apple.com/bill,5734,Shopping,Electronics,-207.37,USD,-160007.74,E-Com,Cupertino,US,1045,user_001,,FX purchase 263.31 USD @ rate 1.27
1fadac4b-d66d-4e65-a830-a2af5da02a53,2030-12-01,2030-12-02,Uber UK,4121,Transport,Ride Hailing,-19.2,GBP,-160026.94,E-Com,London,GB,4488,user_001,,
687e8434-a450-4d1d-b055-f8aadb364ab7,2030-12-01,2030-12-02,Deliveroo,5812,Food & Drink,Delivery,-15.9,GBP,-160042.84,E-Com,London,GB,2219,user_001,,
9e058b80-bc82-4881-91a9-338bb2461616,2030-12-01,2030-12-02,Tesco,5411,Groceries,Supermarket,-84.56,GBP,-160127.4,POS,London,GB,2219,user_001,,
e6a37aa9-7d79-4c03-aeca-5743d60e9a8c,2030-12-01,2030-12-02,Airline Refund,4511,Travel,Refund,77.63,GBP,-160049.77,Credit,London,GB,1045,user_001,,Refund for ATM Withdrawal
ca485ece-4332-4e36-ad96-4f5e5c8a80d6,2030-12-02,2030-12-03,Crown Estates Lettings,6513,Housing,Rent,-1463.11,GBP,-161512.88,POS,London,GB,2219,user_001,rec_19f70fbcce,
74f4de8d-c621-445c-86ee-0f9a19137b2e,2030-12-03,2030-12-04,Apple.com/bill,5734,Shopping,Electronics,-138.81,USD,-161651.69,E-Com,Cupertino,US,2219,user_001,,FX purchase 171.59 USD @ rate 1.24
97667f5a-3648-43bf-be15-c7a63da46635,2030-12-03,2030-12-03,Airline Refund,4511,Travel,Refund,20.07,GBP,-161631.62,Credit,London,GB,9074,user_001,,Refund for Waitrose
e49225e6-3c47-4ae8-a042-7933792af248,2030-12-03,2030-12-04,Uber UK,4121,Transport,Ride Hailing,-16.01,GBP,-161647.63,E-Com,London,GB,2219,user_001,,
4d1e4e65-1c10-4cd5-91a9-8ee4882a64d1,2030-12-04,2030-12-06,Shell,5541,Transport,Fuel,-32.33,GBP,-161679.96,POS,London,GB,2219,user_002,,
3a5a082d-ea16-4c24-9d2d-36069624fdfa,2030-12-05,2030-12-09,Apple.com/bill,5734,Shopping,Electronics,-104.45,GBP,-161784.41,E-Com,Cupertino,US,1045,user_002,,
45ac7696-732c-449b-8bf5-66594cdbe8b9,2030-12-05,2030-12-09,Transport for London,4111,Transport,Transit,-6.59,GBP,-161791.0,POS,London,GB,1045,user_001,,
4614acd1-8aea-49cc-b31f-539c79569ded,2030-12-05,2030-12-09,Sainsbury's,5411,Groceries,Supermarket,-60.2,GBP,-161851.2,POS,London,GB,1045,user_001,,
71fff1b2-7bdc-4d2a-b32d-3f058cb51c20,2030-12-05,2030-12-05,Deliveroo,5812,Food & Drink,Delivery,-18.53,GBP,-161869.73,E-Com,London,GB,9074,user_001,,
9091c95e-b881-4576-b785-5eaa4c3a9c2e,2030-12-06,2030-12-09,Amazon UK,5942,Shopping,Online Retail,-102.37,GBP,-161972.1,E-Com,London,GB,4488,user_001,,
1af3b62a-f828-4534-997e-7a57a7256bfb,2030-12-07,2030-12-09,Transport for London,4111,Transport,Transit,-5.14,GBP,-161977.24,POS,London,GB,9074,user_001,,
230a285e-36f5-41ac-8dba-42f1990c1bb6,2030-12-07,2030-12-09,Apple.com/bill,5734,Shopping,Electronics,-106.48,GBP,-162083.72,E-Com,Cupertino,US,9074,user_001,,
317a154d-6f26-480b-8c5f-8fe06231d86b,2030-12-07,2030-12-09,Uber UK,4121,Transport,Ride Hailing,-29.07,GBP,-162112.79,E-Com,London,GB,9074,user_001,,
86ae2552-ab51-48a5-9735-8feeef932f69,2030-12-07,2030-12-09,Waitrose,5411,Groceries,Supermarket,-23.36,GBP,-162136.15,POS,London,GB,1045,user_001,,
c3b96ef7-2002-4572-a7bc-447d7ea28fd9,2030-12-07,2030-12-09,HM Revenue & Customs,9311,Income,Tax Refund,10.6,GBP,-162125.55,Credit,London,GB,9074,user_001,,Refund for Local Market
c6073232-2d47-45e7-9690-75a3f3708205,2030-12-07,2030-12-09,Waitrose,5411,Groceries,Supermarket,-75.45,GBP,-162201.0,POS,London,GB,2219,user_001,,
29062d26-041f-4f02-9a67-35e721c98d74,2030-12-08,2030-12-09,Uber UK,4121,Transport,Ride Hailing,-34.64,GBP,-162235.64,E-Com,London,GB,2219,user_001,,
2cd15c6a-a6e6-416b-8ea1-1502aa4e869e,2030-12-08,2030-12-09,Uber UK,4121,Transport,Ride Hailing,-18.48,GBP,-162254.12,E-Com,London,GB,9074,user_001,,
b1ef332c-86e3-44d6-80c4-e4ed25b5f4a8,2030-12-08,2030-12-10,Sainsbury's,5411,Groceries,Supermarket,-31.42,GBP,-162285.54,POS,London,GB,9074,user_001,,
b6e809a6-ba19-46bf-8dc3-09bd03b156ab,2030-12-08,2030-12-09,Sainsbury's,5411,Groceries,Supermarket,-37.59,GBP,-162323.13,POS,London,GB,2219,user_002,,
5f9ea2b2-a1a4-41d9-851f-e0454513c0ae,2030-12-09,2030-12-10,Apple.com/bill,5734,Shopping,Electronics,-78.74,USD,-162401.87,E-Com,Cupertino,US,1045,user_001,,FX purchase 94.21 USD @ rate 1.20
619536b8-072a-4a4a-bcba-7b6c79d7f7f1,2030-12-09,2030-12-11,Octopus Energy,4900,Utilities,Electricity,-132.33,GBP,-162534.2,Direct Debit,London,GB,1045,user_001,rec_141a4a0666,
7899644f-7f62-4d26-9ff8-53bfb30f08b0,2030-12-09,2030-12-09,Uber UK,4121,Transport,Ride Hailing,-21.86,GBP,-162556.06,E-Com,London,GB,4488,user_002,,
0c62712a-0b34-45f6-9367-6f9211e4e6cf,2030-12-10,2030-12-12,Waitrose,5411,Groceries,Supermarket,-61.39,GBP,-162617.45,POS,London,GB,9074,user_001,,
1fbf12a4-24d0-4f61-8d3e-cd7ae50a0ac8,2030-12-10,2030-12-11,Waitrose,5411,Groceries,Supermarket,-42.15,GBP,-162659.6,POS,London,GB,4488,user_001,,
4053133c-7135-477a-ad33-0d5fa6da0077,2030-12-10,2030-12-11,Shell,5541,Transport,Fuel,-88.2,GBP,-162747.8,POS,London,GB,9074,user_001,,
58b82950-7d37-480b-b002-16f92137dadf,2030-12-11,2030-12-13,Waitrose,5411,Groceries,Supermarket,-69.39,GBP,-162817.19,POS,London,GB,4488,user_001,,
aec9af2e-6166-43a4-bf89-740d3f76affb,2030-12-11,2030-12-13,Deliveroo,5812,Food & Drink,Delivery,-17.4,GBP,-162834.59,E-Com,London,GB,1045,user_002,,
b4f2b4df-c7b2-468d-8564-ee11fb8a1c65,2030-12-11,2030-12-13,Thames Water,4900,Utilities,Water,-44.29,GBP,-162878.88,Direct Debit,Reading,GB,1045,user_001,rec_3a34d62842,
d7f7b488-dae7-4f22-9093-ea57815def23,2030-12-11,2030-12-13,Shell,5541,Transport,Fuel,-74.72,GBP,-162953.6,POS,London,GB,2219,user_001,,
0173cc83-a6ae-4e88-9067-80c301c17b2b,2030-12-12,2030-12-13,Tesco,5411,Groceries,Supermarket,-21.4,GBP,-162975.0,POS,London,GB,1045,user_001,,
16dc0620-abdc-4d25-9435-575b59d9cb94,2030-12-12,2030-12-16,Local Market,5499,Groceries,Specialty,-8.74,GBP,-162983.74,POS,London,GB,9074,user_001,,
46984cac-f99a-41b1-841e-8eef02747c89,2030-12-13,2030-12-13,Pret A Manger,5814,Food & Drink,Eating Out,-11.51,GBP,-162995.25,POS,London,GB,9074,user_001,,
b1ba01b3-3a71-4280-aaa4-d4fe8ea722bf,2030-12-13,2030-12-16,ATM Withdrawal,6011,Cash,ATM,-82.73,GBP,-163077.98,ATM,London,GB,1045,user_001,,
e9f10c2e-d7fa-479f-a33c-896a2afd8339,2030-12-13,2030-12-13,City Council Tax,9399,Utilities,Council Tax,-166.75,GBP,-163244.73,Direct Debit,London,GB,9074,user_001,rec_f531495db5,
738e4d66-7c36-439d-ad1d-b5925c6d9c38,2030-12-14,2030-12-16,Amazon UK,5942,Shopping,Online Retail,-117.57,GBP,-163362.3,E-Com,London,GB,9074,user_001,,
b490b739-922f-4c51-a6af-bff682281bcd,2030-12-14,2030-12-16,Sainsbury's,5411,Groceries,Supermarket,-68.33,GBP,-163430.63,POS,London,GB,4488,user_001,,
538f6727-2a6b-4a11-89c6-da9c703725d3,2030-12-15,2030-12-16,Shell,5541,Transport,Fuel,-31.69,GBP,-163462.32,POS,London,GB,9074,user_001,,
99d23826-6f5c-4f1f-91f9-c9aef78cc260,2030-12-15,2030-12-16,Waitrose,5411,Groceries,Supermarket,-29.16,GBP,-163491.48,POS,London,GB,2219,user_001,,
c3e2a583-ebaa-40a5-b9bd-502c03d6d5bd,2030-12-16,2030-12-18,O2 UK,4814,Bills,Mobile,-51.18,GBP,-163542.66,Direct Debit,Slough,GB,9074,user_001,rec_95042d8101,
f8cd95e0-fc63-44c9-9511-dff41752faa5,2030-12-16,2030-12-17,Amazon UK,5942,Shopping,Online Retail,-62.58,GBP,-163605.24,E-Com,London,GB,2219,user_001,,
c7057863-4a68-4fcc-800c-e2c57ba45959,2030-12-17,2030-12-18,GymBox,7997,Wellness,Gym,-64.89,GBP,-163670.13,Direct Debit,London,GB,1045,user_002,rec_19771e79cd,
ea210cdb-e5a8-4398-bda1-a4a894c2d7aa,2030-12-18,2030-12-20,Amazon UK,5942,Shopping,Online Retail,-58.18,GBP,-163728.31,E-Com,London,GB,4488,user_002,,
f10a535a-38fa-4644-9006-b83ea4161bfb,2030-12-18,2030-12-18,Shell,5541,Transport,Fuel,-68.24,GBP,-163796.55,POS,London,GB,4488,user_002,,
b01560d0-06e5-4963-8be8-afa8b3ccd782,2030-12-19,2030-12-23,Spotify,5735,Entertainment,Subscriptions,-9.48,EUR,-163806.03,E-Com,Stockholm,SE,4488,user_001,rec_4c746d2c3b,FX purchase 10.81 EUR @ rate 1.14
67f43780-e8be-4b9a-9f09-fef1de48b1e3,2030-12-20,2030-12-23,ATM Withdrawal,6011,Cash,ATM,-74.79,GBP,-163880.82,ATM,London,GB,9074,user_002,,
936c8769-9005-4757-8a5e-bfbe0885f9f1,2030-12-20,2030-12-23,Local Market,5499,Groceries,Specialty,-16.13,GBP,-163896.95,POS,London,GB,9074,user_001,,
fbe929fa-94e5-4be6-a6aa-5215bf0775a8,2030-12-20,2030-12-23,Amazon UK,5942,Shopping,Online Retail,-44.41,GBP,-163941.36,E-Com,London,GB,2219,user_002,,
df8aba25-08cf-4e36-8c38-ef944785651f,2030-12-21,2030-12-23,Pret A Manger,5814,Food & Drink,Eating Out,-7.23,GBP,-163948.59,POS,London,GB,9074,user_002,,
7434d8ca-0dc0-4ea5-88ad-18a7bbaea426,2030-12-22,2030-12-23,HM Revenue & Customs,9311,Income,Tax Refund,54.13,GBP,-163894.46,Credit,London,GB,2219,user_001,,Refund for Shell
db9d93af-d43c-4643-9673-3b0119800fab,2030-12-22,2030-12-23,Apple.com/bill,5734,Shopping,Electronics,-32.28,GBP,-163926.74,E-Com,Cupertino,US,1045,user_002,,
2dbf5ea2-075f-43a9-a459-a29ed3dd9b17,2030-12-23,2030-12-24,Deliveroo,5812,Food & Drink,Delivery,-13.03,GBP,-163939.77,E-Com,London,GB,1045,user_002,,
ce36a984-bdc1-4be3-a2fe-c9869a416c2e,2030-12-23,2030-12-23,Netflix,7841,Entertainment,Subscriptions,-14.23,USD,-163954.0,E-Com,Los Gatos,US,4488,user_001,rec_1bfe33738d,FX purchase 17.43 USD @ rate 1.22
d4d02722-6787-4b86-a6d8-330a6e976fe3,2030-12-23,2030-12-23,Transport for London,4111,Transport,Transit,-11.09,GBP,-163965.09,POS,London,GB,9074,user_001,,
0a08281b-2c4d-4607-bf2a-809459884148,2030-12-24,2030-12-24,Uber UK,4121,Transport,Ride Hailing,-21.09,GBP,-163986.18,E-Com,London,GB,4488,user_001,,
4b394f16-86e1-4a27-9087-8e835f7e0da6,2030-12-24,2030-12-26,Local Market,5499,Groceries,Specialty,-21.45,GBP,-164007.63,POS,London,GB,1045,user_001,,
ab290e28-4978-41d6-bcd7-26217a14f6cb,2030-12-24,2030-12-24,Local Market,5499,Groceries,Specialty,-11.32,GBP,-164018.95,POS,London,GB,2219,user_001,,
40818b64-3c55-419f-a724-c8e493c2111b,2030-12-25,2030-12-25,T212 Capital,6011,Income,Salary,3344.06,GBP,-160674.89,Credit,London,GB,2219,user_001,rec_2ff8f778d0,
725e43d2-894e-4d70-9d37-0d207fef89b0,2030-12-25,2030-12-26,Local Market,5499,Groceries,Specialty,-19.06,GBP,-160693.95,POS,London,GB,9074,user_002,,
ceeaa1c8-6f07-49b8-9351-586a031b6d47,2030-12-25,2030-12-25,Local Market,5499,Groceries,Specialty,-21.46,GBP,-160715.41,POS,London,GB,1045,user_001,,
ef10578b-bc09-4c25-b0a8-dd82b7d946e3,2030-12-25,2030-12-25,Waitrose,5411,Groceries,Supermarket,-66.63,GBP,-160782.04,POS,London,GB,2219,user_001,,
df01f16e-2bdd-4c47-baa3-b3232e62aed4,2030-12-26,2030-12-27,Amazon UK,5942,Shopping,Online Retail,-68.97,GBP,-160851.01,E-Com,London,GB,9074,user_001,,
09724dea-cb23-443a-b120-ecde2138a275,2030-12-27,2030-12-27,Shell,5541,Transport,Fuel,-57.37,GBP,-160908.38,POS,London,GB,9074,user_002,,
61f4cc98-4a9f-44fe-b124-2c1d6c6f28bc,2030-12-27,2030-12-27,Waitrose,5411,Groceries,Supermarket,-26.1,GBP,-160934.48,POS,London,GB,9074,user_001,,
71143408-f0b5-4468-87d8-ade364774aa1,2030-12-27,2030-12-27,Shell,5541,Transport,Fuel,-92.22,GBP,-161026.7,POS,London,GB,4488,user_002,,
7e7fba26-677d-4540-bbeb-15744c2a4361,2030-12-28,2030-12-30,Deliveroo,5812,Food & Drink,Delivery,-33.39,GBP,-161060.09,E-Com,London,GB,4488,user_001,,
c893dea2-8e1a-4364-a3bc-897a8a796d24,2030-12-28,2030-12-30,Transport for London,4111,Transport,Transit,-5.01,GBP,-161065.1,POS,London,GB,9074,user_001,,
31fc5472-ebda-4b9f-a07b-03172f8997a6,2030-12-29,2030-12-30,Sainsbury's,5411,Groceries,Supermarket,-48.86,GBP,-161113.96,POS,London,GB,2219,user_001,,
b6402531-30a3-483e-9559-d25ed89c417f,2030-12-29,2030-12-30,Deliveroo,5812,Food & Drink,Delivery,-28.44,GBP,-161142.4,E-Com,London,GB,1045,user_002,,
d9068e7a-8ecd-4d16-8637-facf993be1a3,2030-12-29,2030-12-30,Tesco,5411,Groceries,Supermarket,-18.37,GBP,-161160.77,POS,London,GB,9074,user_001,,
74c5f5ec-3981-482f-9301-8d08df2645a8,2030-12-30,2031-01-01,Transport for London,4111,Transport,Transit,-9.41,GBP,-161170.18,POS,London,GB,9074,user_001,,
a9c3ef03-3176-4b3a-b22c-a367ac927046,2030-12-30,2031-01-01,Transport for London,4111,Transport,Transit,-8.38,GBP,-161178.56,POS,London,GB,4488,user_001,,
ee9d5d46-1b06-4940-9062-84d6ad9d7dac,2030-12-30,2031-01-01,Uber UK,4121,Transport,Ride Hailing,-14.67,GBP,-161193.23,E-Com,London,GB,9074,user_001,,
ce36e628-c181-4dc7-b2ed-9b8f16e60c42,2030-12-31,2030-12-31,Apple.com/bill,5734,Shopping,Electronics,-127.79,GBP,-161321.02,E-Com,Cupertino,US,1045,user_001,,
0d0e01be-e3b4-4a0c-8a46-538e4d02accd,2031-01-01,2031-01-02,Crown Estates Lettings,6513,Housing,Rent,-1500.91,GBP,-162821.93,POS,London,GB,4488,user_001,rec_19f70fbcce,
bea50c36-3c22-4440-b08a-6c98f73857f3,2031-01-01,2031-01-02,Apple.com/bill,5734,Shopping,Electronics,-124.61,GBP,-162946.54,E-Com,Cupertino,US,2219,user_001,,
d8f3b26a-dc2f-457d-a139-7a0a9803cc2a,2031-01-01,2031-01-01,Waitrose,5411,Groceries,Supermarket,-45.46,GBP,-162992.0,POS,London,GB,4488,user_001,,
4a4b4595-14b4-4b31-b59a-1b6e7b263ca8,2031-01-02,2031-01-03,Local Market,5499,Groceries,Specialty,-20.29,GBP,-163012.29,POS,London,GB,9074,user_002,,
5864da71-66e1-4d03-940e-94195466ad5c,2031-01-02,2031-01-06,Uber UK,4121,Transport,Ride Hailing,-10.86,GBP,-163023.15,E-Com,London,GB,2219,user_001,,
6c0ff02b-befc-411d-9e3b-421feb1bb16a,2031-01-02,2031-01-06,Shell,5541,Transport,Fuel,-88.37,GBP,-163111.52,POS,London,GB,1045,user_001,,
952ad946-fd24-4f1c-adf6-faf04334f81b,2031-01-02,2031-01-06,Apple.com/bill,5734,Shopping,Electronics,-169.18,GBP,-163280.7,E-Com,Cupertino,US,4488,user_001,,
cc7ddc21-d229-4489-b81f-f0b15ab14fbc,2031-01-02,2031-01-02,Deliveroo,5812,Food & Drink,Delivery,-12.65,GBP,-163293.35,E-Com,London,GB,9074,user_002,,
8221d48c-bc15-49b3-9428-1d0b1d352b2a,2031-01-03,2031-01-06,Deliveroo,5812,Food & Drink,Delivery,-27.41,GBP,-163320.76,E-Com,London,GB,9074,user_001,,
f5f841c3-c308-47af-9edb-c4c90f1c1a4c,2031-01-03,2031-01-03,HM Revenue & Customs,9311,Income,Tax Refund,6.21,GBP,-163314.55,Credit,London,GB,9074,user_001,,Refund for Local Market
70fe50e3-d2e8-4f73-8f72-bcad47b918f9,2031-01-04,2031-01-06,Waitrose,5411,Groceries,Supermarket,-63.85,GBP,-163378.4,POS,London,GB,9074,user_002,,
d5d1e41b-ed52-4980-9b5a-e4b9a05772af,2031-01-04,2031-01-06,Deliveroo,5812,Food & Drink,Delivery,-32.05,GBP,-163410.45,E-Com,London,GB,4488,user_001,,
e72a1e5f-229d-4bde-941a-2f54d31d6054,2031-01-04,2031-01-06,Apple.com/bill,5734,Shopping,Electronics,-35.01,GBP,-163445.46,E-Com,Cupertino,US,4488,user_002,,
4751ed80-c121-4ea6-963c-75a59eb7f870,2031-01-05,2031-01-07,Pret A Manger,5814,Food & Drink,Eating Out,-8.23,GBP,-163453.69,POS,London,GB,9074,user_001,,
f7f70f16-85dc-4152-ad91-3d2a2348e2da,2031-01-05,2031-01-07,Sainsbury's,5411,Groceries,Supermarket,-59.98,GBP,-163513.67,POS,London,GB,4488,user_001,,
005479f9-3f91-4255-8a4d-31a9d2449d07,2031-01-06,2031-01-06,Tesco,5411,Groceries,Supermarket,-66.83,GBP,-163580.5,POS,London,GB,1045,user_001,,
b7b5c9e5-3d41-49f7-9bef-66c222016e69,2031-01-06,2031-01-07,Waitrose,5411,Groceries,Supermarket,-55.99,GBP,-163636.49,POS,London,GB,9074,user_001,,
ccf8956b-107b-4217-bce2-bedba1702e52,2031-01-06,2031-01-06,Deliveroo,5812,Food & Drink,Delivery,-32.22,GBP,-163668.71,E-Com,London,GB,4488,user_001,,
a38a9722-bf90-44c3-8770-f9c06206232f,2031-01-07,2031-01-08,Uber UK,4121,Transport,Ride Hailing,-18.99,GBP,-163687.7,E-Com,London,GB,1045,user_002,,
d8b9a53d-9026-4a4e-bbfc-c56a728af18e,2031-01-07,2031-01-08,Octopus Energy,4900,Utilities,Electricity,-143.75,GBP,-163831.45,Direct Debit,London,GB,4488,user_002,rec_09c3f12b18,
e584c9f4-5a17-4466-b93a-54f1aad16869,2031-01-08,2031-01-09,Tesco,5411,Groceries,Supermarket,-24.29,GBP,-163855.74,POS,London,GB,4488,user_001,,
2f84fad1-b21f-4574-b43a-18fc8e2f4666,2031-01-09,2031-01-09,Local Market,5499,Groceries,Specialty,-19.19,GBP,-163874.93,POS,London,GB,4488,user_001,,
b872ea15-f7c2-4a92-814b-a8e08f19dbaf,2031-01-09,2031-01-13,Local Market,5499,Groceries,Specialty,-13.61,GBP,-163888.54,POS,London,GB,9074,user_001,,
db80bf87-deed-4191-aff4-89a9fdbdbd0b,2031-01-09,2031-01-13,Amazon UK,5942,Shopping,Online Retail,-106.8,GBP,-163995.34,E-Com,London,GB,1045,user_001,,
e08b8736-90ed-4098-8f8f-6a50c20b6aba,2031-01-09,2031-01-09,Deliveroo,5812,Food & Drink,Delivery,-20.17,GBP,-164015.51,E-Com,London,GB,2219,user_002,,
ef499e25-9451-45be-8517-1bf8ed4882ca,2031-01-09,2031-01-10,Shell,5541,Transport,Fuel,-69.99,GBP,-164085.5,POS,London,GB,4488,user_002,,
9a4c91dc-9b62-4d43-ab9e-1942f52128e2,2031-01-10,2031-01-10,Transport for London,4111,Transport,Transit,-11.6,GBP,-164097.1,POS,London,GB,9074,user_001,,
0c7313d4-feb0-41fc-bc6f-37bf04ab94a6,2031-01-11,2031-01-13,Tesco,5411,Groceries,Supermarket,-33.79,GBP,-164130.89,POS,London,GB,9074,user_001,,
13641a38-20e0-4fd6-8f76-6249253e3be7,2031-01-11,2031-01-13,Tesco,5411,Groceries,Supermarket,-53.39,GBP,-164184.28,POS,London,GB,9074,user_002,,
2f894561-a4af-4cd3-a08b-b8d88555e842,2031-01-11,2031-01-13,Waitrose,5411,Groceries,Supermarket,-29.76,GBP,-164214.04,POS,London,GB,2219,user_001,,
3f10f0b6-f740-4bb9-ac05-7f536920988d,2031-01-11,2031-01-13,Apple.com/bill,5734,Shopping,Electronics,-155.73,GBP,-164369.77,E-Com,Cupertino,US,4488,user_001,,
7ea81556-2c88-4439-b478-fb5801aee0eb,2031-01-11,2031-01-13,Pret A Manger,5814,Food & Drink,Eating Out,-7.47,GBP,-164377.24,POS,London,GB,2219,user_002,,
fe70281a-5e61-4714-8494-4c199791574a,2031-01-11,2031-01-13,Waitrose,5411,Groceries,Supermarket,-27.84,GBP,-164405.08,POS,London,GB,4488,user_002,,
19a80b15-1069-4e0d-bd99-eeee546a99e6,2031-01-12,2031-01-13,Transport for London,4111,Transport,Transit,-10.92,GBP,-164416.0,POS,London,GB,4488,user_001,,
6c443b40-ed7b-4120-85e1-99b10c9b1488,2031-01-12,2031-01-13,Pret A Manger,5814,Food & Drink,Eating Out,-5.83,GBP,-164421.83,POS,London,GB,9074,user_001,,
7fa4ec18-070a-47f0-a2a2-249c7d869ba7,2031-01-12,2031-01-13,Amazon UK,5942,Shopping,Online Retail,-58.34,GBP,-164480.17,E-Com,London,GB,1045,user_002,,
b15e5e43-5926-41e0-a918-ae27191a3aa8,2031-01-12,2031-01-13,Sainsbury's,5411,Groceries,Supermarket,-48.24,GBP,-164528.41,POS,London,GB,4488,user_001,,
300226be-c61a-4eca-9ed1-33144b33e6af,2031-01-13,2031-01-13,City Council Tax,9399,Utilities,Council Tax,-168.55,GBP,-164696.96,Direct Debit,London,GB,4488,user_001,rec_f531495db5,
55e93dc5-71e0-468c-a37e-03321171af23,2031-01-13,2031-01-13,Pret A Manger,5814,Food & Drink,Eating Out,-10.35,GBP,-164707.31,POS,London,GB,1045,user_002,,
69c56509-451c-4a10-a573-68f31bcd6de1,2031-01-13,2031-01-15,Thames Water,4900,Utilities,Water,-41.07,GBP,-164748.38,Direct Debit,Reading,GB,4488,user_001,rec_3a34d62842,
a64f1458-b207-4cd9-ba0a-ad2005695e97,2031-01-13,2031-01-14,Sainsbury's,5411,Groceries,Supermarket,-64.71,GBP,-164813.09,POS,London,GB,4488,user_001,,
c2869893-faf3-401a-bd22-8c6adb349b5b,2031-01-14,2031-01-14,Deliveroo,5812,Food & Drink,Delivery,-25.35,GBP,-164838.44,E-Com,London,GB,2219,user_001,,
16423aa6-2275-4661-99e6-79e74533ac7d,2031-01-15,2031-01-16,Deliveroo,5812,Food & Drink,Delivery,-30.84,GBP,-164869.28,E-Com,London,GB,1045,user_001,,
75d76d72-7e6a-4001-9553-8c038811d0af,2031-01-15,2031-01-15,Apple.com/bill,5734,Shopping,Electronics,-160.91,GBP,-165030.19,E-Com,Cupertino,US,4488,user_001,,
ac7c4e8a-6adf-4f45-882f-c101dee640ec,2031-01-15,2031-01-17,O2 UK,4814,Bills,Mobile,-48.47,GBP,-165078.66,Direct Debit,Slough,GB,4488,user_001,rec_95042d8101,
d8365742-59ae-4b8c-a532-8286f20ecfcc,2031-01-15,2031-01-16,Transport for London,4111,Transport,Transit,-4.68,GBP,-165083.34,POS,London,GB,9074,user_001,,
ddca1829-26c5-4eb8-9f76-98068d6b7c09,2031-01-16,2031-01-17,Sainsbury's,5411,Groceries,Supermarket,-46.4,GBP,-165129.74,POS,London,GB,9074,user_001,,
e1279666-ac7d-4f05-9014-721950dc8153,2031-01-16,2031-01-17,Transport for London,4111,Transport,Transit,-3.66,GBP,-165133.4,POS,London,GB,2219,user_001,,
1c42db65-7822-43ca-ae1b-a38efd73fe4d,2031-01-17,2031-01-20,Transport for London,4111,Transport,Transit,-6.76,GBP,-165140.16,POS,London,GB,2219,user_001,,
3cbc4701-182d-4301-b311-acd885c43769,2031-01-17,2031-01-17,GymBox,7997,Wellness,Gym,-45.13,GBP,-165185.29,Direct Debit,London,GB,9074,user_002,rec_19771e79cd,
80cb5839-dbbf-432c-a5b6-f4d8e68cb451,2031-01-17,2031-01-20,Pret A Manger,5814,Food & Drink,Eating Out,-10.63,GBP,-165195.92,POS,London,GB,2219,user_002,,
2dd1cd26-cb5b-4858-a6fe-01057e2dc4a3,2031-01-18,2031-01-20,Apple.com/bill,5734,Shopping,Electronics,-41.02,USD,-165236.94,E-Com,Cupertino,US,1045,user_001,,FX purchase 48.91 USD @ rate 1.19
3f254c0e-10f0-4787-becd-f459b5a27419,2031-01-18,2031-01-20,Uber UK,4121,Transport,Ride Hailing,-16.28,GBP,-165253.22,E-Com,London,GB,1045,user_001,,
a85866f9-a45e-4080-aa0f-0e9cd77e22fd,2031-01-18,2031-01-20,Transport for London,4111,Transport,Transit,-7.85,GBP,-165261.07,POS,London,GB,2219,user_001,,
ec52d8d3-cde9-4659-ba72-45083a6c58aa,2031-01-18,2031-01-20,Waitrose,5411,Groceries,Supermarket,-37.2,GBP,-165298.27,POS,London,GB,2219,user_001,,
32d8083c-57fa-4c32-b833-4a765cc26e10,2031-01-19,2031-01-21,Sainsbury's,5411,Groceries,Supermarket,-29.45,GBP,-165327.72,POS,London,GB,9074,user_001,,
5db2e85b-3327-4929-966d-86d4254aa8b7,2031-01-19,2031-01-20,Local Market,5499,Groceries,Specialty,-9.06,GBP,-165336.78,POS,London,GB,2219,user_001,,
0544f9f0-cafb-49c3-93c3-3161b402c4bf,2031-01-20,2031-01-21,Transport for London,4111,Transport,Transit,-9.82,GBP,-165346.6,POS,London,GB,2219,user_001,,
6b965086-21d8-44d1-ab32-623b959ee928,2031-01-20,2031-01-21,Tesco,5411,Groceries,Supermarket,-75.28,GBP,-165421.88,POS,London,GB,1045,user_001,,
8ed605ab-6686-4c36-b0d8-b949f31241d9,2031-01-20,2031-01-22,Uber UK,4121,Transport,Ride Hailing,-25.06,GBP,-165446.94,E-Com,London,GB,9074,user_001,,
9427d8eb-173d-4f33-9cf9-5b5eb489640b,2031-01-20,2031-01-21,Waitrose,5411,Groceries,Supermarket,-28.93,GBP,-165475.87,POS,London,GB,2219,user_001,,
bb613e7b-6a05-461c-a27f-45f96aa8c3ed,2031-01-20,2031-01-20,Spotify,5735,Entertainment,Subscriptions,-8.71,EUR,-165484.58,E-Com,Stockholm,SE,4488,user_001,rec_4c746d2c3b,FX purchase 10.14 EUR @ rate 1.16
c39feb91-5b48-41f5-9cb2-5c40d8a32987,2031-01-20,2031-01-20,Uber UK,4121,Transport,Ride Hailing,-24.86,GBP,-165509.44,E-Com,London,GB,2219,user_002,,
2f4ddbfc-1497-42fe-a06f-2c2b1adb5668,2031-01-21,2031-01-23,Local Market,5499,Groceries,Specialty,-17.95,GBP,-165527.39,POS,London,GB,1045,user_002,,
64b4b8b4-91c6-4a7e-91a2-5e1c876fd6df,2031-01-21,2031-01-23,Pret A Manger,5814,Food & Drink,Eating Out,-6.23,GBP,-165533.62,POS,London,GB,1045,user_001,,
85741359-0f15-487b-b750-878d246071b8,2031-01-21,2031-01-23,Netflix,7841,Entertainment,Subscriptions,-13.49,GBP,-165547.11,E-Com,Los Gatos,US,1045,user_001,rec_1bfe33738d,
46e8b0d6-498f-4186-b5fb-981306c7ba42,2031-01-22,2031-01-24,Tesco,5411,Groceries,Supermarket,-49.46,GBP,-165596.57,POS,London,GB,1045,user_002,,
7f4adebd-dc94-414d-abd3-5fe197b9527b,2031-01-22,2031-01-22,Uber UK,4121,Transport,Ride Hailing,-11.55,GBP,-165608.12,E-Com,London,GB,1045,user_001,,
d6387432-6c66-427f-9222-db8819b68f1c,2031-01-22,2031-01-22,British Airways,4511,Travel,Flights,-296.26,USD,-165904.38,E-Com,London,GB,4488,user_001,,Holiday booking
ca14d8df-c5a9-4edd-8fe7-41954354e96b,2031-01-23,2031-01-23,ATM Withdrawal,6011,Cash,ATM,-115.26,GBP,-166019.64,ATM,London,GB,9074,user_001,,
dbd16a9f-3998-4b4d-835b-727d0108ebae,2031-01-23,2031-01-23,Deliveroo,5812,Food & Drink,Delivery,-14.16,GBP,-166033.8,E-Com,London,GB,1045,user_001,,
800a0473-a822-4c86-a974-7a88006cf33e,2031-01-24,2031-01-24,Shell,5541,Transport,Fuel,-46.53,GBP,-166080.33,POS,London,GB,9074,user_001,,
f7ca47b0-f33d-4941-b507-07bbf256e383,2031-01-24,2031-01-24,T212 Capital,6011,Income,Salary,3140.79,GBP,-162939.54,Credit,London,GB,9074,user_001,rec_2ff8f778d0,
36cdb09a-a5c3-4c63-a7fc-7fa010f36b7b,2031-01-25,2031-01-27,Tesco,5411,Groceries,Supermarket,-72.64,GBP,-163012.18,POS,London,GB,1045,user_001,,
49c3c701-bfab-4c70-9fb5-baf0bd2c884d,2031-01-25,2031-01-27,Apple.com/bill,5734,Shopping,Electronics,-103.42,USD,-163115.6,E-Com,Cupertino,US,4488,user_001,,FX purchase 133.42 USD @ rate 1.29
9be62b64-6396-469b-9967-d4e701327ad1,2031-01-25,2031-01-27,Transport for London,4111,Transport,Transit,-7.7,GBP,-163123.3,POS,London,GB,4488,user_002,,
9e8525ac-5dd3-4a97-bae4-2c961e07402f,2031-01-25,2031-01-27,Transport for London,4111,Transport,Transit,-5.16,GBP,-163128.46,POS,London,GB,1045,user_001,,
a8146510-0af5-4e95-a96b-68a826163cec,2031-01-25,2031-01-27,Local Market,5499,Groceries,Specialty,-6.28,GBP,-163134.74,POS,London,GB,4488,user_001,,
15b4d119-5b37-4f82-a9d6-5f51adbfa028,2031-01-26,2031-01-28,Pret A Manger,5814,Food & Drink,Eating Out,-8.19,GBP,-163142.93,POS,London,GB,9074,user_001,,
ad6dc018-0d9d-41e1-a18a-cff86a69f212,2031-01-26,2031-01-28,Tesco,5411,Groceries,Supermarket,-52.28,GBP,-163195.21,POS,London,GB,1045,user_001,,
ec0e6567-f37d-413d-a36f-7b9bbc4e627b,2031-01-27,2031-01-29,Sainsbury's,5411,Groceries,Supermarket,-15.34,GBP,-163210.55,POS,London,GB,2219,user_001,,
e157605a-929a-439a-a974-ef7e0dd82925,2031-01-28,2031-01-30,Uber UK,4121,Transport,Ride Hailing,-15.7,GBP,-163226.25,E-Com,London,GB,4488,user_002,,
e20a9f85-edf7-48e0-8731-1b3af99dd405,2031-01-28,2031-01-29,Shell,5541,Transport,Fuel,-81.66,GBP,-163307.91,POS,London,GB,4488,user_001,,
ea8e8e1f-c529-4fbc-8acd-71c5d45a823d,2031-01-28,2031-01-30,ATM Withdrawal,6011,Cash,ATM,-100.81,GBP,-163408.72,ATM,London,GB,9074,user_001,,
39a297e5-5d61-47ca-ab90-06c4c3288cb2,2031-01-29,2031-01-31,Deliveroo,5812,Food & Drink,Delivery,-29.92,GBP,-163438.64,E-Com,London,GB,4488,user_001,,
d0cb0e79-671c-4028-ba60-2704b935ecb2,2031-01-30,2031-01-30,Local Market,5499,Groceries,Specialty,-11.24,GBP,-163449.88,POS,London,GB,1045,user_001,,
fbdb42dd-c7bf-47b9-9259-09a3880153b1,2031-01-30,2031-01-30,Airline Refund,4511,Travel,Refund,11.29,GBP,-163438.59,Credit,London,GB,1045,user_001,,Refund for Deliveroo
2e24a761-d26a-4715-a14d-54cc493dddf5,2031-01-31,2031-02-03,Tesco,5411,Groceries,Supermarket,-19.45,GBP,-163458.04,POS,London,GB,9074,user_001,,
1d07747d-4666-46b0-9241-98ea1ca8400c,2031-02-01,2031-02-03,Transport for London,4111,Transport,Transit,-4.4,GBP,-163462.44,POS,London,GB,4488,user_002,,
5b6eab5f-4f14-4311-a0a9-e2621ac08f4c,2031-02-01,2031-02-03,Transport for London,4111,Transport,Transit,-11.24,GBP,-163473.68,POS,London,GB,9074,user_001,,
6ba6ad70-c64b-44aa-a33a-09c188d35fef,2031-02-01,2031-02-03,Waitrose,5411,Groceries,Supermarket,-44.99,GBP,-163518.67,POS,London,GB,1045,user_001,,
04157b11-4d9a-4a5d-a4fc-b242b79d5736,2031-02-02,2031-02-03,Deliveroo,5812,Food & Drink,Delivery,-21.07,GBP,-163539.74,E-Com,London,GB,1045,user_001,,
06f8be2e-173f-4c10-99fa-99c00d4d5078,2031-02-02,2031-02-03,Waitrose,5411,Groceries,Supermarket,-49.54,GBP,-163589.28,POS,London,GB,9074,user_001,,
0b6bd5a9-571f-4874-a951-3be0bb4f0d36,2031-02-02,2031-02-03,Deliveroo,5812,Food & Drink,Delivery,-21.57,GBP,-163610.85,E-Com,London,GB,2219,user_001,,
33e2fc17-0ebb-4c3c-83b6-062eb12ffec7,2031-02-02,2031-02-04,Apple.com/bill,5734,Shopping,Electronics,-60.43,GBP,-163671.28,E-Com,Cupertino,US,2219,user_001,,
42e27437-ec5a-476a-8a35-b5731bfacf87,2031-02-02,2031-02-03,Sainsbury's,5411,Groceries,Supermarket,-46.47,GBP,-163717.75,POS,London,GB,4488,user_001,,
345811d3-c258-4715-9479-48d20a8facd6,2031-02-03,2031-02-03,Waitrose,5411,Groceries,Supermarket,-60.73,GBP,-163778.48,POS,London,GB,9074,user_001,,
666394ca-19a9-4d4c-b378-8c0f8831a871,2031-02-03,2031-02-05,Local Market,5499,Groceries,Specialty,-12.39,GBP,-163790.87,POS,London,GB,2219,user_001,,
bdef0f1d-c537-467c-b1a0-8cd920598b21,2031-02-03,2031-02-04,Crown Estates Lettings,6513,Housing,Rent,-1491.72,GBP,-165282.59,POS,London,GB,9074,user_001,rec_19f70fbcce,
e0f31277-0288-402c-b859-9d3a8753bfe6,2031-02-03,2031-02-05,Sainsbury's,5411,Groceries,Supermarket,-64.99,GBP,-165347.58,POS,London,GB,1045,user_001,,
35ce25a6-6cbe-44a2-9545-287c77c12b83,2031-02-05,2031-02-05,Pret A Manger,5814,Food & Drink,Eating Out,-9.76,GBP,-165357.34,POS,London,GB,2219,user_002,,
cc23af1b-371f-4af7-a70b-ebff70fddf23,2031-02-05,2031-02-07,Local Market,5499,Groceries,Specialty,-18.75,GBP,-165376.09,POS,London,GB,2219,user_001,,
e3ef6c63-9164-4f52-9db0-d5d20a341d70,2031-02-05,2031-02-05,Local Market,5499,Groceries,Specialty,-13.3,GBP,-165389.39,POS,London,GB,4488,user_001,,
5bdf455e-4f9e-4992-b99f-9226cb1318cc,2031-02-06,2031-02-10,Transport for London,4111,Transport,Transit,-11.21,GBP,-165400.6,POS,London,GB,9074,user_001,,
bb5ee501-e40b-40ac-a5a4-377dc7218848,2031-02-06,2031-02-10,Uber UK,4121,Transport,Ride Hailing,-20.17,GBP,-165420.77,E-Com,London,GB,2219,user_001,,
fb5f9b3c-b412-4f58-89b6-f5ea80f6c43b,2031-02-06,2031-02-06,Local Market,5499,Groceries,Specialty,-20.43,GBP,-165441.2,POS,London,GB,1045,user_001,,
6e4cbd8d-c129-4ff9-9438-d36d0e988e5b,2031-02-07,2031-02-07,Octopus Energy,4900,Utilities,Electricity,-138.85,GBP,-165580.05,Direct Debit,London,GB,2219,user_001,rec_141a4a0666,
3cfd46ba-8bcb-493f-95b7-dcda2f25a710,2031-02-08,2031-02-10,Waitrose,5411,Groceries,Supermarket,-69.16,GBP,-165649.21,POS,London,GB,9074,user_001,,
6dea0756-959b-443b-b3a0-10192d6c8671,2031-02-08,2031-02-10,Uber UK,4121,Transport,Ride Hailing,-13.57,GBP,-165662.78,E-Com,London,GB,9074,user_001,,
b8397b7c-af25-414c-abb9-1c275cb91366,2031-02-08,2031-02-10,ATM Withdrawal,6011,Cash,ATM,-104.19,GBP,-165766.97,ATM,London,GB,4488,user_001,,
ffb60d12-e2ae-47e9-a91b-5051ad8097c9,2031-02-08,2031-02-10,Uber UK,4121,Transport,Ride Hailing,-9.38,GBP,-165776.35,E-Com,London,GB,1045,user_001,,
364e0af4-73a4-4d2c-b683-4fd21bd4b080,2031-02-09,2031-02-10,Shell,5541,Transport,Fuel,-64.89,GBP,-165841.24,POS,London,GB,2219,user_001,,
3f3149bc-1570-4378-a944-c1dfdbf1e22c,2031-02-09,2031-02-10,Local Market,5499,Groceries,Specialty,-18.25,GBP,-165859.49,POS,London,GB,1045,user_002,,
70b491d7-efb2-4a21-9b98-1946f0f4dc79,2031-02-09,2031-02-10,Transport for London,4111,Transport,Transit,-7.35,GBP,-165866.84,POS,London,GB,9074,user_001,,
a89df1b9-fdff-4fa7-8c84-25cf748c85e8,2031-02-09,2031-02-11,Transport for London,4111,Transport,Transit,-4.06,GBP,-165870.9,POS,London,GB,9074,user_002,,
727a3185-8e05-4c65-8147-36dcd4261586,2031-02-10,2031-02-10,Transport for London,4111,Transport,Transit,-6.87,GBP,-165877.77,POS,London,GB,2219,user_001,,
7c5e5d2d-3670-430c-a304-890bb6bc2b5c,2031-02-11,2031-02-11,Thames Water,4900,Utilities,Water,-37.09,GBP,-165914.86,Direct Debit,Reading,GB,1045,user_001,rec_3a34d62842,
91edc6d3-2ec8-449b-9036-dca6e17971e0,2031-02-11,2031-02-11,Local Market,5499,Groceries,Specialty,-10.99,GBP,-165925.85,POS,London,GB,1045,user_001,,
c6459c56-649b-4163-9938-e3b5d09b2a0d,2031-02-11,2031-02-12,Uber UK,4121,Transport,Ride Hailing,-16.32,GBP,-165942.17,E-Com,London,GB,9074,user_001,,
0ddac681-caab-4978-b04b-6a26d3618f94,2031-02-13,2031-02-17,City Council Tax,9399,Utilities,Council Tax,-168.05,GBP,-166110.22,Direct Debit,London,GB,1045,user_001,rec_f531495db5,
91c5dcbd-1453-4b7e-8d98-3cdef246243f,2031-02-13,2031-02-17,Uber UK,4121,Transport,Ride Hailing,-22.21,GBP,-166132.43,E-Com,London,GB,9074,user_001,,
9687bf25-f48d-4fe8-a898-17209ca2078e,2031-02-13,2031-02-17,Sainsbury's,5411,Groceries,Supermarket,-31.05,GBP,-166163.48,POS,London,GB,9074,user_002,,
32c3d75c-3220-4acb-95b5-80f38805971e,2031-02-14,2031-02-17,Amazon UK,5942,Shopping,Online Retail,-16.76,GBP,-166180.24,E-Com,London,GB,9074,user_002,,
f834a2dd-ee47-443b-a266-2757bf7874aa,2031-02-14,2031-02-14,Tesco,5411,Groceries,Supermarket,-55.96,GBP,-166236.2,POS,London,GB,9074,user_001,,
3393caf4-f6e8-424c-a345-0f96513082bd,2031-02-15,2031-02-17,Local Market,5499,Groceries,Specialty,-10.14,GBP,-166246.34,POS,London,GB,9074,user_001,,
d357b9d2-4820-4ce9-9ec1-3f81835cf3b9,2031-02-15,2031-02-17,HM Revenue & Customs,9311,Income,Tax Refund,63.87,GBP,-166182.47,Credit,London,GB,2219,user_001,,Refund for Waitrose
ebb95c22-4dbb-484c-af10-49d2420f8ac2,2031-02-15,2031-02-17,Amazon UK,5942,Shopping,Online Retail,-105.63,GBP,-166288.1,E-Com,London,GB,1045,user_001,,
753f5052-a8c3-4fd4-ab4f-b08010c55065,2031-02-16,2031-02-17,Uber UK,4121,Transport,Ride Hailing,-23.76,GBP,-166311.86,E-Com,London,GB,1045,user_002,,
8a384a8c-942c-4179-b0ff-10ff915cc7e2,2031-02-16,2031-02-18,Amazon UK,5942,Shopping,Online Retail,-68.71,GBP,-166380.57,E-Com,London,GB,2219,user_001,,
223dfb16-cf70-4303-aaa7-bf827cd8ec8c,2031-02-17,2031-02-17,O2 UK,4814,Bills,Mobile,-49.15,GBP,-166429.72,Direct Debit,Slough,GB,4488,user_002,rec_d2dce4c42f,
7ad621a3-fa1d-4535-835c-9fd745ed23b7,2031-02-17,2031-02-18,GymBox,7997,Wellness,Gym,-56.14,GBP,-166485.86,Direct Debit,London,GB,9074,user_001,rec_3906953fd2,
c73cdc81-4e7b-46f0-bb8c-597244ff04a2,2031-02-18,2031-02-18,Amazon UK,5942,Shopping,Online Retail,-40.14,GBP,-166526.0,E-Com,London,GB,1045,user_001,,
46fa13a9-ff33-452b-9b42-2842bb790134,2031-02-19,2031-02-19,Apple.com/bill,5734,Shopping,Electronics,-107.71,USD,-166633.71,E-Com,Cupertino,US,1045,user_001,,FX purchase 136.63 USD @ rate 1.27
a518f5d2-e119-47de-97ff-92cfd9134be3,2031-02-19,2031-02-19,Spotify,5735,Entertainment,Subscriptions,-9.54,EUR,-166643.25,E-Com,Stockholm,SE,4488,user_001,rec_4c746d2c3b,FX purchase 10.71 EUR @ rate 1.12
3b583232-184a-4b3f-959c-f1a9cce33815,2031-02-20,2031-02-20,Apple.com/bill,5734,Shopping,Electronics,-108.95,GBP,-166752.2,E-Com,Cupertino,US,1045,user_002,,
06d1e127-e6a7-4b8d-a942-d135e409ad68,2031-02-21,2031-02-21,Netflix,7841,Entertainment,Subscriptions,-11.31,GBP,-166763.51,E-Com,Los Gatos,US,1045,user_002,rec_d9322c1382,
830b2ddc-6689-47c0-9f75-3b157298f238,2031-02-21,2031-02-21,Deliveroo,5812,Food & Drink,Delivery,-28.85,GBP,-166792.36,E-Com,London,GB,9074,user_001,,
231de5e1-0757-49b5-9fd6-b44eefe0fdec,2031-02-22,2031-02-24,Shell,5541,Transport,Fuel,-34.53,GBP,-166826.89,POS,London,GB,2219,user_001,,
28e95cbb-eb4c-43b1-a4a4-b52022ecef41,2031-02-22,2031-02-24,Amazon UK,5942,Shopping,Online Retail,-115.14,GBP,-166942.03,E-Com,London,GB,2219,user_002,,
3f989293-ba9c-4ee3-9b42-cbbb11d6a732,2031-02-22,2031-02-24,Pret A Manger,5814,Food & Drink,Eating Out,-11.76,GBP,-166953.79,POS,London,GB,1045,user_001,,
e0545b92-eb86-43be-9d87-ac373ba23d12,2031-02-22,2031-02-24,Shell,5541,Transport,Fuel,-92.75,GBP,-167046.54,POS,London,GB,9074,user_001,,
e47cdfd5-b4fb-4e4b-a00a-69b0c638b356,2031-02-22,2031-02-24,Uber UK,4121,Transport,Ride Hailing,-30.27,GBP,-167076.81,E-Com,London,GB,9074,user_001,,
330281c1-e194-4ad7-ad46-3efcf65d6380,2031-02-23,2031-02-24,Transport for London,4111,Transport,Transit,-4.0,GBP,-167080.81,POS,London,GB,4488,user_002,,
83fced66-2cd6-4e7e-9745-6854c967e992,2031-02-23,2031-02-25,Waitrose,5411,Groceries,Supermarket,-59.74,GBP,-167140.55,POS,London,GB,2219,user_001,,
bcfbe436-affe-4e49-8e02-6c2dc32300be,2031-02-23,2031-02-24,Sainsbury's,5411,Groceries,Supermarket,-55.56,GBP,-167196.11,POS,London,GB,9074,user_001,,
d7ea8e5d-0f68-466f-9fec-f4f403b68adb,2031-02-23,2031-02-25,Transport for London,4111,Transport,Transit,-6.76,GBP,-167202.87,POS,London,GB,4488,user_001,,
06bac44f-8175-450f-a7da-75969e6101a9,2031-02-24,2031-02-24,Waitrose,5411,Groceries,Supermarket,-59.61,GBP,-167262.48,POS,London,GB,9074,user_002,,
1f300531-d64e-483b-917e-b3289731519d,2031-02-25,2031-02-25,Pret A Manger,5814,Food & Drink,Eating Out,-6.31,GBP,-167268.79,POS,London,GB,9074,user_002,,
587cacda-fb9f-4666-ad13-3315b06993d4,2031-02-25,2031-02-25,Local Market,5499,Groceries,Specialty,-19.46,GBP,-167288.25,POS,London,GB,1045,user_002,,
fb306492-11da-4673-833f-47f7d7e14f77,2031-02-25,2031-02-25,T212 Capital,6011,Income,Salary,2969.5,GBP,-164318.75,Credit,London,GB,4488,user_001,rec_2ff8f778d0,
f029afc7-eb3d-4697-9a5d-7b8e97b3cc5c,2031-02-26,2031-02-27,Pret A Manger,5814,Food & Drink,Eating Out,-11.8,GBP,-164330.55,POS,London,GB,9074,user_001,,
99095378-6f9f-4816-a8a8-68af7fdc4c73,2031-02-27,2031-02-28,Transport for London,4111,Transport,Transit,-5.53,GBP,-164336.08,POS,London,GB,9074,user_001,,
05ddc5e2-fae5-4bc7-94cd-a2dee2d44e22,2031-02-28,2031-02-28,Uber UK,4121,Transport,Ride Hailing,-30.89,GBP,-164366.97,E-Com,London,GB,4488,user_001,,
ac346ff2-5ead-440c-a552-6be32ae35130,2031-02-28,2031-03-03,Transport for London,4111,Transport,Transit,-5.57,GBP,-164372.54,POS,London,GB,9074,user_001,,
1bfeae82-8ff4-4c87-b7ef-09d4512daec6,2031-03-01,2031-03-03,Waitrose,5411,Groceries,Supermarket,-35.24,GBP,-164407.78,POS,London,GB,9074,user_001,,
5f7049ac-4cae-4d4a-af32-b3785bf47db7,2031-03-01,2031-03-03,Uber UK,4121,Transport,Ride Hailing,-29.94,GBP,-164437.72,E-Com,London,GB,4488,user_001,,
b4834368-5542-406f-bcc3-b8f0aa5261fc,2031-03-01,2031-03-03,Apple.com/bill,5734,Shopping,Electronics,-55.74,GBP,-164493.46,E-Com,Cupertino,US,4488,user_001,,
1a10e624-409f-4d18-ba04-7719d5eae67a,2031-03-02,2031-03-03,Shell,5541,Transport,Fuel,-81.52,GBP,-164574.98,POS,London,GB,9074,user_001,,
613d977e-f995-46a0-9625-fcc9c492a47f,2031-03-02,2031-03-03,Local Market,5499,Groceries,Specialty,-15.13,GBP,-164590.11,POS,London,GB,2219,user_001,,
a6aaea2c-61df-4e0b-9728-2427f46e74bd,2031-03-02,2031-03-03,Amazon UK,5942,Shopping,Online Retail,-48.53,GBP,-164638.64,E-Com,London,GB,1045,user_001,,
19e4124a-0f18-40e4-9446-783b0751cf61,2031-03-03,2031-03-03,Crown Estates Lettings,6513,Housing,Rent,-1491.13,GBP,-166129.77,POS,London,GB,4488,user_001,rec_19f70fbcce,
3190712c-7810-4477-8a46-4c5ec81a920a,2031-03-03,2031-03-03,ATM Withdrawal,6011,Cash,ATM,-116.24,GBP,-166246.01,ATM,London,GB,1045,user_001,,
94f1b1ed-48a4-4738-abe1-aa93aa76e807,2031-03-03,2031-03-03,Pret A Manger,5814,Food & Drink,Eating Out,-6.93,GBP,-166252.94,POS,London,GB,2219,user_001,,
e2d52479-b2f2-46f2-91a0-fc755061df59,2031-03-03,2031-03-05,Local Market,5499,Groceries,Specialty,-14.74,GBP,-166267.68,POS,London,GB,2219,user_001,,
906d039c-6d71-4365-86a1-6411a9ae58fe,2031-03-04,2031-03-06,Amazon UK,5942,Shopping,Online Retail,-65.43,GBP,-166333.11,E-Com,London,GB,4488,user_001,,
aac17ee5-d6c4-4596-9645-8019f08878eb,2031-03-04,2031-03-05,Tesco,5411,Groceries,Supermarket,-31.97,GBP,-166365.08,POS,London,GB,2219,user_001,,
b6d7215e-614d-46ea-8541-d1bcd3fc860a,2031-03-04,2031-03-06,Local Market,5499,Groceries,Specialty,-10.36,GBP,-166375.44,POS,London,GB,4488,user_001,,
985cad0f-2ac5-438f-a75f-40984f925313,2031-03-05,2031-03-05,Pret A Manger,5814,Food & Drink,Eating Out,-7.99,GBP,-166383.43,POS,London,GB,2219,user_001,,
6aecff80-6fb6-4055-91a4-e4fbf65ef2f7,2031-03-06,2031-03-10,Local Market,5499,Groceries,Specialty,-10.68,GBP,-166394.11,POS,London,GB,9074,user_002,,
c8fc7f5d-986c-47dd-8c9c-820123883819,2031-03-06,2031-03-06,Pret A Manger,5814,Food & Drink,Eating Out,-9.54,GBP,-166403.65,POS,London,GB,2219,user_001,,
14417a25-5db4-4898-b3bd-e6dd5b7bfb8e,2031-03-07,2031-03-07,Transport for London,4111,Transport,Transit,-5.31,GBP,-166408.96,POS,London,GB,4488,user_001,,
c64f6aef-bedf-4590-b23b-50be6ddcc400,2031-03-07,2031-03-10,Octopus Energy,4900,Utilities,Electricity,-119.29,GBP,-166528.25,Direct Debit,London,GB,4488,user_001,rec_141a4a0666,
6e5b72e2-29cb-4237-84e8-724c4a45a804,2031-03-08,2031-03-10,Shell,5541,Transport,Fuel,-56.8,GBP,-166585.05,POS,London,GB,9074,user_001,,
ae7e4bb5-c1b5-467f-96ce-4fee3dd1d484,2031-03-08,2031-03-10,Waitrose,5411,Groceries,Supermarket,-22.89,GBP,-166607.94,POS,London,GB,1045,user_001,,
b00f4bed-2f9b-469c-9849-0a3a026af6e9,2031-03-08,2031-03-10,Apple.com/bill,5734,Shopping,Electronics,-65.16,USD,-166673.1,E-Com,Cupertino,US,9074,user_001,,FX purchase 83.17 USD @ rate 1.28
410f2da5-b596-471f-b1bd-683cd03f983f,2031-03-09,2031-03-11,Shell,5541,Transport,Fuel,-56.9,GBP,-166730.0,POS,London,GB,2219,user_001,,
77cb946c-18ed-4eec-afbc-c88e128aaff8,2031-03-09,2031-03-11,Shell,5541,Transport,Fuel,-92.93,GBP,-166822.93,POS,London,GB,1045,user_001,,
1705c374-73f6-483d-9c86-2745588aaefe,2031-03-11,2031-03-12,Pret A Manger,5814,Food & Drink,Eating Out,-9.31,GBP,-166832.24,POS,London,GB,2219,user_002,,
5b31bb99-bbf1-4365-bd99-eeea4a717bb9,2031-03-11,2031-03-12,Uber UK,4121,Transport,Ride Hailing,-11.23,GBP,-166843.47,E-Com,London,GB,9074,user_001,,
6a712f9c-433e-4452-bd95-32165c7222ff,2031-03-11,2031-03-13,Thames Water,4900,Utilities,Water,-42.57,GBP,-166886.04,Direct Debit,Reading,GB,2219,user_001,rec_3a34d62842,
b1b2caf0-2d5c-49df-8075-b04b2f0f57e5,2031-03-11,2031-03-11,HM Revenue & Customs,9311,Income,Tax Refund,2.9,GBP,-166883.14,Credit,London,GB,1045,user_001,,Refund for Transport for London
b7218c5a-99a9-4b20-a7e7-3e9e952eb8b8,2031-03-11,2031-03-13,Shell,5541,Transport,Fuel,-53.17,GBP,-166936.31,POS,London,GB,9074,user_001,,
dbf047f3-e752-43d8-9ccb-e27feb74730f,2031-03-11,2031-03-12,Uber UK,4121,Transport,Ride Hailing,-29.55,GBP,-166965.86,E-Com,London,GB,9074,user_001,,
1c8453a8-ebb0-4f0f-a28c-485343f93189,2031-03-12,2031-03-13,Amazon UK,5942,Shopping,Online Retail,-74.94,GBP,-167040.8,E-Com,London,GB,9074,user_001,,
e2f9bcfd-3043-42f4-a2b9-13e02c85b476,2031-03-12,2031-03-12,Amazon UK,5942,Shopping,Online Retail,-116.16,GBP,-167156.96,E-Com,London,GB,2219,user_001,,
83699e94-e25c-4887-8eda-9db4bb31e4b3,2031-03-13,2031-03-13,City Council Tax,9399,Utilities,Council Tax,-181.34,GBP,-167338.3,Direct Debit,London,GB,1045,user_001,rec_f531495db5,
95059e4c-38e1-41c9-869f-664d2b8142e4,2031-03-13,2031-03-17,Shell,5541,Transport,Fuel,-80.91,GBP,-167419.21,POS,London,GB,2219,user_001,,
c8a06366-68c8-41ce-962e-f010b3c65448,2031-03-13,2031-03-17,Transport for London,4111,Transport,Transit,-11.0,GBP,-167430.21,POS,London,GB,4488,user_001,,
40198b20-e7d8-47c6-9ae8-1eeef12694f5,2031-03-14,2031-03-14,Airline Refund,4511,Travel,Refund,5.39,GBP,-167424.82,Credit,London,GB,1045,user_001,,Refund for Pret A Manger
a48dd7b1-5493-4b80-94fa-3e1da42fbd54,2031-03-14,2031-03-14,Deliveroo,5812,Food & Drink,Delivery,-16.23,GBP,-167441.05,E-Com,London,GB,2219,user_001,,
b82957f6-8069-40ef-a02d-95b8d22dee0a,2031-03-15,2031-03-17,Amazon UK,5942,Shopping,Online Retail,-30.14,GBP,-167471.19,E-Com,London,GB,9074,user_001,,
97659e2b-e23f-44c6-9c0d-2c2b124cd439,2031-03-16,2031-03-17,Pret A Manger,5814,Food & Drink,Eating Out,-8.54,GBP,-167479.73,POS,London,GB,1045,user_001,,
8c79b6e1-67b8-4cfa-89d2-1fe8143ebe40,2031-03-17,2031-03-19,GymBox,7997,Wellness,Gym,-56.74,GBP,-167536.47,Direct Debit,London,GB,2219,user_001,rec_3906953fd2,
b1a55dce-d099-4214-8dc1-db58853eaa8e,2031-03-17,2031-03-18,O2 UK,4814,Bills,Mobile,-43.04,GBP,-167579.51,Direct Debit,Slough,GB,4488,user_001,rec_95042d8101,
b1f8d780-61c6-4230-8a74-aabbd405bc7b,2031-03-17,2031-03-19,Sainsbury's,5411,Groceries,Supermarket,-57.39,GBP,-167636.9,POS,London,GB,4488,user_001,,
04a36e4d-d370-401d-9be7-7fde2286765e,2031-03-19,2031-03-19,Spotify,5735,Entertainment,Subscriptions,-9.98,EUR,-167646.88,E-Com,Stockholm,SE,9074,user_001,rec_4c746d2c3b,FX purchase 10.64 EUR @ rate 1.07
103faae7-18c2-4e55-b808-efd5cad5c8c7,2031-03-19,2031-03-19,Transport for London,4111,Transport,Transit,-8.49,GBP,-167655.37,POS,London,GB,9074,user_001,,
f461c5af-fd32-4e85-ae84-42230ccc598d,2031-03-19,2031-03-20,Amazon UK,5942,Shopping,Online Retail,-107.83,GBP,-167763.2,E-Com,London,GB,1045,user_001,,
ffb4a1b6-445b-4b0d-aab5-dde861b0e7b6,2031-03-19,2031-03-21,Shell,5541,Transport,Fuel,-42.61,GBP,-167805.81,POS,London,GB,9074,user_002,,
04164be4-da86-43f1-b87d-03cb52418924,2031-03-20,2031-03-21,Sainsbury's,5411,Groceries,Supermarket,-51.81,GBP,-167857.62,POS,London,GB,4488,user_001,,
b46e26a9-12c4-4c58-b5ec-528018a5d81a,2031-03-20,2031-03-20,HM Revenue & Customs,9311,Income,Tax Refund,9.4,GBP,-167848.22,Credit,London,GB,9074,user_001,,Refund for Pret A Manger
8e79fc96-803e-4225-b33d-6c1ef1742dc5,2031-03-21,2031-03-21,Netflix,7841,Entertainment,Subscriptions,-11.98,GBP,-167860.2,E-Com,Los Gatos,US,1045,user_001,rec_1bfe33738d,
0cd31ea2-9853-4f78-8ad6-cc05e70980c3,2031-03-22,2031-03-24,Pret A Manger,5814,Food & Drink,Eating Out,-9.5,GBP,-167869.7,POS,London,GB,2219,user_002,,
2a8a96f1-3e1c-4e1e-8002-25421cda60e2,2031-03-22,2031-03-24,Sainsbury's,5411,Groceries,Supermarket,-45.88,GBP,-167915.58,POS,London,GB,1045,user_001,,
3579fe3f-8fff-40c5-9084-c4d25f39f8e2,2031-03-22,2031-03-24,Pret A Manger,5814,Food & Drink,Eating Out,-5.53,GBP,-167921.11,POS,London,GB,1045,user_001,,
78a03a57-0812-49d0-979e-a43097dcdb4e,2031-03-22,2031-03-24,Local Market,5499,Groceries,Specialty,-21.48,GBP,-167942.59,POS,London,GB,2219,user_001,,
d5ff0193-3e49-4137-9249-49f96d51c309,2031-03-22,2031-03-24,Pret A Manger,5814,Food & Drink,Eating Out,-9.11,GBP,-167951.7,POS,London,GB,4488,user_001,,
07799f1b-51e1-4aac-a8b7-1b6c3f478e5a,2031-03-23,2031-03-24,Tesco,5411,Groceries,Supermarket,-34.53,GBP,-167986.23,POS,London,GB,9074,user_001,,
2c32def7-8008-4f12-960c-9d75b276740e,2031-03-23,2031-03-25,Amazon UK,5942,Shopping,Online Retail,-95.52,GBP,-168081.75,E-Com,London,GB,2219,user_001,,
39de8cc8-36a2-4465-b156-c03c86654c8f,2031-03-23,2031-03-25,Sainsbury's,5411,Groceries,Supermarket,-24.67,GBP,-168106.42,POS,London,GB,1045,user_001,,
8088228b-4b90-4b44-8296-e7b08f2abdd5,2031-03-23,2031-03-24,Shell,5541,Transport,Fuel,-55.88,GBP,-168162.3,POS,London,GB,1045,user_001,,
cb93550a-e0fd-42b6-807c-fd85dbcce485,2031-03-23,2031-03-24,Shell,5541,Transport,Fuel,-46.69,GBP,-168208.99,POS,London,GB,4488,user_001,,
d7c05ecf-3d17-44f3-acb3-882aca7b92c9,2031-03-23,2031-03-24,Transport for London,4111,Transport,Transit,-11.13,GBP,-168220.12,POS,London,GB,1045,user_001,,
59929af0-288c-48ad-a4fa-c67bd61847de,2031-03-25,2031-03-25,Uber UK,4121,Transport,Ride Hailing,-32.98,GBP,-168253.1,E-Com,London,GB,9074,user_001,,
85149d1a-4c3b-46bb-9ced-361a6bb5c970,2031-03-25,2031-03-25,Sainsbury's,5411,Groceries,Supermarket,-35.08,GBP,-168288.18,POS,London,GB,9074,user_001,,
8cf9d205-de37-4021-8adc-c9564362144e,2031-03-25,2031-03-25,Shell,5541,Transport,Fuel,-38.73,GBP,-168326.91,POS,London,GB,4488,user_001,,
d6f94692-8115-429e-a0c6-38d4fdc00cac,2031-03-25,2031-03-25,T212 Capital,6011,Income,Salary,3448.38,GBP,-164878.53,Credit,London,GB,1045,user_002,rec_c649d24d0f,
109ec139-f0d0-4022-a4ec-36a273e58cda,2031-03-26,2031-03-26,Local Market,5499,Groceries,Specialty,-16.67,GBP,-164895.2,POS,London,GB,1045,user_002,,
30f87d89-302d-436e-b21d-55eee375c155,2031-03-26,2031-03-27,Deliveroo,5812,Food & Drink,Delivery,-28.91,GBP,-164924.11,E-Com,London,GB,1045,user_001,,
2a1cdd73-2f6a-4ba5-a0be-ed505afbe9ef,2031-03-27,2031-03-28,Pret A Manger,5814,Food & Drink,Eating Out,-10.38,GBP,-164934.49,POS,London,GB,1045,user_001,,
84eca7ef-99e6-4aa7-88c9-205c752f0692,2031-03-28,2031-03-28,Shell,5541,Transport,Fuel,-94.96,GBP,-165029.45,POS,London,GB,1045,user_001,,
17d79105-d01c-42d2-b38e-42f87945bce5,2031-03-29,2031-03-31,Deliveroo,5812,Food & Drink,Delivery,-29.96,GBP,-165059.41,E-Com,London,GB,2219,user_002,,
e29b36ee-94fe-49d1-93c7-c0e06d184cb9,2031-03-29,2031-03-31,Sainsbury's,5411,Groceries,Supermarket,-23.65,GBP,-165083.06,POS,London,GB,9074,user_001,,
151a6a7e-22ce-4050-b963-c51cea85bde8,2031-03-30,2031-03-31,Deliveroo,5812,Food & Drink,Delivery,-19.15,GBP,-165102.21,E-Com,London,GB,9074,user_001,,
451b299d-fdc7-4ffd-828b-1fa02d1ef499,2031-03-30,2031-03-31,Uber UK,4121,Transport,Ride Hailing,-22.33,GBP,-165124.54,E-Com,London,GB,9074,user_002,,
50c9667e-383e-419f-bdaa-524186b37040,2031-03-30,2031-03-31,Shell,5541,Transport,Fuel,-91.0,GBP,-165215.54,POS,London,GB,4488,user_001,,
b43ba044-6bb0-4698-bd42-a76933429cd1,2031-03-30,2031-03-31,Shell,5541,Transport,Fuel,-64.21,GBP,-165279.75,POS,London,GB,2219,user_001,,
01f7bb9a-ddbb-4cb6-9b5a-bab630fb25bb,2031-03-31,2031-04-01,Local Market,5499,Groceries,Specialty,-17.83,GBP,-165297.58,POS,London,GB,2219,user_002,,
091e2c78-fa07-4880-8dc8-751b3a0bcedc,2031-03-31,2031-03-31,Waitrose,5411,Groceries,Supermarket,-42.84,GBP,-165340.42,POS,London,GB,9074,user_001,,
1382b79e-018f-4851-ac77-5b5016348124,2031-03-31,2031-03-31,Apple.com/bill,5734,Shopping,Electronics,-162.76,USD,-165503.18,E-Com,Cupertino,US,9074,user_001,,FX purchase 202.14 USD @ rate 1.24
38fd886e-6aa8-4f94-86c3-bf0328d1fc2c,2031-03-31,2031-03-31,Deliveroo,5812,Food & Drink,Delivery,-26.25,GBP,-165529.43,E-Com,London,GB,2219,user_002,,
a0297e98-2d72-45c8-b5be-1c67f41975d9,2031-04-01,2031-04-01,Crown Estates Lettings,6513,Housing,Rent,-1531.92,GBP,-167061.35,POS,London,GB,2219,user_001,rec_19f70fbcce,
023e66b0-c758-4224-92fc-ddfdbe94c856,2031-04-02,2031-04-02,Amazon UK,5942,Shopping,Online Retail,-55.03,GBP,-167116.38,E-Com,London,GB,2219,user_001,,
2eb147a0-483f-4ed3-a81c-96ff695ef87a,2031-04-02,2031-04-02,Deliveroo,5812,Food & Drink,Delivery,-25.23,GBP,-167141.61,E-Com,London,GB,4488,user_001,,
6f7a07a7-3a57-4e8c-aff5-0285b5bfb39b,2031-04-04,2031-04-04,Waitrose,5411,Groceries,Supermarket,-53.63,GBP,-167195.24,POS,London,GB,4488,user_001,,
a2bc41f2-3c20-4132-be98-2f9e2053c16c,2031-04-04,2031-04-04,Tesco,5411,Groceries,Supermarket,-73.02,GBP,-167268.26,POS,London,GB,9074,user_001,,
a34917a1-2a45-43ad-b8c8-f794b1799c47,2031-04-04,2031-04-07,Waitrose,5411,Groceries,Supermarket,-34.3,GBP,-167302.56,POS,London,GB,1045,user_002,,
04715263-4353-42fc-8536-036838358f9f,2031-04-05,2031-04-07,Local Market,5499,Groceries,Specialty,-17.43,GBP,-167319.99,POS,London,GB,2219,user_002,,
2ba41fe3-ebc2-4e42-8813-d93a095bb6d6,2031-04-05,2031-04-07,Apple.com/bill,5734,Shopping,Electronics,-6.68,GBP,-167326.67,E-Com,Cupertino,US,1045,user_002,,
9a5f80df-3a60-4e0d-961d-8dcfd2ca129c,2031-04-05,2031-04-07,Local Market,5499,Groceries,Specialty,-11.08,GBP,-167337.75,POS,London,GB,1045,user_001,,
d67701c2-f43b-493c-aa19-a26fa07b0756,2031-04-05,2031-04-07,Tesco,5411,Groceries,Supermarket,-73.56,GBP,-167411.31,POS,London,GB,1045,user_001,,
d895b2b4-e133-449e-b7fc-2ab03e7eb9ff,2031-04-05,2031-04-07,Pret A Manger,5814,Food & Drink,Eating Out,-10.91,GBP,-167422.22,POS,London,GB,1045,user_001,,
3584314a-d17d-4b22-81cf-70a173f15cee,2031-04-06,2031-04-08,Sainsbury's,5411,Groceries,Supermarket,-35.91,GBP,-167458.13,POS,London,GB,4488,user_001,,
758426c0-68d6-434c-a880-f329a1de9490,2031-04-06,2031-04-08,Waitrose,5411,Groceries,Supermarket,-74.25,GBP,-167532.38,POS,London,GB,4488,user_001,,
8a794542-b090-4d25-bdb5-5c46d0c9b009,2031-04-06,2031-04-07,Sainsbury's,5411,Groceries,Supermarket,-35.11,GBP,-167567.49,POS,London,GB,4488,user_001,,
0ae6b318-e9da-4085-9d7c-94d78fbfb121,2031-04-07,2031-04-08,Deliveroo,5812,Food & Drink,Delivery,-18.78,GBP,-167586.27,E-Com,London,GB,9074,user_001,,
467287a8-e8e0-4540-961f-12c10a6b50f3,2031-04-07,2031-04-08,Octopus Energy,4900,Utilities,Electricity,-113.89,GBP,-167700.16,Direct Debit,London,GB,2219,user_001,rec_141a4a0666,
7495d230-98b0-4e90-9c79-e5fd56dd6065,2031-04-07,2031-04-09,Deliveroo,5812,Food & Drink,Delivery,-18.93,GBP,-167719.09,E-Com,London,GB,2219,user_001,,
1101df54-a967-4ee8-a28e-50eda1eebf02,2031-04-09,2031-04-11,Pret A Manger,5814,Food & Drink,Eating Out,-8.76,GBP,-167727.85,POS,London,GB,1045,user_001,,
1b58ab6a-b1e2-4aa0-a04e-a65e07cdca8a,2031-04-10,2031-04-14,Transport for London,4111,Transport,Transit,-5.0,GBP,-167732.85,POS,London,GB,1045,user_002,,
2235c627-303b-4992-9185-ce505a2f9af8,2031-04-10,2031-04-11,Waitrose,5411,Groceries,Supermarket,-63.13,GBP,-167795.98,POS,London,GB,1045,user_001,,
57fb7ca1-16e6-40a8-b2fe-3ec5678e61c1,2031-04-10,2031-04-10,Uber UK,4121,Transport,Ride Hailing,-22.26,GBP,-167818.24,E-Com,London,GB,2219,user_001,,
9724b675-9449-4ecc-98c2-7a7a2fef7323,2031-04-11,2031-04-14,Thames Water,4900,Utilities,Water,-33.97,GBP,-167852.21,Direct Debit,Reading,GB,4488,user_001,rec_3a34d62842,
92f62a09-0221-41af-a34b-9719d0843df0,2031-04-12,2031-04-14,Transport for London,4111,Transport,Transit,-7.23,GBP,-167859.44,POS,London,GB,4488,user_001,,
e67bee00-fb2e-418c-8fcc-b8c727baa9c3,2031-04-12,2031-04-14,Pret A Manger,5814,Food & Drink,Eating Out,-10.79,GBP,-167870.23,POS,London,GB,9074,user_001,,
28bd0504-f5ce-476b-82c4-ff63c6b2b330,2031-04-13,2031-04-14,Amazon UK,5942,Shopping,Online Retail,-38.56,GBP,-167908.79,E-Com,London,GB,9074,user_001,,
8bf4f06e-4ca4-49f3-9e3f-f5e5a75c8e0b,2031-04-13,2031-04-14,Local Market,5499,Groceries,Specialty,-6.82,GBP,-167915.61,POS,London,GB,9074,user_001,,
a8d63bac-93b4-42ae-8da8-43424154be57,2031-04-13,2031-04-15,Tesco,5411,Groceries,Supermarket,-64.87,GBP,-167980.48,POS,London,GB,9074,user_001,,
cabcaaf2-fc76-4659-a3ab-a10baf7dfb39,2031-04-13,2031-04-14,Uber UK,4121,Transport,Ride Hailing,-12.96,GBP,-167993.44,E-Com,London,GB,1045,user_001,,
d245882e-7784-4b0a-903f-915fb9f957e1,2031-04-13,2031-04-14,Pret A Manger,5814,Food & Drink,Eating Out,-11.41,GBP,-168004.85,POS,London,GB,9074,user_001,,
f0e758bc-50fa-477e-b705-29fad5486517,2031-04-13,2031-04-14,Transport for London,4111,Transport,Transit,-9.13,GBP,-168013.98,POS,London,GB,9074,user_002,,
1620c853-99ad-4506-bdb5-85ecb60c3afd,2031-04-14,2031-04-16,City Council Tax,9399,Utilities,Council Tax,-174.82,GBP,-168188.8,Direct Debit,London,GB,4488,user_001,rec_f531495db5,
1c01ff31-760f-4986-9319-fa48f38ea4fe,2031-04-14,2031-04-16,Uber UK,4121,Transport,Ride Hailing,-13.53,GBP,-168202.33,E-Com,London,GB,9074,user_001,,
3516f3a3-7fc4-4929-be60-ab212f733e36,2031-04-15,2031-04-15,O2 UK,4814,Bills,Mobile,-54.58,GBP,-168256.91,Direct Debit,Slough,GB,4488,user_001,rec_95042d8101,
3550d4a3-796d-46f5-86d3-9baf776cd0c6,2031-04-15,2031-04-15,Tesco,5411,Groceries,Supermarket,-52.97,GBP,-168309.88,POS,London,GB,9074,user_002,,
7def0e29-d37f-47a6-a318-2f8d1f12b968,2031-04-15,2031-04-17,Uber UK,4121,Transport,Ride Hailing,-30.11,GBP,-168339.99,E-Com,London,GB,9074,user_001,,
4846385a-6c8e-4b95-87ca-db168612c227,2031-04-16,2031-04-18,Waitrose,5411,Groceries,Supermarket,-23.67,GBP,-168363.66,POS,London,GB,2219,user_001,,
7bcfbf17-bcbb-4dde-a101-8c6c286aceef,2031-04-16,2031-04-16,Uber UK,4121,Transport,Ride Hailing,-22.41,GBP,-168386.07,E-Com,London,GB,2219,user_001,,
c84880ca-5b9c-4b64-a258-0f6d6418fc57,2031-04-16,2031-04-16,Local Market,5499,Groceries,Specialty,-15.66,GBP,-168401.73,POS,London,GB,4488,user_002,,
ffd66a77-d063-4afb-87da-5c097870a0ea,2031-04-16,2031-04-18,Uber UK,4121,Transport,Ride Hailing,-18.58,GBP,-168420.31,E-Com,London,GB,9074,user_002,,
3184b54c-a282-4e58-80cc-017f027f6de5,2031-04-17,2031-04-18,Transport for London,4111,Transport,Transit,-8.22,GBP,-168428.53,POS,London,GB,4488,user_002,,
35b119b2-d0e9-408e-ae8b-26eaf805141a,2031-04-17,2031-04-17,HM Revenue & Customs,9311,Income,Tax Refund,8.71,GBP,-168419.82,Credit,London,GB,9074,user_002,,Refund for Local Market
a982fe18-9b2b-42f3-ad76-c58283beffd6,2031-04-17,2031-04-17,GymBox,7997,Wellness,Gym,-57.32,GBP,-168477.14,Direct Debit,London,GB,4488,user_001,rec_3906953fd2,
60c2b649-7a29-443d-9e6f-31a224569d1a,2031-04-18,2031-04-21,Tesco,5411,Groceries,Supermarket,-37.61,GBP,-168514.75,POS,London,GB,2219,user_001,,
65f370b2-e7fa-4bbb-8584-0dc2638b13c1,2031-04-18,2031-04-18,Airbnb,7011,Travel,Accommodation,-416.12,GBP,-168930.87,E-Com,Dublin,IE,1045,user_001,,Holiday booking
7f90007c-c01a-4eec-a9b6-3f6e2864abbe,2031-04-18,2031-04-21,ATM Withdrawal,6011,Cash,ATM,-84.82,GBP,-169015.69,ATM,London,GB,2219,user_001,,
a9382da0-dfc4-4c67-aa1f-09b092aece1e,2031-04-19,2031-04-21,Shell,5541,Transport,Fuel,-75.6,GBP,-169091.29,POS,London,GB,1045,user_001,,
bf9e1496-17f0-4a88-8290-6d3f170362b1,2031-04-19,2031-04-21,Tesco,5411,Groceries,Supermarket,-28.09,GBP,-169119.38,POS,London,GB,1045,user_001,,
1f2d6721-cedb-478d-88e6-fb37779650a7,2031-04-20,2031-04-21,Transport for London,4111,Transport,Transit,-10.46,GBP,-169129.84,POS,London,GB,9074,user_002,,
30c5885a-94b6-4811-83f2-f0043aeb45fa,2031-04-20,2031-04-21,Sainsbury's,5411,Groceries,Supermarket,-54.3,GBP,-169184.14,POS,London,GB,2219,user_002,,
944fb670-385c-4ad5-9764-17d59694e3c7,2031-04-20,2031-04-21,HM Revenue & Customs,9311,Income,Tax Refund,1233.48,GBP,-167950.66,Credit,London,GB,9074,user_001,,Refund for Crown Estates Lettings
f337a857-1a27-4e8b-8ff4-f301ff41ffab,2031-04-20,2031-04-21,Amazon UK,5942,Shopping,Online Retail,-14.15,GBP,-167964.81,E-Com,London,GB,1045,user_002,,
430c416f-7d64-4539-b4ca-002b1866a0ca,2031-04-21,2031-04-21,Netflix,7841,Entertainment,Subscriptions,-12.45,USD,-167977.26,E-Com,Los Gatos,US,4488,user_001,rec_1bfe33738d,FX purchase 15.7 USD @ rate 1.26
7547d5a3-c7fe-4312-86e1-44ad646f42e2,2031-04-21,2031-04-22,Spotify,5735,Entertainment,Subscriptions,-9.77,GBP,-167987.03,E-Com,Stockholm,SE,4488,user_001,rec_4c746d2c3b,
07cabc60-d225-448e-b6e3-b7d8f5408216,2031-04-22,2031-04-24,Local Market,5499,Groceries,Specialty,-8.37,GBP,-167995.4,POS,London,GB,4488,user_001,,
528aefca-db01-4ace-a15b-fb7a92116dc6,2031-04-22,2031-04-23,Uber UK,4121,Transport,Ride Hailing,-18.44,GBP,-168013.84,E-Com,London,GB,9074,user_001,,
dda9c786-b344-4ea3-b227-209ff6e283c5,2031-04-23,2031-04-25,Local Market,5499,Groceries,Specialty,-11.2,GBP,-168025.04,POS,London,GB,4488,user_001,,
4202fe00-3c46-457c-9f90-a779f6c0d524,2031-04-24,2031-04-28,Amazon UK,5942,Shopping,Online Retail,-10.75,GBP,-168035.79,E-Com,London,GB,9074,user_001,,
5df9d43e-7502-4acf-90f0-ca8ef13de35a,2031-04-24,2031-04-28,Transport for London,4111,Transport,Transit,-7.5,GBP,-168043.29,POS,London,GB,9074,user_001,,
228f6ccf-ec62-4fc8-b3d7-e85280d73a7f,2031-04-25,2031-04-28,Uber UK,4121,Transport,Ride Hailing,-13.35,GBP,-168056.64,E-Com,London,GB,1045,user_001,,
c6799808-593e-45be-9d94-df85306de878,2031-04-25,2031-04-25,T212 Capital,6011,Income,Salary,3109.18,GBP,-164947.46,Credit,London,GB,9074,user_002,rec_c649d24d0f,
a76729bd-e780-4599-ac9e-5e250b217d97,2031-04-26,2031-04-28,Apple.com/bill,5734,Shopping,Electronics,-138.39,GBP,-165085.85,E-Com,Cupertino,US,9074,user_001,,
2129abdd-b6bc-4876-956d-216cf6572801,2031-04-27,2031-04-29,Apple.com/bill,5734,Shopping,Electronics,-209.67,GBP,-165295.52,E-Com,Cupertino,US,9074,user_001,,
900876aa-5957-4118-bb6d-c2baf09c6b6f,2031-04-27,2031-04-28,Uber UK,4121,Transport,Ride Hailing,-33.09,GBP,-165328.61,E-Com,London,GB,1045,user_001,,
bfde93cf-3d41-4aa2-8cde-7b149f6222d7,2031-04-27,2031-04-28,Transport for London,4111,Transport,Transit,-10.53,GBP,-165339.14,POS,London,GB,9074,user_001,,
f268d7b9-6d87-4867-9f63-24195f5733cb,2031-04-27,2031-04-29,Uber UK,4121,Transport,Ride Hailing,-12.33,GBP,-165351.47,E-Com,London,GB,1045,user_001,,
a96e437f-d01e-4cea-8dc4-9128483f478e,2031-04-28,2031-04-29,Waitrose,5411,Groceries,Supermarket,-58.72,GBP,-165410.19,POS,London,GB,1045,user_002,,
b0c16647-7e43-44e0-a12f-79753acd7b96,2031-04-28,2031-04-30,Shell,5541,Transport,Fuel,-82.55,GBP,-165492.74,POS,London,GB,1045,user_001,,
21e6c796-ad5a-4d57-b516-2dfbf3aee115,2031-04-29,2031-05-01,Deliveroo,5812,Food & Drink,Delivery,-30.7,GBP,-165523.44,E-Com,London,GB,9074,user_001,,
907c7698-e5bf-4fe5-9df1-4ea4f13e00d1,2031-04-29,2031-04-30,Transport for London,4111,Transport,Transit,-3.8,GBP,-165527.24,POS,London,GB,4488,user_001,,
c58820f1-94b1-4e4b-b80c-584b53d4a747,2031-04-29,2031-04-30,Local Market,5499,Groceries,Specialty,-13.54,GBP,-165540.78,POS,London,GB,9074,user_002,,
38d0942c-2389-4050-8646-952621d3d8e4,2031-05-01,2031-05-01,Crown Estates Lettings,6513,Housing,Rent,-1546.88,GBP,-167087.66,POS,London,GB,2219,user_001,rec_19f70fbcce,
ad7110cc-14bc-4797-b759-ca2e5f0d3bbe,2031-05-01,2031-05-05,Tesco,5411,Groceries,Supermarket,-69.13,GBP,-167156.79,POS,London,GB,9074,user_002,,
a75a6dd1-68b8-419a-9a48-23857652777f,2031-05-02,2031-05-05,Uber UK,4121,Transport,Ride Hailing,-34.55,GBP,-167191.34,E-Com,London,GB,4488,user_002,,
0c9b783b-1210-4251-9990-436bc722c6ca,2031-05-03,2031-05-05,Pret A Manger,5814,Food & Drink,Eating Out,-5.76,GBP,-167197.1,POS,London,GB,2219,user_001,,
c9dc03e2-9b11-4443-b939-f07df9302ee4,2031-05-03,2031-05-05,Pret A Manger,5814,Food & Drink,Eating Out,-6.58,GBP,-167203.68,POS,London,GB,1045,user_001,,
25de6727-3646-4cc1-a45c-f5eb4e964e82,2031-05-04,2031-05-05,Waitrose,5411,Groceries,Supermarket,-51.93,GBP,-167255.61,POS,London,GB,1045,user_001,,
a6f07cd9-5e13-4901-a6df-2694541cc4b7,2031-05-04,2031-05-05,Deliveroo,5812,Food & Drink,Delivery,-16.19,GBP,-167271.8,E-Com,London,GB,2219,user_001,,
cc2ead0c-b608-4e89-a606-d946bbea4e62,2031-05-04,2031-05-05,Transport for London,4111,Transport,Transit,-6.44,GBP,-167278.24,POS,London,GB,1045,user_001,,
fe10c2bd-9665-41c3-abfa-327ae4fa2792,2031-05-04,2031-05-05,Amazon UK,5942,Shopping,Online Retail,-99.87,GBP,-167378.11,E-Com,London,GB,2219,user_002,,
02411998-1906-40cc-942d-124bd7c6e549,2031-05-05,2031-05-05,Waitrose,5411,Groceries,Supermarket,-77.96,GBP,-167456.07,POS,London,GB,4488,user_001,,
0d7b42cf-c8d4-489e-8603-8c5ea459ddbe,2031-05-05,2031-05-05,Sainsbury's,5411,Groceries,Supermarket,-17.95,GBP,-167474.02,POS,London,GB,9074,user_001,,
3f0188d4-33ec-41bb-b704-3791df04a13e,2031-05-05,2031-05-05,Local Market,5499,Groceries,Specialty,-10.53,GBP,-167484.55,POS,London,GB,2219,user_001,,
e9823a58-7eaa-4fe9-a34b-9780ec78700b,2031-05-05,2031-05-05,Apple.com/bill,5734,Shopping,Electronics,-97.14,USD,-167581.69,E-Com,Cupertino,US,4488,user_001,,FX purchase 124.28 USD @ rate 1.28
1b447e4c-7602-4430-8a11-bac2fd9a9efb,2031-05-06,2031-05-06,Deliveroo,5812,Food & Drink,Delivery,-22.76,GBP,-167604.45,E-Com,London,GB,9074,user_001,,
c0e65f6b-8d8c-4116-8980-b2fc25ba8876,2031-05-07,2031-05-07,Octopus Energy,4900,Utilities,Electricity,-127.78,GBP,-167732.23,Direct Debit,London,GB,4488,user_001,rec_141a4a0666,
fde20b1c-7143-4e0f-a2af-b53941587fec,2031-05-07,2031-05-07,Tesco,5411,Groceries,Supermarket,-39.91,GBP,-167772.14,POS,London,GB,9074,user_001,,
0ae0f965-3797-4d5a-8888-b2d9358c8170,2031-05-08,2031-05-08,Uber UK,4121,Transport,Ride Hailing,-30.47,GBP,-167802.61,E-Com,London,GB,2219,user_001,,
193132ab-5823-406a-9fcc-c8979e8ce332,2031-05-08,2031-05-12,Sainsbury's,5411,Groceries,Supermarket,-47.14,GBP,-167849.75,POS,London,GB,4488,user_001,,
2d2a3146-a196-48d3-b4ea-50ff1b6fd571,2031-05-08,2031-05-08,Pret A Manger,5814,Food & Drink,Eating Out,-6.72,GBP,-167856.47,POS,London,GB,1045,user_002,,
7c075c70-b371-4f19-9f32-1bdef9912a3e,2031-05-08,2031-05-12,Local Market,5499,Groceries,Specialty,-12.66,GBP,-167869.13,POS,London,GB,1045,user_002,,
b5b76968-425a-40cb-9386-8a2e3aef29e9,2031-05-08,2031-05-12,Apple.com/bill,5734,Shopping,Electronics,-50.64,USD,-167919.77,E-Com,Cupertino,US,1045,user_002,,FX purchase 63.27 USD @ rate 1.25
f4d54ac0-ff1c-45cd-8d1a-e112d5274672,2031-05-08,2031-05-09,Tesco,5411,Groceries,Supermarket,-73.14,GBP,-167992.91,POS,London,GB,1045,user_001,,
5b947050-a5b5-42b5-880a-4e3a0cb3155f,2031-05-09,2031-05-09,HM Revenue & Customs,9311,Income,Tax Refund,169.06,GBP,-167823.85,Credit,London,GB,2219,user_001,,Refund for Apple.com/bill
238d40ee-a543-48f0-8125-c7505f4477bf,2031-05-10,2031-05-12,Uber UK,4121,Transport,Ride Hailing,-24.05,GBP,-167847.9,E-Com,London,GB,2219,user_001,,
4370189a-0668-4bf0-ba6d-ad5ff8b8c0e2,2031-05-10,2031-05-12,Pret A Manger,5814,Food & Drink,Eating Out,-7.16,GBP,-167855.06,POS,London,GB,4488,user_001,,
c7d5010d-a76c-4bd1-bbb8-b3e954012edd,2031-05-10,2031-05-12,Shell,5541,Transport,Fuel,-78.45,GBP,-167933.51,POS,London,GB,9074,user_001,,
01579388-3b6a-4a92-86b4-52f0092cbc0e,2031-05-11,2031-05-12,Sainsbury's,5411,Groceries,Supermarket,-21.67,GBP,-167955.18,POS,London,GB,2219,user_001,,
c24318a2-acb6-4bd2-b134-3ab02666a556,2031-05-11,2031-05-12,Sainsbury's,5411,Groceries,Supermarket,-21.55,GBP,-167976.73,POS,London,GB,4488,user_001,,
c49f2e78-8c7d-4278-85ab-7e9a62424bd6,2031-05-11,2031-05-13,Local Market,5499,Groceries,Specialty,-14.85,GBP,-167991.58,POS,London,GB,1045,user_001,,
e15ba82f-f07e-4030-bd44-9f812fd44265,2031-05-11,2031-05-12,Waitrose,5411,Groceries,Supermarket,-67.41,GBP,-168058.99,POS,London,GB,4488,user_001,,
efd8ccd5-4464-447e-a4c8-304794db1d5c,2031-05-11,2031-05-12,Uber UK,4121,Transport,Ride Hailing,-31.35,GBP,-168090.34,E-Com,London,GB,2219,user_001,,
fa9a746e-b8ce-46bc-a036-9cae10a3bd0e,2031-05-11,2031-05-12,Sainsbury's,5411,Groceries,Supermarket,-17.11,GBP,-168107.45,POS,London,GB,9074,user_001,,
3d40d90a-4d7e-4ffc-9ecf-7e9d558d6079,2031-05-12,2031-05-12,Amazon UK,5942,Shopping,Online Retail,-110.5,GBP,-168217.95,E-Com,London,GB,9074,user_001,,
99fd5675-5bd8-4aeb-be04-c3061bc549ac,2031-05-12,2031-05-12,Thames Water,4900,Utilities,Water,-37.61,GBP,-168255.56,Direct Debit,Reading,GB,9074,user_001,rec_3a34d62842,
b62fa11e-1f9e-4565-bfe3-01330c793610,2031-05-12,2031-05-13,Shell,5541,Transport,Fuel,-79.05,GBP,-168334.61,POS,London,GB,1045,user_001,,
322bad74-90ca-49e2-8cd0-38edd1a65598,2031-05-13,2031-05-14,City Council Tax,9399,Utilities,Council Tax,-171.98,GBP,-168506.59,Direct Debit,London,GB,2219,user_001,rec_f531495db5,
3eff6e52-0791-4a42-aa6a-c1bdba30ee8c,2031-05-14,2031-05-15,Shell,5541,Transport,Fuel,-88.5,GBP,-168595.09,POS,London,GB,2219,user_002,,
47c90363-1e8c-4d18-87ec-3ea1c48d9a2c,2031-05-14,2031-05-15,Tesco,5411,Groceries,Supermarket,-55.14,GBP,-168650.23,POS,London,GB,2219,user_001,,
a4e57c16-9fe2-4f44-94f3-e4d235cc7ecb,2031-05-14,2031-05-16,Deliveroo,5812,Food & Drink,Delivery,-21.79,GBP,-168672.02,E-Com,London,GB,1045,user_001,,
d29ce693-5842-43c4-8590-3c1a68fea846,2031-05-15,2031-05-16,O2 UK,4814,Bills,Mobile,-37.44,GBP,-168709.46,Direct Debit,Slough,GB,1045,user_002,rec_d2dce4c42f,
027817c0-3104-4ad3-b562-0259e1502a01,2031-05-16,2031-05-19,Pret A Manger,5814,Food & Drink,Eating Out,-6.02,GBP,-168715.48,POS,London,GB,4488,user_002,,
4642366b-2c3f-4c77-87f6-f1e8841d2868,2031-05-16,2031-05-19,Transport for London,4111,Transport,Transit,-10.99,GBP,-168726.47,POS,London,GB,9074,user_001,,
5f4ce5d0-c4ba-41ce-9c67-5fc9eba3bf1d,2031-05-16,2031-05-16,Sainsbury's,5411,Groceries,Supermarket,-39.03,GBP,-168765.5,POS,London,GB,1045,user_001,,
8869b088-2fdc-4cc2-9e09-42183577a9c5,2031-05-16,2031-05-19,Waitrose,5411,Groceries,Supermarket,-52.73,GBP,-168818.23,POS,London,GB,9074,user_001,,
09520c04-6603-43cf-a1e7-25c771ff0003,2031-05-17,2031-05-19,ATM Withdrawal,6011,Cash,ATM,-113.79,GBP,-168932.02,ATM,London,GB,1045,user_001,,
1986aadb-f054-4f32-b64d-e25bb1c284d1,2031-05-17,2031-05-19,Tesco,5411,Groceries,Supermarket,-75.91,GBP,-169007.93,POS,London,GB,9074,user_001,,
6b1a6e12-4b29-4214-b5bc-851acf6dd83a,2031-05-17,2031-05-19,Deliveroo,5812,Food & Drink,Delivery,-23.69,GBP,-169031.62,E-Com,London,GB,4488,user_001,,
7f6b4da2-c66e-4f03-9330-bc4c0d0d21a2,2031-05-17,2031-05-19,Pret A Manger,5814,Food & Drink,Eating Out,-8.97,GBP,-169040.59,POS,London,GB,9074,user_001,,
c1bc2e64-fb17-44ea-b555-bd1796d99576,2031-05-17,2031-05-19,Sainsbury's,5411,Groceries,Supermarket,-33.52,GBP,-169074.11,POS,London,GB,4488,user_001,,
ed2ff058-af1e-428d-8b9d-76c56a7b0a78,2031-05-17,2031-05-19,Uber UK,4121,Transport,Ride Hailing,-12.93,GBP,-169087.04,E-Com,London,GB,9074,user_001,,
c78c81a2-78f5-49fc-9796-3b3ac79444a8,2031-05-18,2031-05-20,Local Market,5499,Groceries,Specialty,-14.72,GBP,-169101.76,POS,London,GB,9074,user_001,,
cfb03226-0ed7-4189-95c2-9c257e5a373c,2031-05-18,2031-05-20,Amazon UK,5942,Shopping,Online Retail,-107.7,GBP,-169209.46,E-Com,London,GB,4488,user_001,,
dabd6d65-a1fb-47af-8972-e3aae6044324,2031-05-18,2031-05-19,Sainsbury's,5411,Groceries,Supermarket,-54.93,GBP,-169264.39,POS,London,GB,2219,user_001,,
1c4f5f07-b131-4b0a-b67f-038972c9999a,2031-05-19,2031-05-21,Waitrose,5411,Groceries,Supermarket,-34.89,GBP,-169299.28,POS,London,GB,2219,user_001,,
7cd3b090-19a2-4568-a728-7ec322d405a4,2031-05-19,2031-05-20,Spotify,5735,Entertainment,Subscriptions,-8.21,EUR,-169307.49,E-Com,Stockholm,SE,2219,user_001,rec_4c746d2c3b,FX purchase 9.48 EUR @ rate 1.15
c5cf7eb7-acbe-4a94-958a-e60d3a66ff2b,2031-05-19,2031-05-21,GymBox,7997,Wellness,Gym,-45.1,GBP,-169352.59,Direct Debit,London,GB,9074,user_001,rec_3906953fd2,
dbc833ca-cc43-4078-b524-573fce028460,2031-05-19,2031-05-21,Tesco,5411,Groceries,Supermarket,-28.82,GBP,-169381.41,POS,London,GB,2219,user_001,,
5f53cf43-a5b5-4a57-8e10-f00d45852282,2031-05-20,2031-05-21,Uber UK,4121,Transport,Ride Hailing,-33.28,GBP,-169414.69,E-Com,London,GB,1045,user_001,,
db4ce313-d859-4263-9275-da755b525711,2031-05-20,2031-05-20,Apple.com/bill,5734,Shopping,Electronics,-22.7,GBP,-169437.39,E-Com,Cupertino,US,2219,user_002,,
0fdae8bc-89fd-4d2f-a6db-e924ed22c89d,2031-05-21,2031-05-21,Shell,5541,Transport,Fuel,-72.81,GBP,-169510.2,POS,London,GB,9074,user_002,,
1e426066-0328-431e-85fc-60ee016443c6,2031-05-21,2031-05-23,Uber UK,4121,Transport,Ride Hailing,-18.5,GBP,-169528.7,E-Com,London,GB,9074,user_002,,
25463810-c6fe-4c90-abe2-37e7d829e142,2031-05-21,2031-05-21,HM Revenue & Customs,9311,Income,Tax Refund,4.91,GBP,-169523.79,Credit,London,GB,9074,user_001,,Refund for Local Market
5f0ae16a-2587-4268-a065-0c0dcef1e0e8,2031-05-21,2031-05-22,Netflix,7841,Entertainment,Subscriptions,-13.06,GBP,-169536.85,E-Com,Los Gatos,US,9074,user_002,rec_d9322c1382,
901b288a-29bb-48a7-9d5a-81e34f5e1008,2031-05-21,2031-05-23,Uber UK,4121,Transport,Ride Hailing,-30.33,GBP,-169567.18,E-Com,London,GB,1045,user_002,,
0424c634-df4f-45f0-8b7f-f6a6f7dac4b9,2031-05-23,2031-05-26,Amazon UK,5942,Shopping,Online Retail,-105.6,GBP,-169672.78,E-Com,London,GB,4488,user_001,,
7c01dac9-3ccb-4a7e-acaa-7dbe65404591,2031-05-23,2031-05-23,T212 Capital,6011,Income,Salary,3300.98,GBP,-166371.8,Credit,London,GB,2219,user_001,rec_2ff8f778d0,
a8e76c65-9e92-4a04-8340-fbc3390f6b78,2031-05-23,2031-05-26,Sainsbury's,5411,Groceries,Supermarket,-32.82,GBP,-166404.62,POS,London,GB,2219,user_002,,
096cffca-28ac-4cb5-bc21-aaa39f6e4222,2031-05-24,2031-05-26,Deliveroo,5812,Food & Drink,Delivery,-14.44,GBP,-166419.06,E-Com,London,GB,1045,user_001,,
0db3bea7-16cc-49fc-8f4c-04b4f00069a7,2031-05-24,2031-05-26,Uber UK,4121,Transport,Ride Hailing,-18.99,GBP,-166438.05,E-Com,London,GB,1045,user_001,,
5ff8ab6d-a4fb-437c-bbf3-10bd2545c393,2031-05-24,2031-05-26,Deliveroo,5812,Food & Drink,Delivery,-28.4,GBP,-166466.45,E-Com,London,GB,4488,user_001,,
b1d4d95b-5995-4cb4-8e5a-dc346cc46517,2031-05-24,2031-05-26,Local Market,5499,Groceries,Specialty,-17.33,GBP,-166483.78,POS,London,GB,4488,user_002,,
c078d0e7-d5a5-41f6-ab74-ce7368bdb6b4,2031-05-24,2031-05-26,Tesco,5411,Groceries,Supermarket,-78.2,GBP,-166561.98,POS,London,GB,2219,user_001,,
c0ea9866-412e-4a2c-aeb4-d0f6bf2295fe,2031-05-24,2031-05-26,Shell,5541,Transport,Fuel,-39.3,GBP,-166601.28,POS,London,GB,1045,user_002,,
037f5ad6-2e8a-4c14-b3bb-e577d7ab57cb,2031-05-25,2031-05-26,Waitrose,5411,Groceries,Supermarket,-27.81,GBP,-166629.09,POS,London,GB,4488,user_002,,
1bacd400-701b-43c0-8c41-c5e99ba9dd97,2031-05-26,2031-05-28,Amazon UK,5942,Shopping,Online Retail,-101.86,GBP,-166730.95,E-Com,London,GB,1045,user_002,,
d22d8b69-c88a-433f-adf7-a165b4573808,2031-05-26,2031-05-27,Amazon UK,5942,Shopping,Online Retail,-47.34,GBP,-166778.29,E-Com,London,GB,9074,user_002,,
eb30b0fb-9a11-4148-bea8-8af0154b2a5c,2031-05-26,2031-05-28,Uber UK,4121,Transport,Ride Hailing,-15.55,GBP,-166793.84,E-Com,London,GB,2219,user_001,,
79c632b9-9bec-4b33-ad01-70c3af0f2e5c,2031-05-27,2031-05-27,Pret A Manger,5814,Food & Drink,Eating Out,-11.23,GBP,-166805.07,POS,London,GB,2219,user_001,,
c972f317-065f-47b9-adb2-78537559ea00,2031-05-27,2031-05-28,Pret A Manger,5814,Food & Drink,Eating Out,-9.02,GBP,-166814.09,POS,London,GB,2219,user_001,,
f7bf8bc8-c65e-482a-802f-7b4ee5a9d066,2031-05-27,2031-05-28,Amazon UK,5942,Shopping,Online Retail,-40.19,GBP,-166854.28,E-Com,London,GB,4488,user_001,,
32675fd7-8e35-4495-aaa4-3133f34b4d20,2031-05-29,2031-05-29,Waitrose,5411,Groceries,Supermarket,-52.84,GBP,-166907.12,POS,London,GB,4488,user_001,,
7540ab5f-81ba-4a90-8229-fce3ba1dcff7,2031-05-29,2031-06-02,Sainsbury's,5411,Groceries,Supermarket,-51.94,GBP,-166959.06,POS,London,GB,4488,user_001,,
bc49c3bc-20a3-427d-b619-29c190d7f718,2031-05-29,2031-05-30,Shell,5541,Transport,Fuel,-67.72,GBP,-167026.78,POS,London,GB,2219,user_001,,
06fce152-cdfa-4c00-a589-f662dfa3678b,2031-05-30,2031-05-30,Uber UK,4121,Transport,Ride Hailing,-32.81,GBP,-167059.59,E-Com,London,GB,9074,user_001,,
c595f0ab-da95-4d21-93ad-00becda16ba7,2031-05-31,2031-06-02,Tesco,5411,Groceries,Supermarket,-61.81,GBP,-167121.4,POS,London,GB,4488,user_001,,
d4fcac78-5281-4872-b8a5-f06023cac92e,2031-05-31,2031-06-02,Waitrose,5411,Groceries,Supermarket,-53.2,GBP,-167174.6,POS,London,GB,9074,user_001,,
efcd6eb9-56ef-4126-b8ca-f7a96b477fda,2031-05-31,2031-06-02,Apple.com/bill,5734,Shopping,Electronics,-41.83,GBP,-167216.43,E-Com,Cupertino,US,2219,user_002,,
06e7a7ce-1511-453e-9214-68771f7f84b9,2031-06-01,2031-06-02,Waitrose,5411,Groceries,Supermarket,-24.57,GBP,-167241.0,POS,London,GB,1045,user_001,,
0ed70ce0-5da8-47fa-b060-07f2cd1b078f,2031-06-01,2031-06-02,Waitrose,5411,Groceries,Supermarket,-50.76,GBP,-167291.76,POS,London,GB,2219,user_001,,
4eed9d77-d59a-440e-9619-f14fd3023c56,2031-06-01,2031-06-03,Sainsbury's,5411,Groceries,Supermarket,-51.49,GBP,-167343.25,POS,London,GB,9074,user_001,,
6cb7a0c0-d312-4de7-9d53-8ff2b552d220,2031-06-01,2031-06-03,Deliveroo,5812,Food & Drink,Delivery,-24.42,GBP,-167367.67,E-Com,London,GB,4488,user_001,,
e055bce8-2cc3-4fa9-b729-e1b246a7a072,2031-06-01,2031-06-02,Uber UK,4121,Transport,Ride Hailing,-29.81,GBP,-167397.48,E-Com,London,GB,4488,user_002,,
423ac5e9-8305-4388-b052-992be1e534e1,2031-06-02,2031-06-02,Crown Estates Lettings,6513,Housing,Rent,-1457.44,GBP,-168854.92,POS,London,GB,1045,user_002,rec_fc2ae06846,
c6ae0ba3-a7f5-4292-9b64-2f37c7735ecf,2031-06-02,2031-06-02,ATM Withdrawal,6011,Cash,ATM,-65.85,GBP,-168920.77,ATM,London,GB,1045,user_001,,
2dc68563-61e4-4b1c-8199-9ec14d05083f,2031-06-03,2031-06-04,Apple.com/bill,5734,Shopping,Electronics,-186.08,GBP,-169106.85,E-Com,Cupertino,US,9074,user_001,,
bead9651-b75c-4326-af13-a9d8f2e7010c,2031-06-03,2031-06-05,Tesco,5411,Groceries,Supermarket,-60.94,GBP,-169167.79,POS,London,GB,9074,user_001,,
18595f9d-3b19-41a1-a181-4f03dfe73728,2031-06-04,2031-06-06,Pret A Manger,5814,Food & Drink,Eating Out,-11.04,GBP,-169178.83,POS,London,GB,2219,user_002,,
24c5dd4e-951c-4b70-b946-0b26c304b095,2031-06-04,2031-06-06,Pret A Manger,5814,Food & Drink,Eating Out,-7.59,GBP,-169186.42,POS,London,GB,9074,user_001,,
4f4c42ce-db3c-4125-9731-f9bde2243873,2031-06-05,2031-06-06,Uber UK,4121,Transport,Ride Hailing,-33.78,GBP,-169220.2,E-Com,London,GB,1045,user_001,,
946401b3-885a-4011-9c3a-9e4d5027043c,2031-06-05,2031-06-05,HM Revenue & Customs,9311,Income,Tax Refund,7.32,GBP,-169212.88,Credit,London,GB,2219,user_001,,Refund for Pret A Manger
95a631c4-2375-4f4e-9913-f04cffd517ad,2031-06-07,2031-06-09,Waitrose,5411,Groceries,Supermarket,-39.85,GBP,-169252.73,POS,London,GB,4488,user_001,,
a41bb118-76bf-4347-a6cb-c8b238fd9c09,2031-06-07,2031-06-09,Local Market,5499,Groceries,Specialty,-10.05,GBP,-169262.78,POS,London,GB,2219,user_001,,
a61d1676-0c1d-4d5f-9f8c-650253d3eb1b,2031-06-07,2031-06-09,ATM Withdrawal,6011,Cash,ATM,-111.16,GBP,-169373.94,ATM,London,GB,1045,user_001,,
09f0bd0c-b566-40b0-9a5f-0a27c7574475,2031-06-08,2031-06-10,Sainsbury's,5411,Groceries,Supermarket,-40.65,GBP,-169414.59,POS,London,GB,4488,user_001,,
37f80467-0daf-48a7-8bd8-07f3278e78cf,2031-06-08,2031-06-10,Local Market,5499,Groceries,Specialty,-19.41,GBP,-169434.0,POS,London,GB,4488,user_001,,
4332ddb2-8048-4fed-b8db-18cd47b93560,2031-06-08,2031-06-09,Uber UK,4121,Transport,Ride Hailing,-34.8,GBP,-169468.8,E-Com,London,GB,4488,user_001,,
f76aaf25-f759-4932-8b61-10ce8b6d745d,2031-06-08,2031-06-10,Shell,5541,Transport,Fuel,-78.98,GBP,-169547.78,POS,London,GB,9074,user_001,,
38a522bf-cdfc-4ccc-8cd3-6542fadf1caf,2031-06-09,2031-06-09,Uber UK,4121,Transport,Ride Hailing,-32.48,GBP,-169580.26,E-Com,London,GB,4488,user_001,,
6688cf22-6e21-4ddb-8421-3350e284dffc,2031-06-09,2031-06-09,Octopus Energy,4900,Utilities,Electricity,-117.62,GBP,-169697.88,Direct Debit,London,GB,9074,user_001,rec_141a4a0666,
f916addf-234a-4b3f-a07c-e3b9ae447ce7,2031-06-09,2031-06-09,Uber UK,4121,Transport,Ride Hailing,-13.38,GBP,-169711.26,E-Com,London,GB,9074,user_001,,
54bd0809-8c8d-4589-89bf-b52d240ede99,2031-06-10,2031-06-11,Local Market,5499,Groceries,Specialty,-6.69,GBP,-169717.95,POS,London,GB,2219,user_001,,
92068da5-0949-466a-bcaa-a4ca7259498c,2031-06-10,2031-06-10,Shell,5541,Transport,Fuel,-94.01,GBP,-169811.96,POS,London,GB,4488,user_001,,
a4084429-d67a-4ca5-b281-6160634ad1f9,2031-06-10,2031-06-10,Sainsbury's,5411,Groceries,Supermarket,-30.76,GBP,-169842.72,POS,London,GB,9074,user_001,,
d934455f-ab29-4f8b-b4ae-502f6e17e12f,2031-06-10,2031-06-11,Amazon UK,5942,Shopping,Online Retail,-94.19,GBP,-169936.91,E-Com,London,GB,1045,user_002,,
de82fea2-8f3a-4cb1-b7a4-630d788bb28e,2031-06-10,2031-06-11,Sainsbury's,5411,Groceries,Supermarket,-36.53,GBP,-169973.44,POS,London,GB,4488,user_001,,
242b9c2f-1a95-4b94-ac50-5a3782bd9841,2031-06-11,2031-06-13,Local Market,5499,Groceries,Specialty,-15.35,GBP,-169988.79,POS,London,GB,2219,user_001,,
60733082-8ebd-46b6-95a1-8621b296c022,2031-06-11,2031-06-12,Deliveroo,5812,Food & Drink,Delivery,-13.29,GBP,-170002.08,E-Com,London,GB,1045,user_002,,
74a061b2-929f-42f5-af11-87561fbaceec,2031-06-11,2031-06-12,Thames Water,4900,Utilities,Water,-39.98,GBP,-170042.06,Direct Debit,Reading,GB,1045,user_001,rec_3a34d62842,
89f2b755-12e0-46cc-a114-db697d22543e,2031-06-11,2031-06-13,Apple.com/bill,5734,Shopping,Electronics,-58.95,GBP,-170101.01,E-Com,Cupertino,US,9074,user_001,,
cdf2d835-1aab-4c06-ac2c-51943a23cb69,2031-06-11,2031-06-11,Waitrose,5411,Groceries,Supermarket,-58.31,GBP,-170159.32,POS,London,GB,1045,user_001,,
2a495239-9a4e-487d-9082-869b1a3670f3,2031-06-12,2031-06-16,Tesco,5411,Groceries,Supermarket,-39.7,GBP,-170199.02,POS,London,GB,4488,user_001,,
2d9c854e-89e2-4fb1-b308-a925db308bb7,2031-06-12,2031-06-13,Pret A Manger,5814,Food & Drink,Eating Out,-8.3,GBP,-170207.32,POS,London,GB,1045,user_002,,
d9d13f07-bcb6-40e7-98f2-8c646e4a97d4,2031-06-12,2031-06-13,Uber UK,4121,Transport,Ride Hailing,-29.7,GBP,-170237.02,E-Com,London,GB,2219,user_002,,
277badb7-d13a-4e3f-aaa9-c81153ab3d92,2031-06-13,2031-06-16,Sainsbury's,5411,Groceries,Supermarket,-67.92,GBP,-170304.94,POS,London,GB,2219,user_001,,
3f0d7adf-4f0a-4376-818f-aaf303e342bf,2031-06-13,2031-06-13,Shell,5541,Transport,Fuel,-73.59,GBP,-170378.53,POS,London,GB,9074,user_001,,
7bf6d85b-5d9c-4c83-9313-f2edb35abb73,2031-06-13,2031-06-16,Sainsbury's,5411,Groceries,Supermarket,-24.04,GBP,-170402.57,POS,London,GB,4488,user_001,,
c7d91c11-b06f-4747-8a34-ff3ddd52a215,2031-06-13,2031-06-13,City Council Tax,9399,Utilities,Council Tax,-150.39,GBP,-170552.96,Direct Debit,London,GB,4488,user_001,rec_f531495db5,
746612c5-2500-47ec-b991-ba5bd55712ed,2031-06-14,2031-06-16,Apple.com/bill,5734,Shopping,Electronics,-41.05,GBP,-170594.01,E-Com,Cupertino,US,4488,user_002,,
83e46a57-cbd2-4176-a63d-a9cf8e9b8c26,2031-06-14,2031-06-16,Amazon UK,5942,Shopping,Online Retail,-16.65,GBP,-170610.66,E-Com,London,GB,1045,user_001,,
2b31099c-b910-4e18-9f8a-4f75d4e2c405,2031-06-15,2031-06-16,Amazon UK,5942,Shopping,Online Retail,-41.77,GBP,-170652.43,E-Com,London,GB,2219,user_001,,
5153b41c-a938-4bd0-915b-d4e138c26800,2031-06-15,2031-06-16,Transport for London,4111,Transport,Transit,-9.57,GBP,-170662.0,POS,London,GB,1045,user_001,,
b17915eb-ec0e-4b0a-965b-c1d1db80a08b,2031-06-15,2031-06-16,Waitrose,5411,Groceries,Supermarket,-48.45,GBP,-170710.45,POS,London,GB,2219,user_001,,
dd882879-605c-43ef-9480-ec8f6732be6d,2031-06-15,2031-06-16,Shell,5541,Transport,Fuel,-55.04,GBP,-170765.49,POS,London,GB,4488,user_001,,
33f87295-13a6-4513-96d2-b30bfa478be1,2031-06-16,2031-06-18,O2 UK,4814,Bills,Mobile,-42.7,GBP,-170808.19,Direct Debit,Slough,GB,1045,user_002,rec_d2dce4c42f,
52e13909-87d3-46fd-b45a-a62396711246,2031-06-16,2031-06-18,Shell,5541,Transport,Fuel,-70.66,GBP,-170878.85,POS,London,GB,4488,user_001,,
7093e4e3-2704-4bc4-a738-a50804221192,2031-06-16,2031-06-17,Pret A Manger,5814,Food & Drink,Eating Out,-10.36,GBP,-170889.21,POS,London,GB,9074,user_001,,
71f87dc3-343f-4e82-b27d-664b6c5350f3,2031-06-16,2031-06-16,HM Revenue & Customs,9311,Income,Tax Refund,37.46,GBP,-170851.75,Credit,London,GB,4488,user_001,,Refund for Waitrose
8e6483e9-7d36-4cdd-b757-d3068c239d66,2031-06-16,2031-06-16,Pret A Manger,5814,Food & Drink,Eating Out,-7.42,GBP,-170859.17,POS,London,GB,4488,user_002,,
962ea003-757e-44a0-b841-d24f86b72c12,2031-06-16,2031-06-17,Tesco,5411,Groceries,Supermarket,-26.11,GBP,-170885.28,POS,London,GB,4488,user_001,,
caf88416-651c-4bb0-8865-1a3bebdc9c44,2031-06-16,2031-06-16,Uber UK,4121,Transport,Ride Hailing,-30.14,GBP,-170915.42,E-Com,London,GB,9074,user_001,,
0361e9f2-f1dd-475a-8a2d-c9cc664e2f71,2031-06-17,2031-06-18,Transport for London,4111,Transport,Transit,-7.07,GBP,-170922.49,POS,London,GB,9074,user_001,,
13f14159-a71c-4d9a-afba-106d4d056fe7,2031-06-17,2031-06-19,GymBox,7997,Wellness,Gym,-51.87,GBP,-170974.36,Direct Debit,London,GB,2219,user_002,rec_19771e79cd,
e21f3815-6172-4b8d-9dae-4a3ee120a9a2,2031-06-17,2031-06-17,Shell,5541,Transport,Fuel,-44.43,GBP,-171018.79,POS,London,GB,2219,user_001,,
e569b31e-0a1c-4ff7-8c4d-55497cb8df63,2031-06-17,2031-06-18,Tesco,5411,Groceries,Supermarket,-60.14,GBP,-171078.93,POS,London,GB,2219,user_001,,
af33b80c-b4dc-4ee4-a34e-f16219849f47,2031-06-18,2031-06-19,Amazon UK,5942,Shopping,Online Retail,-90.43,GBP,-171169.36,E-Com,London,GB,1045,user_001,,
233e0c98-cc26-40d7-bf86-ea1c261b1b21,2031-06-19,2031-06-19,Spotify,5735,Entertainment,Subscriptions,-8.94,EUR,-171178.3,E-Com,Stockholm,SE,2219,user_001,rec_4c746d2c3b,FX purchase 10.17 EUR @ rate 1.14
ef2a1a7b-a7ad-44d4-a64d-f6ae38ba71e5,2031-06-19,2031-06-20,ATM Withdrawal,6011,Cash,ATM,-93.78,GBP,-171272.08,ATM,London,GB,1045,user_001,,
031b189f-5884-493f-b2b1-0c0705dc0466,2031-06-20,2031-06-23,Amazon UK,5942,Shopping,Online Retail,-75.59,GBP,-171347.67,E-Com,London,GB,2219,user_001,,
0b8e3294-70c1-4b68-bb51-6844ea5f9ede,2031-06-20,2031-06-23,Apple.com/bill,5734,Shopping,Electronics,-11.17,GBP,-171358.84,E-Com,Cupertino,US,4488,user_001,,
604dc1cb-21ba-4769-976b-153dc3ff1ed6,2031-06-20,2031-06-23,Sainsbury's,5411,Groceries,Supermarket,-47.97,GBP,-171406.81,POS,London,GB,1045,user_001,,
b16a7ca4-544d-40d3-81ac-fdf6576669a4,2031-06-20,2031-06-20,Shell,5541,Transport,Fuel,-64.34,GBP,-171471.15,POS,London,GB,1045,user_001,,
cd81e7f0-cdfc-4bb2-ac4c-67bd3937003e,2031-06-20,2031-06-20,Deliveroo,5812,Food & Drink,Delivery,-24.93,GBP,-171496.08,E-Com,London,GB,9074,user_001,,
cc14dea1-2a3a-4412-b57e-bf6cc76ae7c7,2031-06-21,2031-06-23,Waitrose,5411,Groceries,Supermarket,-29.84,GBP,-171525.92,POS,London,GB,4488,user_001,,
25f47fce-6da4-4c7c-b927-e41a875ef4f4,2031-06-22,2031-06-23,Amazon UK,5942,Shopping,Online Retail,-66.11,GBP,-171592.03,E-Com,London,GB,4488,user_002,,
4a821ee7-95dc-4694-a4c7-d1951329ae7b,2031-06-22,2031-06-23,Pret A Manger,5814,Food & Drink,Eating Out,-11.21,GBP,-171603.24,POS,London,GB,2219,user_001,,
c6b75b45-0b08-4490-b606-48dc5460be19,2031-06-22,2031-06-23,Shell,5541,Transport,Fuel,-43.57,GBP,-171646.81,POS,London,GB,9074,user_001,,
2a7c5e1f-4d76-4564-b9d6-2f577354f89b,2031-06-23,2031-06-23,Netflix,7841,Entertainment,Subscriptions,-10.09,USD,-171656.9,E-Com,Los Gatos,US,9074,user_001,rec_1bfe33738d,FX purchase 12.76 USD @ rate 1.26
802593ee-6c01-4971-b6b1-624069e15d98,2031-06-23,2031-06-25,Deliveroo,5812,Food & Drink,Delivery,-24.49,GBP,-171681.39,E-Com,London,GB,2219,user_001,,
5dfe602a-2f83-4f86-906d-14d4d2f4a094,2031-06-24,2031-06-24,Pret A Manger,5814,Food & Drink,Eating Out,-10.31,GBP,-171691.7,POS,London,GB,4488,user_001,,
5f2fef8c-3752-4661-9729-a8ac2ec5b321,2031-06-24,2031-06-26,Pret A Manger,5814,Food & Drink,Eating Out,-7.94,GBP,-171699.64,POS,London,GB,9074,user_002,,
fa30478f-04b6-4285-8064-2a7730d81d65,2031-06-24,2031-06-25,Local Market,5499,Groceries,Specialty,-9.95,GBP,-171709.59,POS,London,GB,1045,user_001,,
029d041b-24a8-463e-86f5-75554a4463c8,2031-06-25,2031-06-27,Deliveroo,5812,Food & Drink,Delivery,-27.43,GBP,-171737.02,E-Com,London,GB,2219,user_001,,
03761866-0af2-4d2e-a0d2-9d9a86a6e6bb,2031-06-25,2031-06-27,Tesco,5411,Groceries,Supermarket,-65.07,GBP,-171802.09,POS,London,GB,1045,user_001,,
05bbd237-0ead-46ea-b19e-19067cf35691,2031-06-25,2031-06-25,T212 Capital,6011,Income,Salary,2856.31,GBP,-168945.78,Credit,London,GB,9074,user_001,rec_2ff8f778d0,
91b51f3a-038d-40e0-b3b9-d306cdee6811,2031-06-25,2031-06-26,Waitrose,5411,Groceries,Supermarket,-32.78,GBP,-168978.56,POS,London,GB,9074,user_001,,
35896b52-ac80-486e-8d95-23371305fca2,2031-06-26,2031-06-30,Deliveroo,5812,Food & Drink,Delivery,-32.44,GBP,-169011.0,E-Com,London,GB,4488,user_001,,
aefd89ca-449b-4870-8ec2-56f8a189c00f,2031-06-26,2031-06-30,Deliveroo,5812,Food & Drink,Delivery,-20.53,GBP,-169031.53,E-Com,London,GB,4488,user_001,,
7cbf320d-e0d3-4d33-be68-cb51afdd7208,2031-06-27,2031-06-27,Deliveroo,5812,Food & Drink,Delivery,-30.08,GBP,-169061.61,E-Com,London,GB,9074,user_001,,
0efe7a14-d66a-4984-a292-8cc2498a574f,2031-06-28,2031-06-30,Airline Refund,4511,Travel,Refund,75.96,GBP,-168985.65,Credit,London,GB,2219,user_001,,Refund for Shell
4ee8f741-21dc-489d-bcd6-c5a4043e6e86,2031-06-28,2031-06-30,Sainsbury's,5411,Groceries,Supermarket,-39.46,GBP,-169025.11,POS,London,GB,4488,user_001,,
5fb10e15-b8d5-469e-8b30-70d3f674c8e3,2031-06-28,2031-06-30,Transport for London,4111,Transport,Transit,-11.48,GBP,-169036.59,POS,London,GB,9074,user_001,,
a5c939af-c316-4fbf-99e9-087037f3bd97,2031-06-28,2031-06-30,Transport for London,4111,Transport,Transit,-10.56,GBP,-169047.15,POS,London,GB,2219,user_001,,
beaa6142-90af-4975-80f3-02aa120b3836,2031-06-28,2031-06-30,Amazon UK,5942,Shopping,Online Retail,-35.95,GBP,-169083.1,E-Com,London,GB,1045,user_001,,
51f2a9cd-a2a4-4c40-8bfd-bf6d604eb96e,2031-06-29,2031-06-30,Sainsbury's,5411,Groceries,Supermarket,-48.58,GBP,-169131.68,POS,London,GB,2219,user_001,,
cd8ee302-ffa6-4ca3-b54c-b5562e33d574,2031-06-29,2031-06-30,Transport for London,4111,Transport,Transit,-6.59,GBP,-169138.27,POS,London,GB,2219,user_002,,
d2fe0f7e-6e19-4afa-8b6c-c80e29690e49,2031-06-29,2031-06-30,Amazon UK,5942,Shopping,Online Retail,-37.49,GBP,-169175.76,E-Com,London,GB,2219,user_001,,
f999296c-0c21-4964-9528-ec6e0c50354a,2031-06-29,2031-06-30,Deliveroo,5812,Food & Drink,Delivery,-17.91,GBP,-169193.67,E-Com,London,GB,1045,user_001,,
2eccf75b-607a-4024-91b8-0bbbe88e46b6,2031-07-01,2031-07-01,Crown Estates Lettings,6513,Housing,Rent,-1516.45,GBP,-170710.12,POS,London,GB,2219,user_001,rec_19f70fbcce,
4eb690e7-8c2b-4a02-9c76-a85fdb435a0c,2031-07-01,2031-07-03,Sainsbury's,5411,Groceries,Supermarket,-64.83,GBP,-170774.95,POS,London,GB,4488,user_001,,
1fe01de2-d035-467b-b0b0-19f2b3b635ca,2031-07-02,2031-07-04,Pret A Manger,5814,Food & Drink,Eating Out,-8.31,GBP,-170783.26,POS,London,GB,9074,user_001,,
46bd5271-2bb5-44fc-a3a5-b393cc0b3064,2031-07-02,2031-07-03,Uber UK,4121,Transport,Ride Hailing,-35.68,GBP,-170818.94,E-Com,London,GB,2219,user_002,,
472db227-de4f-43f2-9640-b0df5740bbf9,2031-07-04,2031-07-04,Apple.com/bill,5734,Shopping,Electronics,-27.36,USD,-170846.3,E-Com,Cupertino,US,9074,user_001,,FX purchase 33.86 USD @ rate 1.24
4d7466ea-2e56-481d-ae32-79fe149c62f4,2031-07-04,2031-07-04,Shell,5541,Transport,Fuel,-92.54,GBP,-170938.84,POS,London,GB,4488,user_001,,
3ff24480-48b6-409b-a2e9-ccfc891b5e5d,2031-07-05,2031-07-07,Transport for London,4111,Transport,Transit,-9.13,GBP,-170947.97,POS,London,GB,2219,user_001,,
4787d997-e97c-4d1d-ae99-e4dc42f37075,2031-07-05,2031-07-07,Shell,5541,Transport,Fuel,-48.14,GBP,-170996.11,POS,London,GB,1045,user_001,,
a904a18e-1ad4-4696-8c6a-ac72d3db7f9b,2031-07-05,2031-07-07,Shell,5541,Transport,Fuel,-79.52,GBP,-171075.63,POS,London,GB,9074,user_001,,
b5734f14-6a66-43f5-a22b-394151f87eba,2031-07-05,2031-07-07,Deliveroo,5812,Food & Drink,Delivery,-21.33,GBP,-171096.96,E-Com,London,GB,1045,user_001,,
a1af97d7-f8d0-46f7-91e5-3d0c9e36c4f6,2031-07-06,2031-07-08,Tesco,5411,Groceries,Supermarket,-56.3,GBP,-171153.26,POS,London,GB,4488,user_001,,
5eb08049-c2a5-4f00-9f80-cb0750085e19,2031-07-07,2031-07-08,Waitrose,5411,Groceries,Supermarket,-23.64,GBP,-171176.9,POS,London,GB,9074,user_001,,
697dda44-650d-4ee3-ab6c-0878dfd16f2d,2031-07-07,2031-07-08,Octopus Energy,4900,Utilities,Electricity,-139.62,GBP,-171316.52,Direct Debit,London,GB,4488,user_001,rec_141a4a0666,
11465d46-2d34-47cd-a44a-1751328a5f32,2031-07-08,2031-07-10,Deliveroo,5812,Food & Drink,Delivery,-13.85,GBP,-171330.37,E-Com,London,GB,2219,user_001,,
1d13324e-e9da-47ef-849d-a9008c056cd3,2031-07-09,2031-07-11,Apple.com/bill,5734,Shopping,Electronics,-134.55,USD,-171464.92,E-Com,Cupertino,US,1045,user_002,,FX purchase 168.46 USD @ rate 1.25
9df75c36-6677-4a3a-98f9-9734f66f8b43,2031-07-09,2031-07-09,Sainsbury's,5411,Groceries,Supermarket,-33.74,GBP,-171498.66,POS,London,GB,2219,user_001,,
058909b9-1794-48cc-9287-bdcd352c6127,2031-07-10,2031-07-11,Waitrose,5411,Groceries,Supermarket,-26.06,GBP,-171524.72,POS,London,GB,1045,user_001,,
c14646e2-27e6-45fb-83c4-f8f5d1c49e01,2031-07-10,2031-07-14,Tesco,5411,Groceries,Supermarket,-29.07,GBP,-171553.79,POS,London,GB,1045,user_001,,
c76f3c82-d978-4685-9dff-3c1ca8e16cbb,2031-07-10,2031-07-11,Deliveroo,5812,Food & Drink,Delivery,-31.46,GBP,-171585.25,E-Com,London,GB,4488,user_001,,
5e9fb4e5-7fa8-4ebe-9237-4f1177312911,2031-07-11,2031-07-11,Apple.com/bill,5734,Shopping,Electronics,-178.37,GBP,-171763.62,E-Com,Cupertino,US,9074,user_001,,
bb6a3811-8382-4b02-b686-c6fae055325f,2031-07-11,2031-07-14,Thames Water,4900,Utilities,Water,-33.19,GBP,-171796.81,Direct Debit,Reading,GB,4488,user_001,rec_3a34d62842,
34b90486-9a38-42a7-b3e6-49ba6dd183ba,2031-07-12,2031-07-14,Sainsbury's,5411,Groceries,Supermarket,-62.8,GBP,-171859.61,POS,London,GB,9074,user_002,,
93376b9b-6bbb-40be-b319-86afdb5e2f2e,2031-07-12,2031-07-14,Tesco,5411,Groceries,Supermarket,-75.51,GBP,-171935.12,POS,London,GB,1045,user_001,,
9b2a64a5-e9d3-44ca-9317-7116b3655478,2031-07-12,2031-07-14,Amazon UK,5942,Shopping,Online Retail,-106.98,GBP,-172042.1,E-Com,London,GB,9074,user_001,,
bfe12a81-3819-4c7a-9254-705dde101b59,2031-07-12,2031-07-14,Amazon UK,5942,Shopping,Online Retail,-72.77,GBP,-172114.87,E-Com,London,GB,4488,user_001,,
e8a063ee-fc43-49e9-913b-1d3eb7990a9a,2031-07-12,2031-07-14,Local Market,5499,Groceries,Specialty,-6.5,GBP,-172121.37,POS,London,GB,2219,user_001,,
29fd8cbb-4ba5-4d56-b3d7-e3c47663eb7a,2031-07-13,2031-07-14,Uber UK,4121,Transport,Ride Hailing,-20.5,GBP,-172141.87,E-Com,London,GB,4488,user_001,,
88dcc3f5-c4bb-46bf-a49e-28da099242c2,2031-07-13,2031-07-14,Apple.com/bill,5734,Shopping,Electronics,-154.43,GBP,-172296.3,E-Com,Cupertino,US,2219,user_001,,
a6266d87-a18e-4cb9-a373-c474b75243f7,2031-07-13,2031-07-14,Tesco,5411,Groceries,Supermarket,-46.47,GBP,-172342.77,POS,London,GB,9074,user_002,,
dc086a25-fb87-4074-bf19-bf22b31eb8ae,2031-07-13,2031-07-14,Local Market,5499,Groceries,Specialty,-11.86,GBP,-172354.63,POS,London,GB,4488,user_001,,
e22ac667-6d41-4948-88c4-7b030e7873e8,2031-07-13,2031-07-15,Shell,5541,Transport,Fuel,-65.19,GBP,-172419.82,POS,London,GB,9074,user_001,,
3d17df2a-6290-4227-8bab-dc21a3dacc88,2031-07-14,2031-07-15,Pret A Manger,5814,Food & Drink,Eating Out,-10.01,GBP,-172429.83,POS,London,GB,9074,user_001,,
6969e30c-cc4e-4036-b7f1-cd59db2d5b43,2031-07-14,2031-07-16,City Council Tax,9399,Utilities,Council Tax,-155.65,GBP,-172585.48,Direct Debit,London,GB,4488,user_001,rec_f531495db5,
6f3466e1-effe-4592-932b-73dca8553494,2031-07-14,2031-07-16,Apple.com/bill,5734,Shopping,Electronics,-44.9,USD,-172630.38,E-Com,Cupertino,US,2219,user_001,,FX purchase 55.47 USD @ rate 1.24
cfcbd04f-a7e0-45b6-86ba-a0cb67d46d72,2031-07-14,2031-07-16,Deliveroo,5812,Food & Drink,Delivery,-23.49,GBP,-172653.87,E-Com,London,GB,9074,user_002,,
670a7620-3510-4f00-8d34-a86915cc816c,2031-07-15,2031-07-17,O2 UK,4814,Bills,Mobile,-35.08,GBP,-172688.95,Direct Debit,Slough,GB,1045,user_001,rec_95042d8101,
a9b5cea7-ac2d-422c-a8bd-32cf5f1ee4c2,2031-07-15,2031-07-15,Waitrose,5411,Groceries,Supermarket,-78.0,GBP,-172766.95,POS,London,GB,1045,user_002,,
2c250277-ae5e-487e-b209-28b81bb21191,2031-07-16,2031-07-18,Deliveroo,5812,Food & Drink,Delivery,-12.73,GBP,-172779.68,E-Com,London,GB,1045,user_001,,
a8af8b50-4e2e-4353-af84-a4b00de0d23e,2031-07-16,2031-07-16,Shell,5541,Transport,Fuel,-80.59,GBP,-172860.27,POS,London,GB,2219,user_001,,
6a234729-2855-4a64-ad5f-f5af78d369c6,2031-07-17,2031-07-17,Tesco,5411,Groceries,Supermarket,-68.75,GBP,-172929.02,POS,London,GB,4488,user_001,,
822c43d2-a669-4182-90f3-6c42b50b3b0e,2031-07-17,2031-07-17,GymBox,7997,Wellness,Gym,-48.14,GBP,-172977.16,Direct Debit,London,GB,4488,user_001,rec_3906953fd2,
8d8ab8fc-d817-414c-bd46-6567fcc1dbbd,2031-07-17,2031-07-21,Tesco,5411,Groceries,Supermarket,-25.9,GBP,-173003.06,POS,London,GB,1045,user_001,,
7937bf5e-2513-4967-850c-f26bc7e14537,2031-07-18,2031-07-18,HM Revenue & Customs,9311,Income,Tax Refund,23.99,GBP,-172979.07,Credit,London,GB,4488,user_001,,Refund for Tesco
eb6d839f-650f-4426-88ba-c2e07f690355,2031-07-18,2031-07-21,Sainsbury's,5411,Groceries,Supermarket,-21.36,GBP,-173000.43,POS,London,GB,1045,user_001,,
f2954a6f-d6c2-4493-a6e9-2e90fe32ab45,2031-07-18,2031-07-18,Transport for London,4111,Transport,Transit,-3.65,GBP,-173004.08,POS,London,GB,4488,user_002,,
9236118a-27ff-47e0-90e1-56e6347a845e,2031-07-19,2031-07-21,Sainsbury's,5411,Groceries,Supermarket,-17.25,GBP,-173021.33,POS,London,GB,2219,user_001,,
963c54e5-b88c-4331-8c5b-19bd47cafd60,2031-07-19,2031-07-21,Shell,5541,Transport,Fuel,-46.54,GBP,-173067.87,POS,London,GB,1045,user_001,,
973a5e3d-500d-43ec-a89a-623a9eb646aa,2031-07-19,2031-07-21,Shell,5541,Transport,Fuel,-78.09,GBP,-173145.96,POS,London,GB,1045,user_001,,
1f01b143-4cde-4e75-b8c1-e18f6344b2b8,2031-07-20,2031-07-21,Amazon UK,5942,Shopping,Online Retail,-113.78,GBP,-173259.74,E-Com,London,GB,9074,user_001,,
58b73bc1-e37b-4215-9d1c-c329f661e2bf,2031-07-20,2031-07-21,Transport for London,4111,Transport,Transit,-3.69,GBP,-173263.43,POS,London,GB,9074,user_002,,
6cc02368-e156-4525-a6dc-7ef79df6eed6,2031-07-20,2031-07-21,Local Market,5499,Groceries,Specialty,-7.74,GBP,-173271.17,POS,London,GB,1045,user_001,,
9b9c08a0-9d11-4d8f-93ea-90728fc83782,2031-07-20,2031-07-22,Shell,5541,Transport,Fuel,-77.82,GBP,-173348.99,POS,London,GB,1045,user_001,,
d80cf377-8f36-4d58-bc8f-348196c7abfa,2031-07-20,2031-07-22,Amazon UK,5942,Shopping,Online Retail,-44.02,GBP,-173393.01,E-Com,London,GB,4488,user_002,,
f0163755-6d53-4ee9-94c2-5bc99d769df6,2031-07-20,2031-07-21,Amazon UK,5942,Shopping,Online Retail,-72.65,GBP,-173465.66,E-Com,London,GB,1045,user_001,,
0fcf87d8-ae12-40d3-8470-a34a35345cb6,2031-07-21,2031-07-21,Netflix,7841,Entertainment,Subscriptions,-12.23,GBP,-173477.89,E-Com,Los Gatos,US,4488,user_001,rec_1bfe33738d,
11b6ea6a-0ce1-4687-b0bc-961136004c8a,2031-07-21,2031-07-22,Spotify,5735,Entertainment,Subscriptions,-9.63,EUR,-173487.52,E-Com,Stockholm,SE,9074,user_001,rec_4c746d2c3b,FX purchase 11.22 EUR @ rate 1.16
8730b7bf-6cff-40be-bde0-1fe079f140e6,2031-07-21,2031-07-23,Shell,5541,Transport,Fuel,-41.03,GBP,-173528.55,POS,London,GB,2219,user_001,,
08decac4-e4a7-4b00-b8a9-cbec71f09230,2031-07-22,2031-07-22,Tesco,5411,Groceries,Supermarket,-49.63,GBP,-173578.18,POS,London,GB,2219,user_002,,
a5ca717f-0ef5-47b4-941f-b3c15e05c0fc,2031-07-22,2031-07-24,Deliveroo,5812,Food & Drink,Delivery,-33.78,GBP,-173611.96,E-Com,London,GB,4488,user_001,,
f9404811-9811-40bd-b570-8e97f172354c,2031-07-22,2031-07-23,Shell,5541,Transport,Fuel,-49.86,GBP,-173661.82,POS,London,GB,9074,user_001,,
49aea5a9-2442-44b8-96f0-2435833cf078,2031-07-23,2031-07-25,Deliveroo,5812,Food & Drink,Delivery,-30.9,GBP,-173692.72,E-Com,London,GB,4488,user_001,,
8e7a270c-ef38-46f4-8838-213e0431bb91,2031-07-23,2031-07-24,Uber UK,4121,Transport,Ride Hailing,-10.08,GBP,-173702.8,E-Com,London,GB,1045,user_001,,
0a805fa8-38c2-4fde-a775-53ce666be8fd,2031-07-24,2031-07-24,Deliveroo,5812,Food & Drink,Delivery,-32.19,GBP,-173734.99,E-Com,London,GB,2219,user_001,,
b0ceb53d-8fc0-4c2c-bbc2-f0b8acc6a3cd,2031-07-24,2031-07-28,Pret A Manger,5814,Food & Drink,Eating Out,-7.66,GBP,-173742.65,POS,London,GB,1045,user_002,,
44980708-b134-4949-900c-d7dcf3a1a521,2031-07-25,2031-07-25,Pret A Manger,5814,Food & Drink,Eating Out,-8.19,GBP,-173750.84,POS,London,GB,9074,user_001,,
879bf065-c63d-4122-9de8-f9ae640d260c,2031-07-25,2031-07-25,T212 Capital,6011,Income,Salary,2942.28,GBP,-170808.56,Credit,London,GB,1045,user_001,rec_2ff8f778d0,
78f2e9cd-e47a-447c-ba8e-7e2bc39ccbb0,2031-07-26,2031-07-28,Sainsbury's,5411,Groceries,Supermarket,-15.61,GBP,-170824.17,POS,London,GB,9074,user_001,,
cd06f0f1-3625-4b2b-a634-3dbda50e96f0,2031-07-26,2031-07-28,Uber UK,4121,Transport,Ride Hailing,-24.68,GBP,-170848.85,E-Com,London,GB,2219,user_001,,
bf7b57dc-3d4d-4f18-82bb-6c2a0c04fdc6,2031-07-27,2031-07-29,Deliveroo,5812,Food & Drink,Delivery,-32.85,GBP,-170881.7,E-Com,London,GB,2219,user_002,,
1297813b-3d41-413a-90bb-f5bfe001e2af,2031-07-28,2031-07-28,Apple.com/bill,5734,Shopping,Electronics,-155.54,GBP,-171037.24,E-Com,Cupertino,US,4488,user_001,,
606330af-dbac-4046-adab-4814608ac956,2031-07-28,2031-07-28,Waitrose,5411,Groceries,Supermarket,-82.0,GBP,-171119.24,POS,London,GB,4488,user_001,,
7c1e048b-45f0-42b9-ae5b-d87ef9a4330b,2031-07-28,2031-07-29,Apple.com/bill,5734,Shopping,Electronics,-185.64,GBP,-171304.88,E-Com,Cupertino,US,2219,user_002,,
06227ad7-f898-42b9-a7e1-b741187741b6,2031-07-29,2031-07-30,Apple.com/bill,5734,Shopping,Electronics,-167.51,USD,-171472.39,E-Com,Cupertino,US,4488,user_002,,FX purchase 213.49 USD @ rate 1.27
19940edf-8736-47f2-8640-5c8f972c7814,2031-07-29,2031-07-29,Transport for London,4111,Transport,Transit,-3.5,GBP,-171475.89,POS,London,GB,1045,user_002,,
106ff0ff-9341-4145-92a3-ebc98bb38100,2031-07-30,2031-07-30,Shell,5541,Transport,Fuel,-48.22,GBP,-171524.11,POS,London,GB,2219,user_002,,
3ec85eb6-87d6-4c5e-95b3-b544d55ef30d,2031-07-30,2031-08-01,Sainsbury's,5411,Groceries,Supermarket,-28.5,GBP,-171552.61,POS,London,GB,2219,user_001,,
69e7efc6-c6bd-43db-a9bd-e1b221fd0637,2031-07-30,2031-07-30,Transport for London,4111,Transport,Transit,-6.94,GBP,-171559.55,POS,London,GB,9074,user_002,,
dbb66aa5-2c52-4d01-83d1-e4a21ac2419e,2031-07-30,2031-07-30,Apple.com/bill,5734,Shopping,Electronics,-24.94,USD,-171584.49,E-Com,Cupertino,US,4488,user_001,,FX purchase 30.65 USD @ rate 1.23
f8a04aed-c477-438c-8c2b-71f1e6a2f864,2031-07-30,2031-08-01,Pret A Manger,5814,Food & Drink,Eating Out,-5.86,GBP,-171590.35,POS,London,GB,4488,user_001,,
2aba9cda-2d00-47dd-9551-dca60575c5c6,2031-07-31,2031-08-01,Waitrose,5411,Groceries,Supermarket,-88.96,GBP,-171679.31,POS,London,GB,2219,user_001,,
a004dbc2-7d72-4d58-9a60-73abd39f97be,2031-07-31,2031-07-31,Deliveroo,5812,Food & Drink,Delivery,-12.41,GBP,-171691.72,E-Com,London,GB,2219,user_001,,
a157e285-6320-4784-822e-a69318adba67,2031-07-31,2031-08-01,Tesco,5411,Groceries,Supermarket,-70.8,GBP,-171762.52,POS,London,GB,1045,user_001,,
a212e092-a18b-41c8-b9f5-82a646e7baa6,2031-07-31,2031-08-01,Deliveroo,5812,Food & Drink,Delivery,-31.4,GBP,-171793.92,E-Com,London,GB,2219,user_002,,
05a924a2-71bf-4106-8dc3-425006092efd,2031-08-01,2031-08-01,Uber UK,4121,Transport,Ride Hailing,-33.85,GBP,-171827.77,E-Com,London,GB,9074,user_001,,
622d6bc0-2c81-4cad-ab71-03a90e7fc7fc,2031-08-01,2031-08-04,Local Market,5499,Groceries,Specialty,-15.5,GBP,-171843.27,POS,London,GB,4488,user_002,,
752956b7-6432-4590-9e85-59f353924025,2031-08-01,2031-08-01,Crown Estates Lettings,6513,Housing,Rent,-1573.84,GBP,-173417.11,POS,London,GB,9074,user_002,rec_fc2ae06846,
77f40eed-929f-46ab-971f-1b73a8bd1a54,2031-08-01,2031-08-04,Amazon UK,5942,Shopping,Online Retail,-24.77,GBP,-173441.88,E-Com,London,GB,9074,user_001,,
a7f10013-2294-4aa3-b247-fa056581e4df,2031-08-01,2031-08-04,Sainsbury's,5411,Groceries,Supermarket,-38.75,GBP,-173480.63,POS,London,GB,2219,user_001,,
e0afe589-da80-4c04-af01-25bb510fc911,2031-08-01,2031-08-01,Sainsbury's,5411,Groceries,Supermarket,-37.98,GBP,-173518.61,POS,London,GB,2219,user_001,,
31ae006b-7ba6-455d-8818-0115a672bd9b,2031-08-02,2031-08-04,Apple.com/bill,5734,Shopping,Electronics,-202.47,USD,-173721.08,E-Com,Cupertino,US,1045,user_001,,FX purchase 250.51 USD @ rate 1.24
ae057cc3-fc31-46c5-8af1-f574a9b9400a,2031-08-02,2031-08-04,Transport for London,4111,Transport,Transit,-11.35,GBP,-173732.43,POS,London,GB,9074,user_002,,
b04c4751-4430-4c4c-abef-44136587aa65,2031-08-02,2031-08-04,Shell,5541,Transport,Fuel,-70.56,GBP,-173802.99,POS,London,GB,9074,user_002,,
1bf78192-7dfc-4353-adb8-13c5d81b7463,2031-08-03,2031-08-05,Apple.com/bill,5734,Shopping,Electronics,-200.7,USD,-174003.69,E-Com,Cupertino,US,2219,user_001,,FX purchase 247.6 USD @ rate 1.23
865e7015-c218-4064-bb1b-51b3a27c5cc0,2031-08-03,2031-08-05,Apple.com/bill,5734,Shopping,Electronics,-28.2,GBP,-174031.89,E-Com,Cupertino,US,4488,user_001,,
8e72f94e-a0f3-4ed2-9118-7cec82952545,2031-08-03,2031-08-04,Uber UK,4121,Transport,Ride Hailing,-27.56,GBP,-174059.45,E-Com,London,GB,1045,user_002,,
d7eda8e8-ab3d-4f19-87af-b6268aa7247c,2031-08-03,2031-08-05,Local Market,5499,Groceries,Specialty,-15.87,GBP,-174075.32,POS,London,GB,9074,user_001,,
75788ca4-86bd-4c23-b05c-0d4cd4f40991,2031-08-04,2031-08-05,Tesco,5411,Groceries,Supermarket,-64.95,GBP,-174140.27,POS,London,GB,1045,user_002,,
1c7ce16a-3343-49ae-b40a-f8ebfe0b9b06,2031-08-05,2031-08-06,Pret A Manger,5814,Food & Drink,Eating Out,-6.04,GBP,-174146.31,POS,London,GB,1045,user_001,,
1f680433-0b58-4cf0-864d-49cb95bf94f2,2031-08-05,2031-08-07,Shell,5541,Transport,Fuel,-68.0,GBP,-174214.31,POS,London,GB,9074,user_001,,
e698236f-d523-4e91-a573-fbfc803e3470,2031-08-05,2031-08-07,Amazon UK,5942,Shopping,Online Retail,-109.69,GBP,-174324.0,E-Com,London,GB,1045,user_001,,
eef41b20-8d05-4418-9eef-37bde9f4709a,2031-08-05,2031-08-05,Sainsbury's,5411,Groceries,Supermarket,-69.53,GBP,-174393.53,POS,London,GB,1045,user_001,,
fcd18065-d9d9-4f07-a15e-35787d78d6ac,2031-08-05,2031-08-06,Apple.com/bill,5734,Shopping,Electronics,-187.5,USD,-174581.03,E-Com,Cupertino,US,1045,user_002,,FX purchase 226.75 USD @ rate 1.21
5547f6ac-108e-4e58-bfa2-cf13ba5a636a,2031-08-06,2031-08-06,Local Market,5499,Groceries,Specialty,-16.95,GBP,-174597.98,POS,London,GB,4488,user_001,,
622ec775-585e-41cb-a571-c627b62fbed9,2031-08-07,2031-08-08,Sainsbury's,5411,Groceries,Supermarket,-68.69,GBP,-174666.67,POS,London,GB,4488,user_001,,
8e8c28ab-e49d-4bea-846f-5c0276a258d9,2031-08-07,2031-08-08,Octopus Energy,4900,Utilities,Electricity,-118.37,GBP,-174785.04,Direct Debit,London,GB,4488,user_001,rec_141a4a0666,
d2a6fba4-0879-4799-8b2a-883169790142,2031-08-07,2031-08-07,Waitrose,5411,Groceries,Supermarket,-34.21,GBP,-174819.25,POS,London,GB,4488,user_001,,
2a6e96e6-e664-4877-8959-4d982d38d855,2031-08-08,2031-08-11,Waitrose,5411,Groceries,Supermarket,-81.1,GBP,-174900.35,POS,London,GB,4488,user_002,,
6e1b8910-15b6-4cf7-b176-fca0e8d8881d,2031-08-08,2031-08-11,Transport for London,4111,Transport,Transit,-11.9,GBP,-174912.25,POS,London,GB,4488,user_001,,
01ce8d15-7e5a-46ab-89f3-2f58e5a6b4a4,2031-08-09,2031-08-11,Sainsbury's,5411,Groceries,Supermarket,-27.56,GBP,-174939.81,POS,London,GB,1045,user_001,,
11c405b0-d8bd-40cd-92b1-b2d2958c8b3c,2031-08-09,2031-08-11,Apple.com/bill,5734,Shopping,Electronics,-184.12,USD,-175123.93,E-Com,Cupertino,US,1045,user_001,,FX purchase 232.59 USD @ rate 1.26
8304fc5a-5f48-49c4-840b-a0061324cff6,2031-08-09,2031-08-11,Amazon UK,5942,Shopping,Online Retail,-67.14,GBP,-175191.07,E-Com,London,GB,2219,user_002,,
8c0e289c-588b-4d44-b3b9-5039c6a7636a,2031-08-09,2031-08-11,Tesco,5411,Groceries,Supermarket,-68.37,GBP,-175259.44,POS,London,GB,4488,user_001,,
6e8c3f32-3c5f-4aed-948a-0a9341be3ff6,2031-08-10,2031-08-11,Apple.com/bill,5734,Shopping,Electronics,-114.05,USD,-175373.49,E-Com,Cupertino,US,4488,user_001,,FX purchase 145.3 USD @ rate 1.27
a961e9c2-6268-4652-bf45-ecbf392d8f47,2031-08-10,2031-08-11,Transport for London,4111,Transport,Transit,-10.52,GBP,-175384.01,POS,London,GB,9074,user_001,,
c837a5dc-b0fa-44f2-880a-1d6b0ffee14c,2031-08-10,2031-08-12,Sainsbury's,5411,Groceries,Supermarket,-63.07,GBP,-175447.08,POS,London,GB,9074,user_002,,
5ae4d32f-c7f3-4557-b454-0974488f9a0f,2031-08-11,2031-08-12,Thames Water,4900,Utilities,Water,-38.96,GBP,-175486.04,Direct Debit,Reading,GB,9074,user_001,rec_3a34d62842,
282db7f7-1e72-4996-b168-b692eccbb879,2031-08-12,2031-08-13,Apple.com/bill,5734,Shopping,Electronics,-127.2,USD,-175613.24,E-Com,Cupertino,US,9074,user_001,,FX purchase 159.19 USD @ rate 1.25
1087078e-8d3f-4efc-beff-c62c92a5b7a4,2031-08-13,2031-08-13,City Council Tax,9399,Utilities,Council Tax,-156.72,GBP,-175769.96,Direct Debit,London,GB,2219,user_001,rec_f531495db5,
42a7fc32-0f0c-4756-bbc5-cfd1e84a0ad4,2031-08-13,2031-08-14,Sainsbury's,5411,Groceries,Supermarket,-29.23,GBP,-175799.19,POS,London,GB,1045,user_001,,
a4d7b802-f2eb-45e4-98ba-c22f01edb651,2031-08-13,2031-08-13,Shell,5541,Transport,Fuel,-89.04,GBP,-175888.23,POS,London,GB,2219,user_002,,
b756a0e8-bd4f-4f9d-a9d2-26c6ed653772,2031-08-13,2031-08-15,Amazon UK,5942,Shopping,Online Retail,-59.68,GBP,-175947.91,E-Com,London,GB,2219,user_001,,
2a33e602-d316-4eac-8c1f-2d70be971f1c,2031-08-14,2031-08-15,Uber UK,4121,Transport,Ride Hailing,-34.56,GBP,-175982.47,E-Com,London,GB,4488,user_001,,
7800bd7d-d837-4e13-8b59-d0b7be28167f,2031-08-14,2031-08-15,Waitrose,5411,Groceries,Supermarket,-44.22,GBP,-176026.69,POS,London,GB,4488,user_001,,
cb8a1f4e-c013-482f-93b6-4a128bfd0d1b,2031-08-14,2031-08-14,Uber UK,4121,Transport,Ride Hailing,-11.35,GBP,-176038.04,E-Com,London,GB,9074,user_001,,
2fb1b8dd-8c1a-429c-8067-8f1a7ace79a7,2031-08-15,2031-08-18,O2 UK,4814,Bills,Mobile,-37.42,GBP,-176075.46,Direct Debit,Slough,GB,2219,user_001,rec_95042d8101,
d5b9c7be-465e-444f-8e09-080bd2eea4b7,2031-08-15,2031-08-18,Tesco,5411,Groceries,Supermarket,-43.45,GBP,-176118.91,POS,London,GB,4488,user_001,,
5c6ca3ca-fce5-4f7d-8275-1be28c2b4a34,2031-08-16,2031-08-18,Waitrose,5411,Groceries,Supermarket,-22.72,GBP,-176141.63,POS,London,GB,9074,user_001,,
db3db73a-1eb4-489a-a36d-87f7c5ce706d,2031-08-16,2031-08-18,Deliveroo,5812,Food & Drink,Delivery,-20.83,GBP,-176162.46,E-Com,London,GB,1045,user_001,,
68231d20-c45d-446d-b9bc-3aec6a413db8,2031-08-17,2031-08-18,Transport for London,4111,Transport,Transit,-7.42,GBP,-176169.88,POS,London,GB,4488,user_002,,
bb5457f3-5c9b-49b0-94f0-38229616d277,2031-08-17,2031-08-18,Pret A Manger,5814,Food & Drink,Eating Out,-6.3,GBP,-176176.18,POS,London,GB,4488,user_001,,
f2d76198-c962-440e-b29f-f62b604ef234,2031-08-17,2031-08-18,Apple.com/bill,5734,Shopping,Electronics,-197.61,GBP,-176373.79,E-Com,Cupertino,US,1045,user_001,,
e7ebe35e-3a9b-41b2-82f7-444c13e94b81,2031-08-18,2031-08-18,GymBox,7997,Wellness,Gym,-55.29,GBP,-176429.08,Direct Debit,London,GB,4488,user_002,rec_19771e79cd,
4ace2c9c-e715-4976-89ca-17e75ef4f648,2031-08-19,2031-08-21,Amazon UK,5942,Shopping,Online Retail,-78.7,GBP,-176507.78,E-Com,London,GB,2219,user_001,,
b11ff74f-bf3a-435d-9a8e-eb3af98270aa,2031-08-19,2031-08-19,Spotify,5735,Entertainment,Subscriptions,-9.81,EUR,-176517.59,E-Com,Stockholm,SE,9074,user_001,rec_4c746d2c3b,FX purchase 11.24 EUR @ rate 1.15
ebddece0-4067-4466-b039-dad1085bd4b9,2031-08-19,2031-08-20,Waitrose,5411,Groceries,Supermarket,-75.92,GBP,-176593.51,POS,London,GB,4488,user_001,,
2fdfb390-9a29-498e-810b-10e89202c852,2031-08-20,2031-08-20,Local Market,5499,Groceries,Specialty,-17.71,GBP,-176611.22,POS,London,GB,2219,user_001,,
90b5125b-c740-4112-8e88-133ffd1d730f,2031-08-20,2031-08-22,Apple.com/bill,5734,Shopping,Electronics,-79.37,USD,-176690.59,E-Com,Cupertino,US,4488,user_001,,FX purchase 96.94 USD @ rate 1.22
454eb6c1-f549-4114-b712-6ca8d377aec8,2031-08-21,2031-08-21,Netflix,7841,Entertainment,Subscriptions,-13.04,GBP,-176703.63,E-Com,Los Gatos,US,1045,user_001,rec_1bfe33738d,
8fd97157-8afe-430a-9e8d-c8872f407285,2031-08-21,2031-08-22,Uber UK,4121,Transport,Ride Hailing,-35.54,GBP,-176739.17,E-Com,London,GB,2219,user_001,,
facfca04-2ec3-487a-b734-2239d407354c,2031-08-21,2031-08-21,Sainsbury's,5411,Groceries,Supermarket,-61.11,GBP,-176800.28,POS,London,GB,1045,user_001,,
12df18a5-2741-40ac-b973-b7d62a54e5b4,2031-08-22,2031-08-25,Sainsbury's,5411,Groceries,Supermarket,-51.72,GBP,-176852.0,POS,London,GB,9074,user_001,,
0c723bb5-7368-4c5b-855b-216363159760,2031-08-23,2031-08-25,Apple.com/bill,5734,Shopping,Electronics,-151.87,GBP,-177003.87,E-Com,Cupertino,US,4488,user_001,,
362ba8fb-c544-44ba-b86f-2f7df5ed32c3,2031-08-23,2031-08-25,Transport for London,4111,Transport,Transit,-4.61,GBP,-177008.48,POS,London,GB,4488,user_002,,
a4148e01-3a1e-43f7-8638-a5d229491628,2031-08-23,2031-08-25,Local Market,5499,Groceries,Specialty,-14.91,GBP,-177023.39,POS,London,GB,4488,user_001,,
5344cca7-333a-4ecf-b530-9763bbe7ac44,2031-08-24,2031-08-25,Pret A Manger,5814,Food & Drink,Eating Out,-6.93,GBP,-177030.32,POS,London,GB,2219,user_002,,
683dcd16-af28-48fc-bc6d-75e0a3bdb051,2031-08-24,2031-08-25,Sainsbury's,5411,Groceries,Supermarket,-23.73,GBP,-177054.05,POS,London,GB,9074,user_001,,
7fe3c16b-0ae1-47c0-aa2b-6b0f836a5912,2031-08-24,2031-08-26,Transport for London,4111,Transport,Transit,-3.88,GBP,-177057.93,POS,London,GB,1045,user_001,,
94650599-d007-4746-8265-5a8793a32572,2031-08-24,2031-08-26,Pret A Manger,5814,Food & Drink,Eating Out,-5.6,GBP,-177063.53,POS,London,GB,4488,user_001,,
95d08664-cfe1-4dde-bc6e-785df47da5de,2031-08-24,2031-08-26,Amazon UK,5942,Shopping,Online Retail,-113.49,GBP,-177177.02,E-Com,London,GB,4488,user_002,,
4369d57f-7f30-429b-a76b-0e73b32fb941,2031-08-25,2031-08-25,T212 Capital,6011,Income,Salary,3432.04,GBP,-173744.98,Credit,London,GB,4488,user_001,rec_2ff8f778d0,
dce311f6-1351-45e6-a9c1-dc54ea278a7b,2031-08-25,2031-08-26,Tesco,5411,Groceries,Supermarket,-28.29,GBP,-173773.27,POS,London,GB,2219,user_001,,
f826b314-93de-4356-830a-c972f6fcc61b,2031-08-26,2031-08-27,Uber UK,4121,Transport,Ride Hailing,-18.81,GBP,-173792.08,E-Com,London,GB,9074,user_002,,
37658739-d864-4776-9d43-8dd3fbaaa774,2031-08-27,2031-08-28,Pret A Manger,5814,Food & Drink,Eating Out,-11.67,GBP,-173803.75,POS,London,GB,1045,user_001,,
8c4d97f5-0bca-4c01-ac73-0fd9555dc420,2031-08-27,2031-08-28,Transport for London,4111,Transport,Transit,-6.21,GBP,-173809.96,POS,London,GB,9074,user_002,,
1d712a28-8a4e-4f07-a2a9-40442c508e0e,2031-08-28,2031-09-01,Sainsbury's,5411,Groceries,Supermarket,-37.55,GBP,-173847.51,POS,London,GB,9074,user_001,,
72a551f7-68df-4fe9-b5e9-5e9ff353e636,2031-08-28,2031-09-01,ATM Withdrawal,6011,Cash,ATM,-117.79,GBP,-173965.3,ATM,London,GB,4488,user_001,,
d0e4037e-9f39-4d6c-ac07-c1f5fcbf17ab,2031-08-28,2031-08-28,Sainsbury's,5411,Groceries,Supermarket,-26.47,GBP,-173991.77,POS,London,GB,4488,user_001,,
0ba46c81-289e-4ea2-93e4-ed062c1ef919,2031-08-29,2031-08-29,Pret A Manger,5814,Food & Drink,Eating Out,-6.77,GBP,-173998.54,POS,London,GB,1045,user_001,,
0d9d334e-79e4-4a3b-af7c-6e836d7bc919,2031-08-29,2031-08-29,Shell,5541,Transport,Fuel,-45.52,GBP,-174044.06,POS,London,GB,4488,user_001,,
3ab9da6b-6d59-4a0e-83ee-b35165578ca7,2031-08-29,2031-09-01,Pret A Manger,5814,Food & Drink,Eating Out,-10.36,GBP,-174054.42,POS,London,GB,1045,user_001,,
7a8557d5-bc6e-481b-bcd5-eee38c25274a,2031-08-30,2031-09-01,Transport for London,4111,Transport,Transit,-4.23,GBP,-174058.65,POS,London,GB,2219,user_001,,
85a1e006-94fc-4005-a423-32e6b562948a,2031-08-30,2031-09-01,Amazon UK,5942,Shopping,Online Retail,-91.86,GBP,-174150.51,E-Com,London,GB,4488,user_002,,
6589ab17-4af3-41fa-985e-07d70f23ffb7,2031-08-31,2031-09-01,Shell,5541,Transport,Fuel,-52.84,GBP,-174203.35,POS,London,GB,4488,user_001,,
88876f59-a03a-41e5-b5f4-d19c73063628,2031-08-31,2031-09-02,Sainsbury's,5411,Groceries,Supermarket,-54.03,GBP,-174257.38,POS,London,GB,2219,user_001,,
aefddc70-471a-4c92-81e2-776f3c1bc24a,2031-08-31,2031-09-01,Transport for London,4111,Transport,Transit,-8.29,GBP,-174265.67,POS,London,GB,1045,user_001,,
aff67ff8-f203-4b12-be70-1855d3ee1866,2031-08-31,2031-09-01,Pret A Manger,5814,Food & Drink,Eating Out,-11.28,GBP,-174276.95,POS,London,GB,4488,user_001,,
d36b9dec-65fe-44dd-bcd3-ed54728d8c8e,2031-08-31,2031-09-02,Uber UK,4121,Transport,Ride Hailing,-23.39,GBP,-174300.34,E-Com,London,GB,4488,user_001,,
77709ab9-c495-41aa-bf63-07621572c565,2031-09-01,2031-09-03,Transport for London,4111,Transport,Transit,-6.82,GBP,-174307.16,POS,London,GB,2219,user_002,,
b8202256-4855-49ea-85f7-cf2ee6662d23,2031-09-01,2031-09-01,Crown Estates Lettings,6513,Housing,Rent,-1457.06,GBP,-175764.22,POS,London,GB,4488,user_002,rec_fc2ae06846,
5167b4f2-1df4-4405-bb88-8a6c788b6832,2031-09-02,2031-09-04,Shell,5541,Transport,Fuel,-38.38,GBP,-175802.6,POS,London,GB,4488,user_001,,
d8f95cec-1716-441b-94e8-5aed422b4c94,2031-09-02,2031-09-03,Local Market,5499,Groceries,Specialty,-14.34,GBP,-175816.94,POS,London,GB,1045,user_001,,
3c28eefc-230e-4945-b9d9-07c0fc2c6446,2031-09-04,2031-09-04,Sainsbury's,5411,Groceries,Supermarket,-18.72,GBP,-175835.66,POS,London,GB,2219,user_001,,
4082ed13-583c-434e-aa75-9c4f7faa3be9,2031-09-04,2031-09-05,Transport for London,4111,Transport,Transit,-4.01,GBP,-175839.67,POS,London,GB,9074,user_001,,
898b041b-df21-4143-829b-337c70499d5c,2031-09-04,2031-09-08,Local Market,5499,Groceries,Specialty,-20.67,GBP,-175860.34,POS,London,GB,4488,user_001,,
124e612e-f1f3-49f9-bb26-64f67d909c01,2031-09-05,2031-09-08,ATM Withdrawal,6011,Cash,ATM,-64.21,GBP,-175924.55,ATM,London,GB,4488,user_001,,
5b0734c1-4847-4591-b5b1-da5f4cc878dc,2031-09-05,2031-09-08,Transport for London,4111,Transport,Transit,-3.69,GBP,-175928.24,POS,London,GB,2219,user_002,,
d53c7679-ecee-4808-a42f-6cf3f7884371,2031-09-05,2031-09-08,Uber UK,4121,Transport,Ride Hailing,-11.42,GBP,-175939.66,E-Com,London,GB,1045,user_001,,
081a6dae-4326-427b-bb59-5f27904b3ef4,2031-09-06,2031-09-08,Sainsbury's,5411,Groceries,Supermarket,-48.18,GBP,-175987.84,POS,London,GB,4488,user_001,,
0a4ef79c-eca8-49ff-93cf-c6462ad99d9a,2031-09-06,2031-09-08,Local Market,5499,Groceries,Specialty,-21.74,GBP,-176009.58,POS,London,GB,9074,user_001,,
3b17cff1-0c51-439b-90f6-0ec003e8f3a0,2031-09-06,2031-09-08,Uber UK,4121,Transport,Ride Hailing,-8.23,GBP,-176017.81,E-Com,London,GB,1045,user_001,,
6e9779a9-50b4-4587-bba0-89a3d1dd6f7c,2031-09-06,2031-09-08,Shell,5541,Transport,Fuel,-40.56,GBP,-176058.37,POS,London,GB,4488,user_001,,
81a438a2-5721-4371-878c-785462445a9c,2031-09-06,2031-09-08,Amazon UK,5942,Shopping,Online Retail,-76.76,GBP,-176135.13,E-Com,London,GB,9074,user_001,,
9ca7d0d7-6a2a-413f-859f-b17f614141c2,2031-09-06,2031-09-08,Pret A Manger,5814,Food & Drink,Eating Out,-7.55,GBP,-176142.68,POS,London,GB,2219,user_001,,
cd018497-4542-4cb7-bc4e-2b454ae851a7,2031-09-06,2031-09-08,Shell,5541,Transport,Fuel,-74.9,GBP,-176217.58,POS,London,GB,2219,user_001,,
427c1ad2-efd6-4ea8-bfe9-9bdf9cac7ff4,2031-09-07,2031-09-08,Amazon UK,5942,Shopping,Online Retail,-49.42,GBP,-176267.0,E-Com,London,GB,1045,user_001,,
d4fa28bc-0bb9-464a-92a0-305b751aa1de,2031-09-07,2031-09-08,Amazon UK,5942,Shopping,Online Retail,-89.05,GBP,-176356.05,E-Com,London,GB,2219,user_001,,
0951b0f5-89f0-4693-9250-39e237af976c,2031-09-08,2031-09-10,Transport for London,4111,Transport,Transit,-3.75,GBP,-176359.8,POS,London,GB,2219,user_001,,
7fbe6f87-76c0-4fc3-b76b-bd9cfecb28cf,2031-09-08,2031-09-10,Octopus Energy,4900,Utilities,Electricity,-116.81,GBP,-176476.61,Direct Debit,London,GB,1045,user_001,rec_141a4a0666,
0f42b3c7-b1a9-411a-90bb-a84892f9dafe,2031-09-09,2031-09-11,Tesco,5411,Groceries,Supermarket,-51.36,GBP,-176527.97,POS,London,GB,9074,user_001,,
165398d6-e1e0-40bb-8e71-17f2ad3c53d7,2031-09-09,2031-09-09,Pret A Manger,5814,Food & Drink,Eating Out,-10.42,GBP,-176538.39,POS,London,GB,2219,user_001,,
3d7ad855-70a2-4277-a9da-8b673b8f6974,2031-09-09,2031-09-10,Deliveroo,5812,Food & Drink,Delivery,-27.03,GBP,-176565.42,E-Com,London,GB,4488,user_001,,
7506e211-3ca2-46ca-9838-5b1b7e8f3b33,2031-09-09,2031-09-11,Uber UK,4121,Transport,Ride Hailing,-10.92,GBP,-176576.34,E-Com,London,GB,1045,user_001,,
619d7edf-9f6b-49ef-be8e-9970c6abaa12,2031-09-10,2031-09-11,Uber UK,4121,Transport,Ride Hailing,-24.06,GBP,-176600.4,E-Com,London,GB,1045,user_001,,
778bd2bd-a762-486b-a3b9-45ae24099ee5,2031-09-10,2031-09-10,Tesco,5411,Groceries,Supermarket,-79.27,GBP,-176679.67,POS,London,GB,9074,user_002,,
84ec1f35-bfe5-476c-bd28-08cbc6e02b1c,2031-09-10,2031-09-11,Deliveroo,5812,Food & Drink,Delivery,-19.07,GBP,-176698.74,E-Com,London,GB,1045,user_001,,
b9087fed-d1c3-4b58-93ac-e2c90a79a274,2031-09-10,2031-09-10,Local Market,5499,Groceries,Specialty,-14.07,GBP,-176712.81,POS,London,GB,1045,user_001,,
237d8bbc-8772-4888-bc0b-c0779f5140d3,2031-09-11,2031-09-12,Thames Water,4900,Utilities,Water,-40.16,GBP,-176752.97,Direct Debit,Reading,GB,2219,user_001,rec_3a34d62842,
4880fa50-a679-4001-a788-703dbee23eec,2031-09-11,2031-09-12,Waitrose,5411,Groceries,Supermarket,-43.05,GBP,-176796.02,POS,London,GB,1045,user_001,,
65299794-4c66-4ae1-b33f-f7d8fbd73e92,2031-09-11,2031-09-15,Pret A Manger,5814,Food & Drink,Eating Out,-6.92,GBP,-176802.94,POS,London,GB,2219,user_001,,
8fa59842-6e47-48e6-bbc4-47f444e3397d,2031-09-11,2031-09-15,Amazon UK,5942,Shopping,Online Retail,-44.81,GBP,-176847.75,E-Com,London,GB,1045,user_001,,
f062fd5c-636e-43d2-9987-398f69da0f5b,2031-09-11,2031-09-15,Deliveroo,5812,Food & Drink,Delivery,-30.05,GBP,-176877.8,E-Com,London,GB,2219,user_001,,
b3cc7461-98cb-47db-96c6-6a859af5d772,2031-09-12,2031-09-15,ATM Withdrawal,6011,Cash,ATM,-110.6,GBP,-176988.4,ATM,London,GB,1045,user_002,,
03be7dda-cd7c-4a09-af6e-e99138606737,2031-09-13,2031-09-15,Tesco,5411,Groceries,Supermarket,-49.51,GBP,-177037.91,POS,London,GB,2219,user_001,,
05d48aeb-ea6a-4e86-a743-86432e04fc21,2031-09-13,2031-09-15,Tesco,5411,Groceries,Supermarket,-18.58,GBP,-177056.49,POS,London,GB,2219,user_001,,
e828338a-5edf-4ca8-a88f-7bdb9f9e212f,2031-09-13,2031-09-15,Amazon UK,5942,Shopping,Online Retail,-16.58,GBP,-177073.07,E-Com,London,GB,4488,user_001,,
ee00fbd4-7ecc-435f-8f9b-6cfdd4d44624,2031-09-13,2031-09-15,Transport for London,4111,Transport,Transit,-6.36,GBP,-177079.43,POS,London,GB,9074,user_001,,
9cdd4c2a-5c92-4d4e-b097-41ac8ff05e10,2031-09-14,2031-09-15,Transport for London,4111,Transport,Transit,-9.29,GBP,-177088.72,POS,London,GB,9074,user_002,,
b1ae850d-9f7c-409d-9f94-dc67c6a1923c,2031-09-14,2031-09-15,Uber UK,4121,Transport,Ride Hailing,-32.02,GBP,-177120.74,E-Com,London,GB,2219,user_002,,
3c18238b-853a-4648-93b3-f45d9927c071,2031-09-15,2031-09-15,ATM Withdrawal,6011,Cash,ATM,-66.14,GBP,-177186.88,ATM,London,GB,9074,user_001,,
97f8651f-383b-4234-8a4d-d377e7cbfafe,2031-09-15,2031-09-16,Apple.com/bill,5734,Shopping,Electronics,-181.47,USD,-177368.35,E-Com,Cupertino,US,1045,user_001,,FX purchase 222.96 USD @ rate 1.23
ce2ad9e5-6d7a-4388-914a-84450c9a2846,2031-09-15,2031-09-17,O2 UK,4814,Bills,Mobile,-38.62,GBP,-177406.97,Direct Debit,Slough,GB,2219,user_002,rec_d2dce4c42f,
d07bc707-d380-412d-b752-c57716fdae1a,2031-09-15,2031-09-17,City Council Tax,9399,Utilities,Council Tax,-167.76,GBP,-177574.73,Direct Debit,London,GB,2219,user_001,rec_f531495db5,
58825fda-5547-4d5b-bde7-4334bef1bf2c,2031-09-16,2031-09-17,Local Market,5499,Groceries,Specialty,-11.74,GBP,-177586.47,POS,London,GB,2219,user_001,,
0384f02c-940b-4f38-b177-9ae709bc9c65,2031-09-17,2031-09-17,Amazon UK,5942,Shopping,Online Retail,-112.8,GBP,-177699.27,E-Com,London,GB,9074,user_001,,
c16fd8c7-2c30-40cb-b7b8-57cbb1505ad4,2031-09-17,2031-09-19,GymBox,7997,Wellness,Gym,-54.42,GBP,-177753.69,Direct Debit,London,GB,2219,user_001,rec_3906953fd2,
94ef5ff1-8ede-48b7-b577-1d4f5ca8a2e0,2031-09-18,2031-09-19,ATM Withdrawal,6011,Cash,ATM,-62.2,GBP,-177815.89,ATM,London,GB,2219,user_001,,
08d8919e-57cc-4d27-9a01-99992714d7fb,2031-09-19,2031-09-19,Deliveroo,5812,Food & Drink,Delivery,-19.04,GBP,-177834.93,E-Com,London,GB,2219,user_001,,
0c7be588-06e7-4836-a3ec-25de58d6b693,2031-09-19,2031-09-22,Spotify,5735,Entertainment,Subscriptions,-8.21,GBP,-177843.14,E-Com,Stockholm,SE,1045,user_001,rec_4c746d2c3b,
5fa87f65-a4fc-4509-88b3-5e5d96a4e70f,2031-09-19,2031-09-22,Amazon UK,5942,Shopping,Online Retail,-55.76,GBP,-177898.9,E-Com,London,GB,9074,user_002,,
ee92be77-1cdb-4727-a58f-8ebb1a360423,2031-09-19,2031-09-19,Amazon UK,5942,Shopping,Online Retail,-96.83,GBP,-177995.73,E-Com,London,GB,1045,user_001,,
1f4acf01-4a33-48bf-8f01-16aa62a4ca59,2031-09-20,2031-09-22,Uber UK,4121,Transport,Ride Hailing,-32.39,GBP,-178028.12,E-Com,London,GB,9074,user_001,,
2ffa7812-b207-43e8-a3c3-3cdef5ecb2c7,2031-09-20,2031-09-22,Transport for London,4111,Transport,Transit,-5.8,GBP,-178033.92,POS,London,GB,4488,user_001,,
3dd3d5a8-2c24-4096-af06-2bc105519a9e,2031-09-20,2031-09-22,Pret A Manger,5814,Food & Drink,Eating Out,-5.99,GBP,-178039.91,POS,London,GB,9074,user_001,,
50e5ebf8-d55d-46de-9309-67779259af50,2031-09-20,2031-09-22,Uber UK,4121,Transport,Ride Hailing,-15.44,GBP,-178055.35,E-Com,London,GB,9074,user_001,,
f1f175b4-436d-4b8f-ab67-696b0ff8784a,2031-09-20,2031-09-22,Transport for London,4111,Transport,Transit,-4.85,GBP,-178060.2,POS,London,GB,1045,user_001,,
b6148f61-82f0-41f1-a45a-d5d32d644447,2031-09-21,2031-09-22,Apple.com/bill,5734,Shopping,Electronics,-169.56,GBP,-178229.76,E-Com,Cupertino,US,4488,user_001,,
ce47469e-fc4e-42e8-96e0-12085a56c91b,2031-09-21,2031-09-22,Apple.com/bill,5734,Shopping,Electronics,-57.42,GBP,-178287.18,E-Com,Cupertino,US,4488,user_001,,
fe884c04-60c1-4fd7-968a-496b348c5904,2031-09-21,2031-09-22,Uber UK,4121,Transport,Ride Hailing,-23.68,GBP,-178310.86,E-Com,London,GB,2219,user_001,,
160679f7-11c8-4901-bdb9-d0f12cb7f6cf,2031-09-22,2031-09-23,Shell,5541,Transport,Fuel,-42.11,GBP,-178352.97,POS,London,GB,4488,user_001,,
5a664b72-8351-4366-b925-1d018a658d23,2031-09-22,2031-09-22,Uber UK,4121,Transport,Ride Hailing,-20.02,GBP,-178372.99,E-Com,London,GB,9074,user_001,,
d072fe08-b3b5-439f-8bf6-295e53f0609b,2031-09-22,2031-09-22,Netflix,7841,Entertainment,Subscriptions,-13.9,USD,-178386.89,E-Com,Los Gatos,US,9074,user_001,rec_1bfe33738d,FX purchase 16.87 USD @ rate 1.21
24497feb-2708-4f2c-91ec-09344f18df0f,2031-09-24,2031-09-25,Local Market,5499,Groceries,Specialty,-14.68,GBP,-178401.57,POS,London,GB,9074,user_002,,
8bd6e2ff-e010-4b03-b58d-91d2c39e48e5,2031-09-24,2031-09-25,Uber UK,4121,Transport,Ride Hailing,-30.42,GBP,-178431.99,E-Com,London,GB,1045,user_001,,
951390fe-4364-4fd8-8ea8-347c6d30ddd6,2031-09-24,2031-09-26,Uber UK,4121,Transport,Ride Hailing,-29.15,GBP,-178461.14,E-Com,London,GB,9074,user_002,,
a1b01916-f2cc-4bb8-bfd5-2215479174c1,2031-09-25,2031-09-29,Shell,5541,Transport,Fuel,-86.88,GBP,-178548.02,POS,London,GB,9074,user_001,,
dce8c364-09ab-48e6-b9c5-a4412bd1fc5d,2031-09-25,2031-09-25,T212 Capital,6011,Income,Salary,3290.99,GBP,-175257.03,Credit,London,GB,4488,user_001,rec_2ff8f778d0,
313375b1-23bb-4aa5-9be5-8f10a9b1fa20,2031-09-26,2031-09-26,HM Revenue & Customs,9311,Income,Tax Refund,35.91,GBP,-175221.12,Credit,London,GB,1045,user_001,,Refund for Amazon UK
54dce9f6-d8ae-442a-85e7-a4e2e50160c7,2031-09-26,2031-09-29,Deliveroo,5812,Food & Drink,Delivery,-26.42,GBP,-175247.54,E-Com,London,GB,9074,user_001,,
64acdbcd-02b6-41f3-964c-36ee29a73439,2031-09-26,2031-09-26,Apple.com/bill,5734,Shopping,Electronics,-207.85,GBP,-175455.39,E-Com,Cupertino,US,4488,user_002,,
ca73ab0a-019e-4935-a53f-3d1f9a5f2a1c,2031-09-26,2031-09-29,Local Market,5499,Groceries,Specialty,-7.91,GBP,-175463.3,POS,London,GB,2219,user_001,,
bf691817-870e-463d-9896-69b3506895eb,2031-09-27,2031-09-29,Pret A Manger,5814,Food & Drink,Eating Out,-6.95,GBP,-175470.25,POS,London,GB,2219,user_001,,
00522ec9-597c-42ae-b009-8c78ad9691f5,2031-09-28,2031-09-29,Local Market,5499,Groceries,Specialty,-16.8,GBP,-175487.05,POS,London,GB,1045,user_001,,
dad9feee-c163-4daf-90e9-f91a1a9bc3fc,2031-09-28,2031-09-30,Uber UK,4121,Transport,Ride Hailing,-12.12,GBP,-175499.17,E-Com,London,GB,2219,user_001,,
ee271bb2-b58c-47ca-ba43-703e647ae439,2031-09-28,2031-09-29,Apple.com/bill,5734,Shopping,Electronics,-121.58,GBP,-175620.75,E-Com,Cupertino,US,4488,user_001,,
f8e3f6d5-f625-485f-8d56-d4731751ac7d,2031-09-28,2031-09-29,Waitrose,5411,Groceries,Supermarket,-31.76,GBP,-175652.51,POS,London,GB,2219,user_001,,
e0a62e30-0d1a-43c5-acb1-4f2c417db5a5,2031-09-29,2031-10-01,Amazon UK,5942,Shopping,Online Retail,-68.02,GBP,-175720.53,E-Com,London,GB,9074,user_001,,
2317c59c-80e1-4e60-bd83-896d0a825e59,2031-09-30,2031-09-30,Pret A Manger,5814,Food & Drink,Eating Out,-6.67,GBP,-175727.2,POS,London,GB,4488,user_002,,
29eb77ee-7c2a-4ec4-88e2-3abbf8d3d96a,2031-09-30,2031-10-02,Apple.com/bill,5734,Shopping,Electronics,-49.13,USD,-175776.33,E-Com,Cupertino,US,9074,user_002,,FX purchase 62.79 USD @ rate 1.28
dae74561-95ff-47f8-b7a7-805450e189f8,2031-09-30,2031-09-30,Shell,5541,Transport,Fuel,-52.58,GBP,-175828.91,POS,London,GB,1045,user_001,,
7bbf20ad-a5a2-4173-ac6e-6084814729b7,2031-10-01,2031-10-02,Crown Estates Lettings,6513,Housing,Rent,-1531.13,GBP,-177360.04,POS,London,GB,9074,user_002,rec_fc2ae06846,
7d27a154-00c9-4768-b01c-f73ea27d5e14,2031-10-02,2031-10-02,Apple.com/bill,5734,Shopping,Electronics,-153.19,GBP,-177513.23,E-Com,Cupertino,US,2219,user_002,,
b8b9b631-5128-47ba-a19a-82c51b30d7eb,2031-10-02,2031-10-02,Sainsbury's,5411,Groceries,Supermarket,-55.22,GBP,-177568.45,POS,London,GB,1045,user_001,,
7b3c5622-cbf9-4aee-b86b-4d00a37c72b3,2031-10-03,2031-10-03,Transport for London,4111,Transport,Transit,-9.3,GBP,-177577.75,POS,London,GB,2219,user_001,,
91b7b664-fdc2-446f-9e6f-850ef74f4fdf,2031-10-03,2031-10-06,Tesco,5411,Groceries,Supermarket,-57.52,GBP,-177635.27,POS,London,GB,4488,user_002,,
ca9172d4-0b5f-4a4a-b666-347693cafb87,2031-10-03,2031-10-06,Waitrose,5411,Groceries,Supermarket,-63.92,GBP,-177699.19,POS,London,GB,1045,user_001,,
27649fa3-f8b2-4437-832a-8de3f03bd23a,2031-10-04,2031-10-06,Pret A Manger,5814,Food & Drink,Eating Out,-11.78,GBP,-177710.97,POS,London,GB,1045,user_001,,
65133994-5cf1-4f8f-9a65-6f29494f6aa2,2031-10-04,2031-10-06,Shell,5541,Transport,Fuel,-81.85,GBP,-177792.82,POS,London,GB,2219,user_001,,
674731ab-3e87-419d-a496-d0f5ad4ec124,2031-10-04,2031-10-06,Transport for London,4111,Transport,Transit,-11.92,GBP,-177804.74,POS,London,GB,1045,user_001,,
cf23b1f3-8acb-4487-a3be-ce92d0996c2f,2031-10-04,2031-10-06,Amazon UK,5942,Shopping,Online Retail,-31.4,GBP,-177836.14,E-Com,London,GB,1045,user_001,,
4560416b-e92c-409e-9b61-e8aa4ed1634a,2031-10-05,2031-10-07,Local Market,5499,Groceries,Specialty,-18.53,GBP,-177854.67,POS,London,GB,9074,user_001,,
630df962-96ec-4bcf-9c4e-afe539eb3961,2031-10-05,2031-10-07,Tesco,5411,Groceries,Supermarket,-25.3,GBP,-177879.97,POS,London,GB,4488,user_001,,
b4b07311-6f0c-4216-9c68-16194555a6a3,2031-10-05,2031-10-07,Deliveroo,5812,Food & Drink,Delivery,-18.03,GBP,-177898.0,E-Com,London,GB,2219,user_001,,
2d9d834d-60d5-4035-9ea7-1519c83d9254,2031-10-07,2031-10-09,Octopus Energy,4900,Utilities,Electricity,-122.62,GBP,-178020.62,Direct Debit,London,GB,2219,user_001,rec_141a4a0666,
5c0cc1cb-c5ea-4596-8c8f-9d13aaa89aaa,2031-10-07,2031-10-09,Pret A Manger,5814,Food & Drink,Eating Out,-10.22,GBP,-178030.84,POS,London,GB,4488,user_001,,
8a8a5a51-aad3-4ebc-a187-bf3eb64eba52,2031-10-07,2031-10-07,Amazon UK,5942,Shopping,Online Retail,-114.12,GBP,-178144.96,E-Com,London,GB,9074,user_002,,
f8290dee-f866-450f-bd53-670b27d37bb5,2031-10-07,2031-10-08,Local Market,5499,Groceries,Specialty,-12.69,GBP,-178157.65,POS,London,GB,9074,user_001,,
280f57aa-8ffb-4407-9414-df7a428ef010,2031-10-08,2031-10-10,Sainsbury's,5411,Groceries,Supermarket,-32.34,GBP,-178189.99,POS,London,GB,1045,user_002,,
2a2f5f07-30e2-4460-840e-a4a589743984,2031-10-10,2031-10-13,Sainsbury's,5411,Groceries,Supermarket,-57.69,GBP,-178247.68,POS,London,GB,2219,user_001,,
389f0e06-e37a-4747-b23a-e5146b6722cb,2031-10-10,2031-10-13,Uber UK,4121,Transport,Ride Hailing,-10.75,GBP,-178258.43,E-Com,London,GB,1045,user_001,,
539518d9-1824-4e12-9976-9e5bfcdfa44f,2031-10-10,2031-10-13,Waitrose,5411,Groceries,Supermarket,-35.96,GBP,-178294.39,POS,London,GB,4488,user_002,,
a4ba76ee-c3c0-4cba-98e2-7a3a64bce36a,2031-10-10,2031-10-13,Waitrose,5411,Groceries,Supermarket,-27.76,GBP,-178322.15,POS,London,GB,9074,user_001,,
0f9fa4b9-41b0-480c-9dcf-29bf29874e71,2031-10-11,2031-10-13,Uber UK,4121,Transport,Ride Hailing,-22.03,GBP,-178344.18,E-Com,London,GB,9074,user_001,,
b1552190-1137-41a6-b1ba-ca3c86b8131d,2031-10-11,2031-10-13,Uber UK,4121,Transport,Ride Hailing,-11.91,GBP,-178356.09,E-Com,London,GB,1045,user_001,,
d4ab6fb4-e0e3-4bd6-88ad-0ba3f9d36260,2031-10-11,2031-10-13,Pret A Manger,5814,Food & Drink,Eating Out,-9.96,GBP,-178366.05,POS,London,GB,2219,user_001,,
d8621fcd-53a9-43e4-a825-f671e73ce074,2031-10-11,2031-10-13,Pret A Manger,5814,Food & Drink,Eating Out,-7.62,GBP,-178373.67,POS,London,GB,1045,user_001,,
4546c25f-d4c1-49bb-83e0-83f5dac23915,2031-10-12,2031-10-13,Amazon UK,5942,Shopping,Online Retail,-20.16,GBP,-178393.83,E-Com,London,GB,9074,user_002,,
538a5be7-1f31-4f19-a936-ae8a8fad7906,2031-10-12,2031-10-13,Airbnb,7011,Travel,Accommodation,-149.07,USD,-178542.9,E-Com,Dublin,IE,4488,user_001,,Business travel
c923da80-283e-4d0d-9948-18f15f18e578,2031-10-12,2031-10-13,Transport for London,4111,Transport,Transit,-5.16,GBP,-178548.06,POS,London,GB,9074,user_001,,
ec61f4bc-b42e-4e26-9b61-c5d27a935796,2031-10-12,2031-10-13,Amazon UK,5942,Shopping,Online Retail,-71.05,GBP,-178619.11,E-Com,London,GB,9074,user_001,,
ff0e0ecc-72ab-438c-b342-0830622fe0c0,2031-10-12,2031-10-13,Shell,5541,Transport,Fuel,-65.7,GBP,-178684.81,POS,London,GB,1045,user_001,,
5f504823-3e70-4e77-aea2-a9234873d895,2031-10-13,2031-10-13,Uber UK,4121,Transport,Ride Hailing,-13.86,GBP,-178698.67,E-Com,London,GB,1045,user_001,,
66ddc7ae-fa10-4f88-80cc-1dee4fa2501a,2031-10-13,2031-10-13,Sainsbury's,5411,Groceries,Supermarket,-14.19,GBP,-178712.86,POS,London,GB,4488,user_001,,
958c92ba-216a-4f97-8a85-76e7aacfee7c,2031-10-13,2031-10-14,Uber UK,4121,Transport,Ride Hailing,-16.62,GBP,-178729.48,E-Com,London,GB,9074,user_001,,
9cec8d57-6783-41a4-ac63-0b2bbfb9ed63,2031-10-13,2031-10-14,Thames Water,4900,Utilities,Water,-34.47,GBP,-178763.95,Direct Debit,Reading,GB,2219,user_001,rec_3a34d62842,
be5d0a8e-5bf5-4f83-90ef-c5304b8ac00f,2031-10-13,2031-10-15,City Council Tax,9399,Utilities,Council Tax,-160.63,GBP,-178924.58,Direct Debit,London,GB,4488,user_001,rec_f531495db5,
1672aa7d-77bc-4c9b-ab1e-b87c670346a9,2031-10-15,2031-10-17,O2 UK,4814,Bills,Mobile,-50.16,GBP,-178974.74,Direct Debit,Slough,GB,1045,user_001,rec_95042d8101,
5dd0ba77-553a-4dfd-a5ad-7e68e6e02001,2031-10-15,2031-10-15,Shell,5541,Transport,Fuel,-88.22,GBP,-179062.96,POS,London,GB,1045,user_002,,
82062fb6-eef5-4dca-a8df-f719d3f2eace,2031-10-15,2031-10-17,Deliveroo,5812,Food & Drink,Delivery,-30.36,GBP,-179093.32,E-Com,London,GB,4488,user_001,,
a2d3a81c-63c3-49b8-b9b6-1c70e293bbb0,2031-10-15,2031-10-17,Tesco,5411,Groceries,Supermarket,-32.9,GBP,-179126.22,POS,London,GB,1045,user_001,,
c49d4c69-7b99-40b8-a76c-b5ad8fd547cd,2031-10-15,2031-10-16,Apple.com/bill,5734,Shopping,Electronics,-84.27,GBP,-179210.49,E-Com,Cupertino,US,4488,user_001,,
db9dabd9-6559-4191-9f50-3232c2cf0051,2031-10-15,2031-10-16,Shell,5541,Transport,Fuel,-83.93,GBP,-179294.42,POS,London,GB,4488,user_001,,
79b7f673-0de5-4fce-bb5d-e0f1aaa0ab16,2031-10-16,2031-10-16,Shell,5541,Transport,Fuel,-51.39,GBP,-179345.81,POS,London,GB,1045,user_001,,
8ede65fb-2df9-4d07-8960-cb3dd380ea44,2031-10-17,2031-10-20,Amazon UK,5942,Shopping,Online Retail,-45.52,GBP,-179391.33,E-Com,London,GB,9074,user_002,,
c4348d53-73d0-4341-b2ae-470bdab710b3,2031-10-17,2031-10-17,GymBox,7997,Wellness,Gym,-57.35,GBP,-179448.68,Direct Debit,London,GB,9074,user_002,rec_19771e79cd,
a8fe9ea5-1f4c-4876-915a-61e1e2f3749d,2031-10-18,2031-10-20,Deliveroo,5812,Food & Drink,Delivery,-25.55,GBP,-179474.23,E-Com,London,GB,9074,user_001,,
d6929e6c-1e24-4110-bad4-80e0890e46e4,2031-10-18,2031-10-20,Transport for London,4111,Transport,Transit,-4.21,GBP,-179478.44,POS,London,GB,9074,user_001,,
fae8daf4-1b5c-4697-817b-638808e16029,2031-10-18,2031-10-20,Deliveroo,5812,Food & Drink,Delivery,-17.78,GBP,-179496.22,E-Com,London,GB,1045,user_001,,
492faaa4-7508-46b6-afba-072ae38bfe8f,2031-10-19,2031-10-21,Pret A Manger,5814,Food & Drink,Eating Out,-10.52,GBP,-179506.74,POS,London,GB,1045,user_001,,
e8eb022f-43e7-4414-83d3-217145031e38,2031-10-19,2031-10-20,Deliveroo,5812,Food & Drink,Delivery,-12.76,GBP,-179519.5,E-Com,London,GB,1045,user_001,,
f618bf59-67ba-4951-be4c-67b3e9b486fe,2031-10-19,2031-10-21,Uber UK,4121,Transport,Ride Hailing,-16.37,GBP,-179535.87,E-Com,London,GB,2219,user_001,,
3fc0fd92-68d7-4867-92aa-c007432b5269,2031-10-20,2031-10-20,Spotify,5735,Entertainment,Subscriptions,-9.24,GBP,-179545.11,E-Com,Stockholm,SE,4488,user_001,rec_4c746d2c3b,
5b6fe1e5-55db-4342-bf3f-de20bcee2924,2031-10-20,2031-10-21,Apple.com/bill,5734,Shopping,Electronics,-98.96,USD,-179644.07,E-Com,Cupertino,US,1045,user_001,,FX purchase 126.59 USD @ rate 1.28
ec18713f-783c-4553-acda-f0964ca4de2c,2031-10-20,2031-10-22,Sainsbury's,5411,Groceries,Supermarket,-16.26,GBP,-179660.33,POS,London,GB,9074,user_001,,
705929ac-04f0-463f-bab4-4b1c0f8d6811,2031-10-21,2031-10-21,Tesco,5411,Groceries,Supermarket,-40.65,GBP,-179700.98,POS,London,GB,4488,user_001,,
c877f1c3-4d74-4840-88a4-21b8d4998ab6,2031-10-21,2031-10-23,Netflix,7841,Entertainment,Subscriptions,-10.87,GBP,-179711.85,E-Com,Los Gatos,US,1045,user_001,rec_1bfe33738d,
0193beb5-3915-42eb-a8eb-43aff7c6de83,2031-10-22,2031-10-23,Apple.com/bill,5734,Shopping,Electronics,-165.59,GBP,-179877.44,E-Com,Cupertino,US,2219,user_001,,
1fdcda91-a4c0-4f35-8642-2e508dc9b02c,2031-10-22,2031-10-22,Uber UK,4121,Transport,Ride Hailing,-11.95,GBP,-179889.39,E-Com,London,GB,9074,user_001,,
511bf10a-1a14-4624-9442-68ce5e3e5c69,2031-10-22,2031-10-22,Tesco,5411,Groceries,Supermarket,-63.44,GBP,-179952.83,POS,London,GB,9074,user_001,,
ec49237a-c862-4d55-aa6e-66b8dbaef693,2031-10-23,2031-10-23,Local Market,5499,Groceries,Specialty,-18.03,GBP,-179970.86,POS,London,GB,4488,user_001,,
2bea3968-b7f7-40e1-93b2-35b123187bd3,2031-10-24,2031-10-27,Deliveroo,5812,Food & Drink,Delivery,-19.36,GBP,-179990.22,E-Com,London,GB,9074,user_001,,
d5066556-adec-4255-8494-c0753a7f7bc4,2031-10-24,2031-10-24,T212 Capital,6011,Income,Salary,3342.68,GBP,-176647.54,Credit,London,GB,2219,user_001,rec_2ff8f778d0,
8230dbf8-2066-4b9f-926d-a8931d527e9e,2031-10-25,2031-10-27,Apple.com/bill,5734,Shopping,Electronics,-69.11,USD,-176716.65,E-Com,Cupertino,US,2219,user_001,,FX purchase 88.43 USD @ rate 1.28
83be9e49-f45a-4d55-99df-d262761bfc13,2031-10-25,2031-10-27,Tesco,5411,Groceries,Supermarket,-79.64,GBP,-176796.29,POS,London,GB,4488,user_001,,
983ca848-ddc3-4462-a39b-f26df2d5b885,2031-10-25,2031-10-27,Local Market,5499,Groceries,Specialty,-17.16,GBP,-176813.45,POS,London,GB,1045,user_001,,
c012b9d6-53dc-4cf8-a893-0492d0a7ec8d,2031-10-25,2031-10-27,Local Market,5499,Groceries,Specialty,-16.63,GBP,-176830.08,POS,London,GB,2219,user_001,,
09df9705-85db-4b63-9b95-c566e0dc2399,2031-10-26,2031-10-27,Shell,5541,Transport,Fuel,-72.39,GBP,-176902.47,POS,London,GB,9074,user_001,,
59206ca3-8cb7-4f28-97ca-405eba28695b,2031-10-26,2031-10-27,Waitrose,5411,Groceries,Supermarket,-42.46,GBP,-176944.93,POS,London,GB,1045,user_001,,
9954c5c4-3793-477e-b866-78d7457494f7,2031-10-26,2031-10-27,Uber UK,4121,Transport,Ride Hailing,-23.99,GBP,-176968.92,E-Com,London,GB,2219,user_001,,
999bb217-474c-427b-aa2f-df1d009dd363,2031-10-26,2031-10-27,Sainsbury's,5411,Groceries,Supermarket,-42.25,GBP,-177011.17,POS,London,GB,4488,user_001,,
d37e56d1-e3b7-4178-8b7c-a2a1d84add1a,2031-10-26,2031-10-27,Transport for London,4111,Transport,Transit,-7.76,GBP,-177018.93,POS,London,GB,2219,user_002,,
6f5fc711-93c8-43cb-8d74-b3fed691c417,2031-10-28,2031-10-29,Shell,5541,Transport,Fuel,-86.43,GBP,-177105.36,POS,London,GB,2219,user_001,,
8abf0c1f-3e77-4940-adb3-2cdf58e3015a,2031-10-28,2031-10-29,Apple.com/bill,5734,Shopping,Electronics,-180.89,USD,-177286.25,E-Com,Cupertino,US,4488,user_001,,FX purchase 222.56 USD @ rate 1.23
be80d622-9e08-4e9a-bf3e-92de0e2352cb,2031-10-29,2031-10-29,Sainsbury's,5411,Groceries,Supermarket,-27.94,GBP,-177314.19,POS,London,GB,9074,user_001,,
29f4114d-0fa6-4310-af36-3434fdfb7a55,2031-10-30,2031-10-30,Shell,5541,Transport,Fuel,-87.78,GBP,-177401.97,POS,London,GB,9074,user_002,,
a2a1620d-83f3-4383-80bd-1fe09b45a2cf,2031-10-30,2031-10-31,Tesco,5411,Groceries,Supermarket,-18.54,GBP,-177420.51,POS,London,GB,2219,user_002,,
086c9bf9-a41a-4c12-ada2-2a61ba072a3e,2031-10-31,2031-11-03,Tesco,5411,Groceries,Supermarket,-40.51,GBP,-177461.02,POS,London,GB,2219,user_001,,
54fd5cac-0029-495e-865a-520e59b9bca2,2031-10-31,2031-11-03,Waitrose,5411,Groceries,Supermarket,-80.29,GBP,-177541.31,POS,London,GB,4488,user_001,,
3e1f1f93-5725-4f49-a24a-0bab427d75a4,2031-11-01,2031-11-03,Transport for London,4111,Transport,Transit,-4.89,GBP,-177546.2,POS,London,GB,2219,user_001,,
6b2dcf0e-e18f-4627-862d-353f0fb9a03f,2031-11-01,2031-11-03,Local Market,5499,Groceries,Specialty,-9.89,GBP,-177556.09,POS,London,GB,1045,user_001,,
7424ceeb-e8cb-4dcf-af01-9b3641ce8cc6,2031-11-01,2031-11-03,Shell,5541,Transport,Fuel,-56.63,GBP,-177612.72,POS,London,GB,9074,user_001,,
d3bc8290-7359-4f6c-b828-140653de052f,2031-11-01,2031-11-03,Transport for London,4111,Transport,Transit,-5.16,GBP,-177617.88,POS,London,GB,2219,user_002,,
dcb23a09-ae16-4f4a-b170-904a53cf9a8c,2031-11-01,2031-11-03,Waitrose,5411,Groceries,Supermarket,-51.67,GBP,-177669.55,POS,London,GB,1045,user_001,,
817bd264-5d83-461d-aa18-946e7a37fb4c,2031-11-02,2031-11-04,Waitrose,5411,Groceries,Supermarket,-73.72,GBP,-177743.27,POS,London,GB,9074,user_001,,
9dd75539-1063-4015-b28f-c93fdf8c3563,2031-11-02,2031-11-04,Uber UK,4121,Transport,Ride Hailing,-10.36,GBP,-177753.63,E-Com,London,GB,4488,user_001,,
245a1c98-db39-43ff-9aa9-36a901a37d8b,2031-11-03,2031-11-04,Apple.com/bill,5734,Shopping,Electronics,-124.79,GBP,-177878.42,E-Com,Cupertino,US,1045,user_002,,
7fecf351-4134-4e24-9269-b34f5cbae506,2031-11-03,2031-11-04,Crown Estates Lettings,6513,Housing,Rent,-1562.16,GBP,-179440.58,POS,London,GB,4488,user_001,rec_19f70fbcce,
d3e57b2a-d382-4d11-833b-78b9d7057fc3,2031-11-04,2031-11-06,Pret A Manger,5814,Food & Drink,Eating Out,-10.63,GBP,-179451.21,POS,London,GB,9074,user_001,,
060d296e-1dc7-4125-9e14-02b30d695ef7,2031-11-05,2031-11-05,Shell,5541,Transport,Fuel,-62.4,GBP,-179513.61,POS,London,GB,1045,user_001,,
2b0d1ca5-69f1-4172-87cd-a7153707fe4f,2031-11-05,2031-11-07,Deliveroo,5812,Food & Drink,Delivery,-17.42,GBP,-179531.03,E-Com,London,GB,4488,user_002,,
affc7454-3a1c-4d56-bc0c-47128d27438b,2031-11-06,2031-11-07,Waitrose,5411,Groceries,Supermarket,-44.58,GBP,-179575.61,POS,London,GB,2219,user_001,,
b7f50555-50a7-48e6-98e1-aea9c429c743,2031-11-06,2031-11-06,Sainsbury's,5411,Groceries,Supermarket,-52.47,GBP,-179628.08,POS,London,GB,4488,user_001,,
c328fa16-86e5-415d-b142-cf5efcb78af1,2031-11-06,2031-11-06,Transport for London,4111,Transport,Transit,-7.75,GBP,-179635.83,POS,London,GB,4488,user_001,,
e3521007-8c92-43e3-b095-8b073bdfc7bf,2031-11-06,2031-11-06,Tesco,5411,Groceries,Supermarket,-67.95,GBP,-179703.78,POS,London,GB,4488,user_001,,
34b9c4f2-e12b-4167-97dd-e4a82f5526a7,2031-11-07,2031-11-07,Octopus Energy,4900,Utilities,Electricity,-134.45,GBP,-179838.23,Direct Debit,London,GB,9074,user_002,rec_09c3f12b18,
b9ef5095-a6be-4eb3-b07e-44dd8eef0600,2031-11-07,2031-11-10,ATM Withdrawal,6011,Cash,ATM,-101.87,GBP,-179940.1,ATM,London,GB,9074,user_001,,
11b93279-e919-4366-9272-833c4ab42226,2031-11-08,2031-11-10,Deliveroo,5812,Food & Drink,Delivery,-28.22,GBP,-179968.32,E-Com,London,GB,4488,user_001,,
2017df40-7c57-4728-bb63-d7f454338c9c,2031-11-08,2031-11-10,Pret A Manger,5814,Food & Drink,Eating Out,-7.54,GBP,-179975.86,POS,London,GB,9074,user_001,,
47bae65f-aa79-434b-a211-bb6c55c56d93,2031-11-08,2031-11-10,Deliveroo,5812,Food & Drink,Delivery,-32.94,GBP,-180008.8,E-Com,London,GB,4488,user_001,,
5399fe7f-3081-409c-a9c4-c28e240e839d,2031-11-08,2031-11-10,Waitrose,5411,Groceries,Supermarket,-53.34,GBP,-180062.14,POS,London,GB,2219,user_001,,
66f4e694-dc84-4bbf-a1ae-fe8865ab3d20,2031-11-08,2031-11-10,Amazon UK,5942,Shopping,Online Retail,-67.88,GBP,-180130.02,E-Com,London,GB,2219,user_001,,
d62886d1-0a82-4472-9023-6ba918a81baf,2031-11-08,2031-11-10,Waitrose,5411,Groceries,Supermarket,-21.7,GBP,-180151.72,POS,London,GB,9074,user_002,,
b1ca1a36-db4b-4d7a-b2a8-0500be7b0be4,2031-11-09,2031-11-10,Waitrose,5411,Groceries,Supermarket,-75.38,GBP,-180227.1,POS,London,GB,4488,user_001,,
e2fda31e-1c0b-4571-9288-bf93b778aa18,2031-11-09,2031-11-11,Deliveroo,5812,Food & Drink,Delivery,-30.75,GBP,-180257.85,E-Com,London,GB,9074,user_001,,
094201b2-4ce6-4c30-9d52-cceb8142058d,2031-11-10,2031-11-11,Transport for London,4111,Transport,Transit,-8.66,GBP,-180266.51,POS,London,GB,9074,user_001,,
f02dc93b-278c-4172-8605-df1ee56b3ee6,2031-11-10,2031-11-10,Amazon UK,5942,Shopping,Online Retail,-70.02,GBP,-180336.53,E-Com,London,GB,1045,user_002,,
ce426283-b5f0-4880-bc98-480fd95eb133,2031-11-11,2031-11-11,Thames Water,4900,Utilities,Water,-34.28,GBP,-180370.81,Direct Debit,Reading,GB,1045,user_002,rec_954d02400c,
e4baa8c3-b50c-4649-85c0-07b3713174bb,2031-11-11,2031-11-12,Sainsbury's,5411,Groceries,Supermarket,-67.28,GBP,-180438.09,POS,London,GB,2219,user_001,,
59c4c1f7-0575-4456-8db6-094831747233,2031-11-12,2031-11-14,Pret A Manger,5814,Food & Drink,Eating Out,-8.68,GBP,-180446.77,POS,London,GB,2219,user_001,,
8681646e-f23e-4a2b-bfea-8cd21aa2285d,2031-11-13,2031-11-17,Uber UK,4121,Transport,Ride Hailing,-13.49,GBP,-180460.26,E-Com,London,GB,9074,user_002,,
ce0b1e93-dee8-419a-9b4f-d54984bbf0fb,2031-11-13,2031-11-17,City Council Tax,9399,Utilities,Council Tax,-157.92,GBP,-180618.18,Direct Debit,London,GB,4488,user_001,rec_f531495db5,
f8d9c334-15b5-42ad-a857-d722e444c180,2031-11-13,2031-11-17,Shell,5541,Transport,Fuel,-40.62,GBP,-180658.8,POS,London,GB,9074,user_001,,
a943c8a2-2c9d-4692-bbb9-2b769f34fdbe,2031-11-14,2031-11-14,Transport for London,4111,Transport,Transit,-5.64,GBP,-180664.44,POS,London,GB,4488,user_002,,
e5f2ca9e-03c0-4a0e-9b26-5a9959831baf,2031-11-14,2031-11-17,Shell,5541,Transport,Fuel,-45.98,GBP,-180710.42,POS,London,GB,9074,user_001,,
018de56a-067c-4c32-8060-7621bf80185b,2031-11-15,2031-11-17,Uber UK,4121,Transport,Ride Hailing,-20.36,GBP,-180730.78,E-Com,London,GB,9074,user_001,,
21d4d175-1f2e-4c4c-a46b-daa314bd5263,2031-11-15,2031-11-17,Amazon UK,5942,Shopping,Online Retail,-22.94,GBP,-180753.72,E-Com,London,GB,9074,user_001,,
319b6c00-ad65-454f-af54-9d6abdd0b1d8,2031-11-15,2031-11-17,Uber UK,4121,Transport,Ride Hailing,-22.62,GBP,-180776.34,E-Com,London,GB,4488,user_002,,
810e74d1-f541-4ec0-9359-ebf3446a2dbb,2031-11-15,2031-11-17,Amazon UK,5942,Shopping,Online Retail,-45.18,GBP,-180821.52,E-Com,London,GB,4488,user_001,,
1aff29d2-d337-4cc3-9bc8-121929a7d4b4,2031-11-16,2031-11-17,Waitrose,5411,Groceries,Supermarket,-43.21,GBP,-180864.73,POS,London,GB,1045,user_001,,
280b9f69-fb78-4e57-9861-3436f7667794,2031-11-16,2031-11-17,Waitrose,5411,Groceries,Supermarket,-50.42,GBP,-180915.15,POS,London,GB,9074,user_001,,
7d86417c-0a58-44be-b6f3-f1e77099e02f,2031-11-16,2031-11-17,Waitrose,5411,Groceries,Supermarket,-67.43,GBP,-180982.58,POS,London,GB,1045,user_001,,
afa0cd91-3b37-462b-93a5-8b1a4d5ea16e,2031-11-16,2031-11-17,Local Market,5499,Groceries,Specialty,-15.03,GBP,-180997.61,POS,London,GB,1045,user_001,,
cb521afb-fc9b-491f-864b-ad1166050825,2031-11-16,2031-11-17,Waitrose,5411,Groceries,Supermarket,-62.68,GBP,-181060.29,POS,London,GB,4488,user_001,,
4c6f9acf-62eb-4652-95d5-6b3022e17fb7,2031-11-17,2031-11-19,O2 UK,4814,Bills,Mobile,-53.42,GBP,-181113.71,Direct Debit,Slough,GB,1045,user_001,rec_95042d8101,
c524be34-cb08-4f12-aa54-f49bfece9367,2031-11-17,2031-11-17,Sainsbury's,5411,Groceries,Supermarket,-63.83,GBP,-181177.54,POS,London,GB,9074,user_001,,
c6a344a1-c064-4dd1-abbf-67f33c01c1ec,2031-11-17,2031-11-19,Tesco,5411,Groceries,Supermarket,-40.29,GBP,-181217.83,POS,London,GB,2219,user_001,,
e342bc8a-79f0-42f1-826f-95675c14fb73,2031-11-17,2031-11-17,GymBox,7997,Wellness,Gym,-48.37,GBP,-181266.2,Direct Debit,London,GB,4488,user_001,rec_3906953fd2,
35701b07-2c9c-48d3-a48f-8b6a53cb09d0,2031-11-18,2031-11-20,Waitrose,5411,Groceries,Supermarket,-27.73,GBP,-181293.93,POS,London,GB,4488,user_001,,
ab919b20-4347-481c-9fa4-9ccb5358b44e,2031-11-18,2031-11-18,Deliveroo,5812,Food & Drink,Delivery,-15.84,GBP,-181309.77,E-Com,London,GB,2219,user_001,,
0cfdb1dd-cc75-442c-99b1-07645401740e,2031-11-19,2031-11-20,Shell,5541,Transport,Fuel,-92.57,GBP,-181402.34,POS,London,GB,2219,user_001,,
338a29b7-e904-4a42-b3f0-36f9a7e6bb8b,2031-11-19,2031-11-19,Spotify,5735,Entertainment,Subscriptions,-8.38,GBP,-181410.72,E-Com,Stockholm,SE,9074,user_001,rec_4c746d2c3b,
32281646-1f69-4402-8b95-07d6b4812dd5,2031-11-20,2031-11-24,Airbnb,7011,Travel,Accommodation,-293.45,USD,-181704.17,E-Com,Dublin,IE,1045,user_001,,Holiday booking
8331580b-f5a2-4df0-a26b-df32c332fcb5,2031-11-21,2031-11-24,Netflix,7841,Entertainment,Subscriptions,-14.7,USD,-181718.87,E-Com,Los Gatos,US,9074,user_001,rec_1bfe33738d,FX purchase 17.99 USD @ rate 1.22
db084ab0-3f2f-49d0-981d-707b93ec3894,2031-11-21,2031-11-24,Transport for London,4111,Transport,Transit,-11.7,GBP,-181730.57,POS,London,GB,9074,user_001,,
5a5aad91-e368-4853-9500-fdeba48b12bd,2031-11-22,2031-11-24,Tesco,5411,Groceries,Supermarket,-53.56,GBP,-181784.13,POS,London,GB,1045,user_001,,
89f0bbdc-6840-45e4-bddb-d0fc99d6650a,2031-11-22,2031-11-24,Transport for London,4111,Transport,Transit,-10.84,GBP,-181794.97,POS,London,GB,2219,user_001,,
b2a8d5d6-b49d-48b4-a62c-7f66955d6462,2031-11-22,2031-11-24,Sainsbury's,5411,Groceries,Supermarket,-35.27,GBP,-181830.24,POS,London,GB,9074,user_001,,
c8da019e-2ea3-4f65-b47c-1f418d98e81c,2031-11-22,2031-11-24,Tesco,5411,Groceries,Supermarket,-83.86,GBP,-181914.1,POS,London,GB,2219,user_001,,
119a888e-1718-4666-8757-f8ce56ef88e2,2031-11-23,2031-11-24,Amazon UK,5942,Shopping,Online Retail,-111.07,GBP,-182025.17,E-Com,London,GB,9074,user_001,,
59bf5bee-6ab5-464f-8ea5-35af2bf0047b,2031-11-23,2031-11-24,Local Market,5499,Groceries,Specialty,-13.63,GBP,-182038.8,POS,London,GB,9074,user_001,,
153c5708-169e-4f35-ba24-71c897a69651,2031-11-25,2031-11-26,Pret A Manger,5814,Food & Drink,Eating Out,-8.66,GBP,-182047.46,POS,London,GB,4488,user_001,,
86f42aa1-b189-44ea-afe8-ac17ebc191fd,2031-11-25,2031-11-26,Tesco,5411,Groceries,Supermarket,-72.63,GBP,-182120.09,POS,London,GB,2219,user_001,,
b994b88e-30c5-4d64-9fdc-911cb38c2ced,2031-11-25,2031-11-25,T212 Capital,6011,Income,Salary,3271.58,GBP,-178848.51,Credit,London,GB,9074,user_001,rec_2ff8f778d0,
e49c342e-652d-49d1-a722-6769b46dbec2,2031-11-26,2031-11-28,Shell,5541,Transport,Fuel,-50.43,GBP,-178898.94,POS,London,GB,2219,user_001,,
17e4652c-0a93-4c5f-85cb-524eaacec1a5,2031-11-27,2031-12-01,Pret A Manger,5814,Food & Drink,Eating Out,-9.34,GBP,-178908.28,POS,London,GB,2219,user_002,,
36ab18bf-ba99-40e5-a36b-03166cbdecf2,2031-11-29,2031-12-01,Shell,5541,Transport,Fuel,-90.83,GBP,-178999.11,POS,London,GB,1045,user_001,,
4348aee1-6c3d-4a07-9925-f42fbcac29fe,2031-11-29,2031-12-01,Shell,5541,Transport,Fuel,-46.45,GBP,-179045.56,POS,London,GB,4488,user_001,,
e76c6b95-4ef2-4ef8-877b-e96fdffdf664,2031-11-29,2031-12-01,Uber UK,4121,Transport,Ride Hailing,-30.06,GBP,-179075.62,E-Com,London,GB,2219,user_001,,
288adb74-cd78-42f5-ace0-6745e73ac8b8,2031-11-30,2031-12-01,Transport for London,4111,Transport,Transit,-6.82,GBP,-179082.44,POS,London,GB,9074,user_001,,
38d95ddf-0922-43ed-ac1f-a4b31c376f78,2031-11-30,2031-12-02,Deliveroo,5812,Food & Drink,Delivery,-13.43,GBP,-179095.87,E-Com,London,GB,1045,user_001,,
45ef4720-b535-4093-a1f6-a319d8d3c6d4,2031-11-30,2031-12-02,Shell,5541,Transport,Fuel,-70.82,GBP,-179166.69,POS,London,GB,4488,user_001,,
b9769f94-5588-4910-9a8e-33b7734bf7ab,2031-11-30,2031-12-02,Sainsbury's,5411,Groceries,Supermarket,-39.81,GBP,-179206.5,POS,London,GB,9074,user_001,,
92cf7653-226b-4d24-97db-e61a78822e97,2031-12-01,2031-12-02,Crown Estates Lettings,6513,Housing,Rent,-1507.07,GBP,-180713.57,POS,London,GB,2219,user_001,rec_19f70fbcce,
a08e156c-432d-4552-8059-5df9148cda71,2031-12-01,2031-12-03,Uber UK,4121,Transport,Ride Hailing,-14.85,GBP,-180728.42,E-Com,London,GB,2219,user_002,,
329dd7c4-e91e-400d-8245-d44e62b26710,2031-12-04,2031-12-08,Sainsbury's,5411,Groceries,Supermarket,-58.58,GBP,-180787.0,POS,London,GB,4488,user_001,,
46bc1948-1eaa-459e-aba7-8141369ae955,2031-12-04,2031-12-05,Local Market,5499,Groceries,Specialty,-21.04,GBP,-180808.04,POS,London,GB,9074,user_001,,
ed06c674-f498-4195-918f-1822d76e7195,2031-12-04,2031-12-08,Shell,5541,Transport,Fuel,-51.39,GBP,-180859.43,POS,London,GB,1045,user_001,,
f8d93a63-35f4-4eb8-ac78-f1501953e60c,2031-12-04,2031-12-05,Pret A Manger,5814,Food & Drink,Eating Out,-6.86,GBP,-180866.29,POS,London,GB,9074,user_001,,
045f6d8f-77fe-4a7e-8172-9ba8419e80b7,2031-12-06,2031-12-08,Waitrose,5411,Groceries,Supermarket,-23.73,GBP,-180890.02,POS,London,GB,4488,user_001,,
84803f7b-1ac5-481e-aae6-fed22bf81527,2031-12-06,2031-12-08,Pret A Manger,5814,Food & Drink,Eating Out,-5.81,GBP,-180895.83,POS,London,GB,2219,user_001,,
ec9b0f6b-4131-40cb-86a6-fa19035f6c8f,2031-12-06,2031-12-08,Shell,5541,Transport,Fuel,-34.39,GBP,-180930.22,POS,London,GB,2219,user_001,,
39ff91de-e2d4-45b5-9b7f-8431a5c6091a,2031-12-07,2031-12-08,Transport for London,4111,Transport,Transit,-8.62,GBP,-180938.84,POS,London,GB,4488,user_001,,
736d61b5-2f61-47bc-970c-0637c3777326,2031-12-07,2031-12-08,Apple.com/bill,5734,Shopping,Electronics,-131.09,GBP,-181069.93,E-Com,Cupertino,US,4488,user_001,,
b51f81b5-0151-416c-b5d9-17525fad0b96,2031-12-07,2031-12-08,Deliveroo,5812,Food & Drink,Delivery,-22.05,GBP,-181091.98,E-Com,London,GB,1045,user_001,,
d7ea0f79-9046-41d9-891f-f18372e3ccdb,2031-12-07,2031-12-09,Uber UK,4121,Transport,Ride Hailing,-22.66,GBP,-181114.64,E-Com,London,GB,9074,user_001,,
eec49b0f-b007-4cd2-9f44-cd8223db6610,2031-12-07,2031-12-08,Pret A Manger,5814,Food & Drink,Eating Out,-11.99,GBP,-181126.63,POS,London,GB,9074,user_001,,
06722f66-9a04-4725-8fb9-9dc1fe2a3576,2031-12-08,2031-12-10,Waitrose,5411,Groceries,Supermarket,-48.36,GBP,-181174.99,POS,London,GB,2219,user_001,,
3c9166eb-2221-4849-a29e-caf33d4420b3,2031-12-08,2031-12-09,Octopus Energy,4900,Utilities,Electricity,-133.39,GBP,-181308.38,Direct Debit,London,GB,9074,user_001,rec_141a4a0666,
51b19d85-cf37-49a0-b3bd-edfc238d6898,2031-12-08,2031-12-10,Shell,5541,Transport,Fuel,-92.36,GBP,-181400.74,POS,London,GB,9074,user_001,,
a58843e5-f153-4980-a00e-5cd93d7cf127,2031-12-08,2031-12-10,Apple.com/bill,5734,Shopping,Electronics,-59.72,GBP,-181460.46,E-Com,Cupertino,US,1045,user_001,,
39a85af6-5a70-482f-8531-8d565d0b0620,2031-12-09,2031-12-09,Apple.com/bill,5734,Shopping,Electronics,-203.48,GBP,-181663.94,E-Com,Cupertino,US,2219,user_001,,
64dc483b-bd44-458e-892e-73df6e553594,2031-12-10,2031-12-12,Apple.com/bill,5734,Shopping,Electronics,-97.19,GBP,-181761.13,E-Com,Cupertino,US,4488,user_001,,
6c7ca762-cfd6-4ddc-a42a-97f76460fd7c,2031-12-10,2031-12-10,Tesco,5411,Groceries,Supermarket,-18.76,GBP,-181779.89,POS,London,GB,2219,user_001,,
d1db066b-71fc-4635-8601-b685b8bacf43,2031-12-11,2031-12-12,Thames Water,4900,Utilities,Water,-40.9,GBP,-181820.79,Direct Debit,Reading,GB,4488,user_001,rec_3a34d62842,
2550761b-76ac-4265-b61c-5eef95b2d24e,2031-12-12,2031-12-15,Sainsbury's,5411,Groceries,Supermarket,-43.0,GBP,-181863.79,POS,London,GB,2219,user_001,,
b03d18df-6c6e-4ce3-a497-5d99443191b8,2031-12-12,2031-12-15,Apple.com/bill,5734,Shopping,Electronics,-110.03,GBP,-181973.82,E-Com,Cupertino,US,4488,user_001,,
f5f1a597-b304-4707-94ab-5a9cb267248d,2031-12-12,2031-12-15,Apple.com/bill,5734,Shopping,Electronics,-19.78,USD,-181993.6,E-Com,Cupertino,US,4488,user_001,,FX purchase 24.27 USD @ rate 1.23
f87f2f5f-1748-4137-8408-21b9ff162f12,2031-12-12,2031-12-12,Waitrose,5411,Groceries,Supermarket,-88.8,GBP,-182082.4,POS,London,GB,2219,user_001,,
5a4ccbd9-63ae-452d-a82a-4b12c8cfdbbc,2031-12-13,2031-12-15,Shell,5541,Transport,Fuel,-68.14,GBP,-182150.54,POS,London,GB,4488,user_001,,
73c0515c-07fd-468e-8ffe-a78d63fd1203,2031-12-13,2031-12-15,Transport for London,4111,Transport,Transit,-8.53,GBP,-182159.07,POS,London,GB,1045,user_001,,
a634ebf7-3f88-4d16-b3fb-3176666d56a7,2031-12-13,2031-12-15,Shell,5541,Transport,Fuel,-73.88,GBP,-182232.95,POS,London,GB,9074,user_001,,
c45f1904-ea99-4680-b43a-24013c710b01,2031-12-13,2031-12-15,Sainsbury's,5411,Groceries,Supermarket,-29.38,GBP,-182262.33,POS,London,GB,2219,user_001,,
ccbda308-adb8-4054-af34-48c66ea8b5bb,2031-12-13,2031-12-15,Local Market,5499,Groceries,Specialty,-16.52,GBP,-182278.85,POS,London,GB,1045,user_001,,
d71e6a92-6187-4d6b-ae14-153929b18b29,2031-12-13,2031-12-15,Shell,5541,Transport,Fuel,-84.31,GBP,-182363.16,POS,London,GB,1045,user_001,,
250b272d-a544-4591-a651-9e4b309b5367,2031-12-14,2031-12-15,Local Market,5499,Groceries,Specialty,-10.29,GBP,-182373.45,POS,London,GB,9074,user_002,,
9e6c5a57-3fcd-49e9-9d4c-8008d1e24299,2031-12-15,2031-12-16,Local Market,5499,Groceries,Specialty,-12.8,GBP,-182386.25,POS,London,GB,1045,user_002,,
a2f565ac-c23f-45ef-9c4e-465460332140,2031-12-15,2031-12-15,City Council Tax,9399,Utilities,Council Tax,-169.92,GBP,-182556.17,Direct Debit,London,GB,1045,user_001,rec_f531495db5,
a39b1489-27f9-4fbc-a5a3-98a773aa733f,2031-12-15,2031-12-16,Shell,5541,Transport,Fuel,-52.4,GBP,-182608.57,POS,London,GB,4488,user_001,,
c05ad82a-b781-4275-94ce-54746fb9ef63,2031-12-15,2031-12-16,O2 UK,4814,Bills,Mobile,-52.78,GBP,-182661.35,Direct Debit,Slough,GB,4488,user_001,rec_95042d8101,
d045cb40-4f91-4371-92d0-f230c344c289,2031-12-15,2031-12-15,Transport for London,4111,Transport,Transit,-9.86,GBP,-182671.21,POS,London,GB,9074,user_001,,
2a224ee6-f8b3-4c3c-bba9-cb597ef1ade9,2031-12-16,2031-12-18,Pret A Manger,5814,Food & Drink,Eating Out,-11.68,GBP,-182682.89,POS,London,GB,2219,user_002,,
bbfc4d80-ff07-485e-a364-09689ebfd7d7,2031-12-16,2031-12-16,Uber UK,4121,Transport,Ride Hailing,-35.14,GBP,-182718.03,E-Com,London,GB,4488,user_001,,
01cf6b0b-e03e-46ef-a25d-18ce48cdbc7b,2031-12-17,2031-12-17,Airline Refund,4511,Travel,Refund,27.2,GBP,-182690.83,Credit,London,GB,1045,user_001,,Refund for Uber UK
e6cf5013-02e5-4966-a7a8-079d1f68e610,2031-12-17,2031-12-19,Pret A Manger,5814,Food & Drink,Eating Out,-10.88,GBP,-182701.71,POS,London,GB,1045,user_002,,
ebdf0a7f-b7bd-4349-9408-62b993279c3c,2031-12-17,2031-12-18,GymBox,7997,Wellness,Gym,-52.05,GBP,-182753.76,Direct Debit,London,GB,2219,user_001,rec_3906953fd2,
eeaf48e7-26d9-4f6d-8bfc-892aba668f37,2031-12-17,2031-12-17,Amazon UK,5942,Shopping,Online Retail,-21.99,GBP,-182775.75,E-Com,London,GB,2219,user_001,,
374368fb-cc7c-43a3-8707-626796ff2d0a,2031-12-19,2031-12-19,Spotify,5735,Entertainment,Subscriptions,-9.68,GBP,-182785.43,E-Com,Stockholm,SE,4488,user_001,rec_4c746d2c3b,
99ec8a39-dae0-449d-b76f-3cff41295419,2031-12-19,2031-12-22,Tesco,5411,Groceries,Supermarket,-45.33,GBP,-182830.76,POS,London,GB,2219,user_001,,
f112b5bd-3922-46df-91d6-6c7656a6d838,2031-12-19,2031-12-22,Transport for London,4111,Transport,Transit,-9.82,GBP,-182840.58,POS,London,GB,9074,user_002,,
4f82ada5-ea35-4b99-a95d-d449b7dcb548,2031-12-20,2031-12-22,Apple.com/bill,5734,Shopping,Electronics,-126.34,GBP,-182966.92,E-Com,Cupertino,US,1045,user_001,,
bd301e2b-085b-4226-8c4b-90102c9251fe,2031-12-20,2031-12-22,Uber UK,4121,Transport,Ride Hailing,-18.32,GBP,-182985.24,E-Com,London,GB,2219,user_001,,
c14ac0ca-5a25-4c00-b1b4-1c01d05ab127,2031-12-20,2031-12-22,Apple.com/bill,5734,Shopping,Electronics,-70.91,GBP,-183056.15,E-Com,Cupertino,US,1045,user_001,,
cd0dcce4-c08d-467e-9488-a6dab10bf4f2,2031-12-20,2031-12-22,Sainsbury's,5411,Groceries,Supermarket,-28.17,GBP,-183084.32,POS,London,GB,9074,user_001,,
10e4c02e-cd1a-49dd-aba1-31ae6f488936,2031-12-21,2031-12-22,Deliveroo,5812,Food & Drink,Delivery,-28.56,GBP,-183112.88,E-Com,London,GB,1045,user_002,,
1c18c9a5-c8f7-4f27-9fa5-3a1096136b98,2031-12-21,2031-12-22,Apple.com/bill,5734,Shopping,Electronics,-201.39,USD,-183314.27,E-Com,Cupertino,US,9074,user_002,,FX purchase 246.79 USD @ rate 1.23
54a2a6f9-174c-45cd-a7a5-5b3840c2ef1d,2031-12-21,2031-12-22,Deliveroo,5812,Food & Drink,Delivery,-22.47,GBP,-183336.74,E-Com,London,GB,2219,user_002,,
8ae1b593-9da9-4e4f-a423-550a2e2e6168,2031-12-21,2031-12-22,Deliveroo,5812,Food & Drink,Delivery,-18.14,GBP,-183354.88,E-Com,London,GB,1045,user_001,,
97cff5ec-b470-4c81-a979-ee685ba05e0b,2031-12-21,2031-12-22,Amazon UK,5942,Shopping,Online Retail,-113.09,GBP,-183467.97,E-Com,London,GB,1045,user_001,,
d8699f35-feb5-4e5e-8fde-df73f559d696,2031-12-21,2031-12-23,Transport for London,4111,Transport,Transit,-9.24,GBP,-183477.21,POS,London,GB,2219,user_001,,
391e2e2f-8b3f-4229-a714-d3973d14323f,2031-12-22,2031-12-22,Pret A Manger,5814,Food & Drink,Eating Out,-5.85,GBP,-183483.06,POS,London,GB,4488,user_001,,
7c9be541-8155-4f9b-8a21-665b73bdadfb,2031-12-22,2031-12-22,Netflix,7841,Entertainment,Subscriptions,-13.83,GBP,-183496.89,E-Com,Los Gatos,US,4488,user_001,rec_1bfe33738d,
a403bf24-296a-4a9a-9ac0-7813d3efb4eb,2031-12-22,2031-12-24,Waitrose,5411,Groceries,Supermarket,-53.06,GBP,-183549.95,POS,London,GB,4488,user_001,,
f160d625-2116-4778-96b3-1d53093d706c,2031-12-24,2031-12-24,Uber UK,4121,Transport,Ride Hailing,-20.53,GBP,-183570.48,E-Com,London,GB,4488,user_001,,
72f16212-de13-4774-b5b6-b8648b613e06,2031-12-25,2031-12-29,Local Market,5499,Groceries,Specialty,-6.09,GBP,-183576.57,POS,London,GB,4488,user_002,,
9256957f-4834-44d2-9da6-30cf64cbee3e,2031-12-25,2031-12-25,T212 Capital,6011,Income,Salary,3216.88,GBP,-180359.69,Credit,London,GB,2219,user_001,rec_2ff8f778d0,
2ca59031-8d9e-479d-821d-f788868c90c4,2031-12-27,2031-12-29,Local Market,5499,Groceries,Specialty,-6.6,GBP,-180366.29,POS,London,GB,1045,user_001,,
5b90b12e-f49a-432b-9749-7a9c1ffdcce4,2031-12-27,2031-12-29,Uber UK,4121,Transport,Ride Hailing,-8.51,GBP,-180374.8,E-Com,London,GB,4488,user_002,,
6066cdbe-967e-43fe-a14c-71ea01097e6d,2031-12-27,2031-12-29,Deliveroo,5812,Food & Drink,Delivery,-26.2,GBP,-180401.0,E-Com,London,GB,2219,user_001,,
c0a37bb6-a6a5-40d1-bce6-f58f9e08daac,2031-12-27,2031-12-29,Uber UK,4121,Transport,Ride Hailing,-26.1,GBP,-180427.1,E-Com,London,GB,2219,user_001,,
ddca050f-f8bf-42d4-83a0-e2bb501a32c0,2031-12-27,2031-12-29,Tesco,5411,Groceries,Supermarket,-18.58,GBP,-180445.68,POS,London,GB,9074,user_001,,
5786fa92-a1ec-4f5d-b53c-6d7fc1488b45,2031-12-28,2031-12-30,Apple.com/bill,5734,Shopping,Electronics,-88.2,GBP,-180533.88,E-Com,Cupertino,US,1045,user_002,,
60404f8e-7012-4ce4-96b5-2970b26c70dc,2031-12-28,2031-12-30,Apple.com/bill,5734,Shopping,Electronics,-84.48,GBP,-180618.36,E-Com,Cupertino,US,2219,user_001,,
ee7d40a4-28ae-4582-a70e-edf9581af2f2,2031-12-28,2031-12-29,Shell,5541,Transport,Fuel,-67.87,GBP,-180686.23,POS,London,GB,2219,user_001,,
a2e79a75-ef2d-4c93-8f3d-7642460314c3,2031-12-29,2031-12-31,Local Market,5499,Groceries,Specialty,-7.17,GBP,-180693.4,POS,London,GB,2219,user_001,,
c5bea74e-d41c-4b58-b644-7273dbc45cac,2031-12-29,2031-12-31,Shell,5541,Transport,Fuel,-46.42,GBP,-180739.82,POS,London,GB,2219,user_001,,
33724934-3c6e-4cff-af58-e6c7f61de2cb,2031-12-30,2032-01-01,Tesco,5411,Groceries,Supermarket,-67.5,GBP,-180807.32,POS,London,GB,1045,user_002,,
a5b917fe-3f7e-4934-b77b-b999ec50ed2f,2031-12-30,2031-12-31,Shell,5541,Transport,Fuel,-68.27,GBP,-180875.59,POS,London,GB,9074,user_001,,
62280c8b-7a41-45a1-9c77-4414a573c379,2031-12-31,2031-12-31,Sainsbury's,5411,Groceries,Supermarket,-44.4,GBP,-180919.99,POS,London,GB,1045,user_001,,
640f95ee-a399-4a07-9c25-993e709c3daa,2032-01-01,2032-01-02,Tesco,5411,Groceries,Supermarket,-46.09,GBP,-180966.08,POS,London,GB,1045,user_001,,
a8bb502c-2249-48b6-978e-32538be78e03,2032-01-01,2032-01-02,Amazon UK,5942,Shopping,Online Retail,-66.42,GBP,-181032.5,E-Com,London,GB,9074,user_001,,
eade236e-2d9d-40fd-8810-44b583712611,2032-01-01,2032-01-01,Crown Estates Lettings,6513,Housing,Rent,-1624.39,GBP,-182656.89,POS,London,GB,9074,user_002,rec_fc2ae06846,
855c05c1-d98d-4107-aea9-0783a61d2894,2032-01-02,2032-01-05,Pret A Manger,5814,Food & Drink,Eating Out,-7.86,GBP,-182664.75,POS,London,GB,2219,user_001,,
09dcc5a3-e287-4ae3-9914-ddbab6c93bfd,2032-01-03,2032-01-05,Amazon UK,5942,Shopping,Online Retail,-61.9,GBP,-182726.65,E-Com,London,GB,4488,user_001,,
17cf1650-25d8-47b5-8c3e-c8ce00a91913,2032-01-03,2032-01-05,Shell,5541,Transport,Fuel,-78.94,GBP,-182805.59,POS,London,GB,1045,user_002,,
3db023bf-2a1e-47bd-a23d-b53594fc5954,2032-01-03,2032-01-05,Deliveroo,5812,Food & Drink,Delivery,-27.56,GBP,-182833.15,E-Com,London,GB,1045,user_001,,
554797f6-d57b-4c22-9ccb-2c50d6773103,2032-01-03,2032-01-05,Amazon UK,5942,Shopping,Online Retail,-39.63,GBP,-182872.78,E-Com,London,GB,4488,user_001,,
65e50365-6bfb-4908-973b-53d177faa821,2032-01-03,2032-01-05,Sainsbury's,5411,Groceries,Supermarket,-32.89,GBP,-182905.67,POS,London,GB,1045,user_001,,
cc983962-a8a5-4ff2-bcdd-717c1d6bbd8a,2032-01-03,2032-01-05,Uber UK,4121,Transport,Ride Hailing,-8.12,GBP,-182913.79,E-Com,London,GB,2219,user_001,,
43788554-7374-4a74-914a-4794965c376e,2032-01-04,2032-01-05,Transport for London,4111,Transport,Transit,-7.56,GBP,-182921.35,POS,London,GB,9074,user_002,,
e71d991d-0a3b-4c51-8c3b-4653a2910078,2032-01-04,2032-01-06,Sainsbury's,5411,Groceries,Supermarket,-22.92,GBP,-182944.27,POS,London,GB,4488,user_001,,
74dd6f10-b7e0-47e9-b493-e7ca23f66951,2032-01-05,2032-01-05,Waitrose,5411,Groceries,Supermarket,-41.4,GBP,-182985.67,POS,London,GB,4488,user_001,,
afabc767-b82b-4a33-88d2-77c5e524a959,2032-01-05,2032-01-05,Waitrose,5411,Groceries,Supermarket,-56.24,GBP,-183041.91,POS,London,GB,9074,user_001,,
215d06d3-90db-42ba-8dfd-81094b6aa7cb,2032-01-06,2032-01-07,Pret A Manger,5814,Food & Drink,Eating Out,-11.99,GBP,-183053.9,POS,London,GB,9074,user_001,,
9f3fa6a8-b4a2-4d47-9bf0-be0fe2972fbd,2032-01-06,2032-01-07,Uber UK,4121,Transport,Ride Hailing,-13.94,GBP,-183067.84,E-Com,London,GB,9074,user_001,,
e05c0afc-3fef-4e8e-80e2-e1d5e71b4ba2,2032-01-06,2032-01-08,Shell,5541,Transport,Fuel,-44.12,GBP,-183111.96,POS,London,GB,1045,user_001,,
5737de22-3fd4-4a83-8ebc-5fe265ac11d6,2032-01-07,2032-01-07,Tesco,5411,Groceries,Supermarket,-78.69,GBP,-183190.65,POS,London,GB,9074,user_001,,
c4651d49-04dd-4f8e-89f9-ae18e52f763c,2032-01-07,2032-01-08,Octopus Energy,4900,Utilities,Electricity,-125.55,GBP,-183316.2,Direct Debit,London,GB,2219,user_002,rec_09c3f12b18,
ea3f168a-6433-4041-b14e-82d7ba0c46e2,2032-01-07,2032-01-07,Apple.com/bill,5734,Shopping,Electronics,-91.63,USD,-183407.83,E-Com,Cupertino,US,4488,user_001,,FX purchase 113.81 USD @ rate 1.24
fe4a231a-8495-4c5e-8ff9-c27bfd2ceb9f,2032-01-08,2032-01-09,Sainsbury's,5411,Groceries,Supermarket,-63.01,GBP,-183470.84,POS,London,GB,1045,user_002,,
c16110fe-9f31-49c5-be7d-a9be02f091a1,2032-01-09,2032-01-12,Pret A Manger,5814,Food & Drink,Eating Out,-7.96,GBP,-183478.8,POS,London,GB,9074,user_001,,
06d9c962-e6ee-4175-8fcd-5b86fc2ae48c,2032-01-10,2032-01-12,Waitrose,5411,Groceries,Supermarket,-50.69,GBP,-183529.49,POS,London,GB,2219,user_002,,
18ad52b5-be2e-4489-88e6-ee5c19d8708a,2032-01-10,2032-01-12,Uber UK,4121,Transport,Ride Hailing,-10.77,GBP,-183540.26,E-Com,London,GB,2219,user_001,,
2c01ae20-6ad2-4f40-9377-d7c4a87c67c5,2032-01-10,2032-01-12,Deliveroo,5812,Food & Drink,Delivery,-22.23,GBP,-183562.49,E-Com,London,GB,4488,user_001,,
4215027a-d8fb-4424-9ff4-df7f98c74ae5,2032-01-10,2032-01-12,Shell,5541,Transport,Fuel,-58.43,GBP,-183620.92,POS,London,GB,1045,user_001,,
9a79b01f-cd8c-4337-968f-3785a65c2c57,2032-01-10,2032-01-12,Shell,5541,Transport,Fuel,-78.51,GBP,-183699.43,POS,London,GB,1045,user_001,,
a6e824ff-e8a6-4ca1-bdc1-27460c7b7f80,2032-01-10,2032-01-12,Deliveroo,5812,Food & Drink,Delivery,-32.49,GBP,-183731.92,E-Com,London,GB,9074,user_001,,
d5496234-5049-4b6a-af8b-118c4231a33d,2032-01-10,2032-01-12,Sainsbury's,5411,Groceries,Supermarket,-35.28,GBP,-183767.2,POS,London,GB,1045,user_001,,
05710b7f-1f07-49d3-9f4a-710ba1b98d2d,2032-01-11,2032-01-12,Tesco,5411,Groceries,Supermarket,-47.66,GBP,-183814.86,POS,London,GB,1045,user_001,,
20418402-7ee7-4ce8-b5df-bf0fe7f703ab,2032-01-11,2032-01-13,Amazon UK,5942,Shopping,Online Retail,-26.9,GBP,-183841.76,E-Com,London,GB,9074,user_002,,
641602c6-61a4-4447-be5d-780caed3a46e,2032-01-11,2032-01-13,Waitrose,5411,Groceries,Supermarket,-75.48,GBP,-183917.24,POS,London,GB,2219,user_001,,
74a12f20-fe96-4ad2-8c44-cbb3fb07c3b0,2032-01-11,2032-01-12,Shell,5541,Transport,Fuel,-40.96,GBP,-183958.2,POS,London,GB,2219,user_001,,
5c6612dc-5ab3-427c-aec6-81ef7c919f7c,2032-01-12,2032-01-13,Waitrose,5411,Groceries,Supermarket,-77.69,GBP,-184035.89,POS,London,GB,4488,user_001,,
908b8e78-4f0a-48af-8b00-ba0d267070d7,2032-01-12,2032-01-13,ATM Withdrawal,6011,Cash,ATM,-80.38,GBP,-184116.27,ATM,London,GB,1045,user_001,,
98ccef76-c28e-4203-bb8f-837065d0695c,2032-01-12,2032-01-12,Sainsbury's,5411,Groceries,Supermarket,-29.5,GBP,-184145.77,POS,London,GB,2219,user_001,,
ae02cec4-5461-418d-a237-cf365274e5e9,2032-01-12,2032-01-13,Thames Water,4900,Utilities,Water,-33.2,GBP,-184178.97,Direct Debit,Reading,GB,1045,user_001,rec_3a34d62842,
b05bf4b7-b98a-4a4b-bc24-efcca0b1a7b2,2032-01-12,2032-01-14,Shell,5541,Transport,Fuel,-69.45,GBP,-184248.42,POS,London,GB,4488,user_001,,
26f729ed-10b2-4511-90cf-e3e2e9b2874c,2032-01-13,2032-01-15,Apple.com/bill,5734,Shopping,Electronics,-165.77,GBP,-184414.19,E-Com,Cupertino,US,2219,user_002,,
b8623d2b-d732-4ea6-947e-9fe9b011c731,2032-01-13,2032-01-14,City Council Tax,9399,Utilities,Council Tax,-168.63,GBP,-184582.82,Direct Debit,London,GB,2219,user_001,rec_f531495db5,
466bc23b-eade-4c4a-bf74-a4f01a62049a,2032-01-14,2032-01-14,Tesco,5411,Groceries,Supermarket,-27.46,GBP,-184610.28,POS,London,GB,4488,user_002,,
75429731-8111-417c-897a-a427e9f4a338,2032-01-14,2032-01-16,Local Market,5499,Groceries,Specialty,-15.73,GBP,-184626.01,POS,London,GB,9074,user_001,,
7c01309c-b9da-408d-825c-52827e8a21ad,2032-01-14,2032-01-15,Transport for London,4111,Transport,Transit,-5.09,GBP,-184631.1,POS,London,GB,1045,user_001,,
e6d74ab2-11fd-433d-b08f-48deb745da61,2032-01-14,2032-01-16,Apple.com/bill,5734,Shopping,Electronics,-150.19,GBP,-184781.29,E-Com,Cupertino,US,1045,user_001,,
12e336a9-1572-48ea-b009-9124ce575b4e,2032-01-15,2032-01-15,Airline Refund,4511,Travel,Refund,49.77,GBP,-184731.52,Credit,London,GB,4488,user_001,,Refund for Apple.com/bill
79970d81-4694-44c1-850a-668c8f39d9d7,2032-01-15,2032-01-15,Pret A Manger,5814,Food & Drink,Eating Out,-7.44,GBP,-184738.96,POS,London,GB,9074,user_001,,
f30ae671-d408-4062-a3e4-92d39a36f608,2032-01-15,2032-01-16,Amazon UK,5942,Shopping,Online Retail,-28.52,GBP,-184767.48,E-Com,London,GB,9074,user_001,,
f4c17dc8-418a-44a7-abc6-9ff1743e5e79,2032-01-15,2032-01-15,O2 UK,4814,Bills,Mobile,-46.07,GBP,-184813.55,Direct Debit,Slough,GB,1045,user_001,rec_95042d8101,
d07cc813-a1f6-416d-a4f0-d8138b071e11,2032-01-16,2032-01-16,Waitrose,5411,Groceries,Supermarket,-25.7,GBP,-184839.25,POS,London,GB,9074,user_001,,
73c86d1a-5ceb-473a-97fe-0ab8d1157d58,2032-01-17,2032-01-19,Sainsbury's,5411,Groceries,Supermarket,-41.35,GBP,-184880.6,POS,London,GB,2219,user_001,,
903f30cf-88b6-4518-9250-63fd28137efb,2032-01-17,2032-01-19,Tesco,5411,Groceries,Supermarket,-79.51,GBP,-184960.11,POS,London,GB,9074,user_001,,
d059580a-89d8-419e-b00b-257e7eef7762,2032-01-17,2032-01-19,Deliveroo,5812,Food & Drink,Delivery,-32.24,GBP,-184992.35,E-Com,London,GB,1045,user_001,,
fdd4f7d0-1b1f-487c-af47-3416c9bcec29,2032-01-17,2032-01-19,Sainsbury's,5411,Groceries,Supermarket,-38.79,GBP,-185031.14,POS,London,GB,1045,user_001,,
70e508d5-9bda-45ac-b904-1675fc6ddd15,2032-01-18,2032-01-20,Shell,5541,Transport,Fuel,-59.02,GBP,-185090.16,POS,London,GB,4488,user_002,,
ce739926-7166-4128-b065-aad001491f43,2032-01-18,2032-01-19,Waitrose,5411,Groceries,Supermarket,-85.46,GBP,-185175.62,POS,London,GB,1045,user_001,,
df344def-ea6f-4133-98e7-1e394a4999d3,2032-01-18,2032-01-19,Apple.com/bill,5734,Shopping,Electronics,-46.55,USD,-185222.17,E-Com,Cupertino,US,1045,user_001,,FX purchase 58.99 USD @ rate 1.27
09cb56e3-568f-43b0-9e19-b51873687929,2032-01-19,2032-01-21,Spotify,5735,Entertainment,Subscriptions,-8.22,EUR,-185230.39,E-Com,Stockholm,SE,9074,user_001,rec_4c746d2c3b,FX purchase 9.44 EUR @ rate 1.15
5da49549-ca15-410f-a2c6-bab228ffc8cc,2032-01-19,2032-01-19,Amazon UK,5942,Shopping,Online Retail,-106.43,GBP,-185336.82,E-Com,London,GB,4488,user_001,,
933e2c48-2e07-4387-91bc-fd0c319b39ee,2032-01-19,2032-01-20,GymBox,7997,Wellness,Gym,-52.79,GBP,-185389.61,Direct Debit,London,GB,1045,user_001,rec_3906953fd2,
9602ec26-d193-49c8-bd84-7d3ca48dc124,2032-01-19,2032-01-21,Transport for London,4111,Transport,Transit,-10.71,GBP,-185400.32,POS,London,GB,9074,user_002,,
4fc4d1ec-1def-4c80-9db8-7fdcb70ab9ff,2032-01-20,2032-01-21,Tesco,5411,Groceries,Supermarket,-57.1,GBP,-185457.42,POS,London,GB,1045,user_002,,
60953bd1-6e6c-45c0-8c21-cb9afe3849bd,2032-01-21,2032-01-21,Local Market,5499,Groceries,Specialty,-8.98,GBP,-185466.4,POS,London,GB,1045,user_001,,
8d1bb52d-18db-453e-a3b9-039f49ecb3d0,2032-01-21,2032-01-22,Apple.com/bill,5734,Shopping,Electronics,-106.82,USD,-185573.22,E-Com,Cupertino,US,4488,user_001,,FX purchase 132.46 USD @ rate 1.24
8e5c3026-227e-4f28-890b-699102225d8b,2032-01-21,2032-01-21,Amazon UK,5942,Shopping,Online Retail,-102.48,GBP,-185675.7,E-Com,London,GB,4488,user_001,,
905f197a-8b8e-4b07-bf4f-d714967ac2a3,2032-01-21,2032-01-21,Amazon UK,5942,Shopping,Online Retail,-21.08,GBP,-185696.78,E-Com,London,GB,9074,user_001,,
aba323cc-fe35-4dfa-8117-beeeb07e0ed7,2032-01-21,2032-01-21,Netflix,7841,Entertainment,Subscriptions,-10.5,USD,-185707.28,E-Com,Los Gatos,US,1045,user_001,rec_1bfe33738d,FX purchase 13.51 USD @ rate 1.29
c2bf3dbf-bc51-4c1d-a8ca-454ea179f863,2032-01-21,2032-01-21,Transport for London,4111,Transport,Transit,-5.59,GBP,-185712.87,POS,London,GB,1045,user_001,,
d8005c57-db28-4b04-a3b2-04153850a03f,2032-01-21,2032-01-22,Uber UK,4121,Transport,Ride Hailing,-35.28,GBP,-185748.15,E-Com,London,GB,2219,user_001,,
4771402c-2f9f-4365-af80-df147208699e,2032-01-22,2032-01-22,Apple.com/bill,5734,Shopping,Electronics,-127.55,GBP,-185875.7,E-Com,Cupertino,US,9074,user_002,,
76b90662-b2f2-4baa-8e56-332f328990da,2032-01-23,2032-01-23,Transport for London,4111,Transport,Transit,-7.86,GBP,-185883.56,POS,London,GB,9074,user_001,,
796fd364-2d1d-4591-a170-5a2bcd3aa6a6,2032-01-23,2032-01-23,T212 Capital,6011,Income,Salary,2896.42,GBP,-182987.14,Credit,London,GB,4488,user_001,rec_2ff8f778d0,
cb8f5915-f2cf-4b57-8cf0-7d8501e1ef61,2032-01-23,2032-01-26,Uber UK,4121,Transport,Ride Hailing,-34.8,GBP,-183021.94,E-Com,London,GB,4488,user_001,,
5c1f0780-6336-4752-a8c2-cbfdd0997934,2032-01-24,2032-01-26,Deliveroo,5812,Food & Drink,Delivery,-13.46,GBP,-183035.4,E-Com,London,GB,4488,user_001,,
653dde0a-1bf2-4225-ba38-554dc67b6d25,2032-01-24,2032-01-26,Shell,5541,Transport,Fuel,-32.35,GBP,-183067.75,POS,London,GB,9074,user_002,,
8f8db7b5-9dd2-4b42-b460-62230d3b4c6e,2032-01-24,2032-01-26,Pret A Manger,5814,Food & Drink,Eating Out,-7.92,GBP,-183075.67,POS,London,GB,1045,user_002,,
b60b4cbd-c081-4c6a-9667-39766b331040,2032-01-24,2032-01-26,Amazon UK,5942,Shopping,Online Retail,-80.15,GBP,-183155.82,E-Com,London,GB,9074,user_001,,
dcb2532c-1dec-44df-b207-d45f7d28f4d8,2032-01-24,2032-01-26,Pret A Manger,5814,Food & Drink,Eating Out,-10.12,GBP,-183165.94,POS,London,GB,1045,user_001,,
70b109f3-f61a-459a-97ec-ff8e42d26a3f,2032-01-25,2032-01-26,Transport for London,4111,Transport,Transit,-11.38,GBP,-183177.32,POS,London,GB,4488,user_002,,
70c63176-b36c-42df-9bcc-2119ba1906bb,2032-01-25,2032-01-26,Amazon UK,5942,Shopping,Online Retail,-117.05,GBP,-183294.37,E-Com,London,GB,9074,user_001,,
71bb0001-b20a-449b-aa24-7ef543659195,2032-01-25,2032-01-26,Local Market,5499,Groceries,Specialty,-9.76,GBP,-183304.13,POS,London,GB,2219,user_001,,
21a9675c-4389-4d10-87f0-1c55f8a293e7,2032-01-26,2032-01-26,Airline Refund,4511,Travel,Refund,62.7,GBP,-183241.43,Credit,London,GB,1045,user_002,,Refund for Sainsbury's
6eba853d-2e19-420d-a3ee-328b153b2e3d,2032-01-26,2032-01-26,Pret A Manger,5814,Food & Drink,Eating Out,-11.16,GBP,-183252.59,POS,London,GB,1045,user_001,,
2a939b3b-3ae2-48c5-a60d-420e0e41276e,2032-01-27,2032-01-27,Deliveroo,5812,Food & Drink,Delivery,-26.4,GBP,-183278.99,E-Com,London,GB,4488,user_002,,
b9c2d50e-4c8d-4bce-9973-ec0f3401f0b3,2032-01-27,2032-01-27,Uber UK,4121,Transport,Ride Hailing,-13.23,GBP,-183292.22,E-Com,London,GB,9074,user_001,,
da36d91f-78e8-4225-a570-637522580b45,2032-01-27,2032-01-29,Local Market,5499,Groceries,Specialty,-10.21,GBP,-183302.43,POS,London,GB,9074,user_001,,
524715bf-2be6-480f-8b17-b1818456651c,2032-01-28,2032-01-29,Sainsbury's,5411,Groceries,Supermarket,-66.6,GBP,-183369.03,POS,London,GB,1045,user_001,,
5c182844-5dfe-4300-88e8-600f0535b335,2032-01-28,2032-01-28,Amazon UK,5942,Shopping,Online Retail,-80.29,GBP,-183449.32,E-Com,London,GB,2219,user_001,,
6841869a-1a82-4968-afb6-1b81ec2944ca,2032-01-28,2032-01-28,Tesco,5411,Groceries,Supermarket,-75.73,GBP,-183525.05,POS,London,GB,1045,user_001,,
f983ace7-185b-44a4-8e18-25f46ba36c5c,2032-01-28,2032-01-29,Shell,5541,Transport,Fuel,-39.68,GBP,-183564.73,POS,London,GB,9074,user_001,,
20dbdac9-95e6-4747-a074-fed7c07407dc,2032-01-29,2032-01-29,Apple.com/bill,5734,Shopping,Electronics,-42.44,USD,-183607.17,E-Com,Cupertino,US,2219,user_001,,FX purchase 53.12 USD @ rate 1.25
dff14ea5-00d7-46b1-b4b7-c7038fcdffbf,2032-01-29,2032-02-02,Shell,5541,Transport,Fuel,-77.41,GBP,-183684.58,POS,London,GB,4488,user_001,,
61300eb5-90b4-42b4-a2c3-87a6dfb9fc8a,2032-01-30,2032-02-02,Amazon UK,5942,Shopping,Online Retail,-17.19,GBP,-183701.77,E-Com,London,GB,1045,user_001,,
cd3cefbc-a448-43fd-83d6-37181ec95ae3,2032-01-30,2032-01-30,Amazon UK,5942,Shopping,Online Retail,-108.44,GBP,-183810.21,E-Com,London,GB,4488,user_002,,
53d5edff-34a0-4c47-a3e2-7b3d0efc7249,2032-01-31,2032-02-02,Amazon UK,5942,Shopping,Online Retail,-113.99,GBP,-183924.2,E-Com,London,GB,9074,user_001,,
6ccf788e-d290-4eeb-b674-47fe8ab1ea7d,2032-01-31,2032-02-02,Uber UK,4121,Transport,Ride Hailing,-30.77,GBP,-183954.97,E-Com,London,GB,1045,user_001,,
a8f6291e-d327-4e17-ac5e-a74787861f34,2032-01-31,2032-02-02,Airline Refund,4511,Travel,Refund,32.15,GBP,-183922.82,Credit,London,GB,4488,user_001,,Refund for Deliveroo
afc446b3-6d90-4982-adc2-be875613529c,2032-01-31,2032-02-02,Deliveroo,5812,Food & Drink,Delivery,-15.53,GBP,-183938.35,E-Com,London,GB,9074,user_001,,
ef6f24bb-3b69-4a33-a22d-c55b741a20d3,2032-01-31,2032-02-02,Deliveroo,5812,Food & Drink,Delivery,-28.44,GBP,-183966.79,E-Com,London,GB,4488,user_001,,
feff53ce-4b09-42d6-930f-fdec77586c28,2032-01-31,2032-02-02,Waitrose,5411,Groceries,Supermarket,-71.83,GBP,-184038.62,POS,London,GB,9074,user_002,,
6685ae52-ef4e-4e6f-a6d4-1d55f829f950,2032-02-01,2032-02-02,Tesco,5411,Groceries,Supermarket,-36.15,GBP,-184074.77,POS,London,GB,2219,user_002,,
7831da4f-b7ad-4660-adc9-b50ea8ed5745,2032-02-01,2032-02-03,Tesco,5411,Groceries,Supermarket,-68.12,GBP,-184142.89,POS,London,GB,9074,user_002,,
c4dd0345-eac4-44de-893a-618a9aeff623,2032-02-01,2032-02-02,Apple.com/bill,5734,Shopping,Electronics,-139.24,GBP,-184282.13,E-Com,Cupertino,US,4488,user_002,,
3a63cf4c-acd6-45ec-92aa-f3c351078577,2032-02-02,2032-02-04,Local Market,5499,Groceries,Specialty,-17.2,GBP,-184299.33,POS,London,GB,2219,user_001,,
45c6847d-1aad-4117-bdfd-978ead643119,2032-02-02,2032-02-03,Crown Estates Lettings,6513,Housing,Rent,-1631.53,GBP,-185930.86,POS,London,GB,9074,user_001,rec_19f70fbcce,
e4245539-42ef-4af6-bd5b-7d5a2c49f913,2032-02-03,2032-02-04,Amazon UK,5942,Shopping,Online Retail,-90.68,GBP,-186021.54,E-Com,London,GB,9074,user_001,,
03c4d9b4-6641-497d-84d3-4eba6286bc60,2032-02-05,2032-02-09,Deliveroo,5812,Food & Drink,Delivery,-24.34,GBP,-186045.88,E-Com,London,GB,2219,user_001,,
730bc80a-4718-40d7-90bc-34922ae0568e,2032-02-05,2032-02-05,Amazon UK,5942,Shopping,Online Retail,-89.15,GBP,-186135.03,E-Com,London,GB,9074,user_001,,
279e9f99-699c-488c-b176-cf4832b5ca67,2032-02-06,2032-02-06,Deliveroo,5812,Food & Drink,Delivery,-13.91,GBP,-186148.94,E-Com,London,GB,4488,user_001,,
f696d2d9-8e09-4d0c-9b03-623aa58f87bb,2032-02-06,2032-02-09,Amazon UK,5942,Shopping,Online Retail,-84.23,GBP,-186233.17,E-Com,London,GB,2219,user_001,,
301d2514-9975-47e3-9dac-75e8e4503a86,2032-02-07,2032-02-09,Apple.com/bill,5734,Shopping,Electronics,-199.17,USD,-186432.34,E-Com,Cupertino,US,4488,user_001,,FX purchase 250.63 USD @ rate 1.26
cd8194ce-1c39-4d16-b303-f2952cf026ce,2032-02-07,2032-02-09,Tesco,5411,Groceries,Supermarket,-31.3,GBP,-186463.64,POS,London,GB,1045,user_001,,
3609516f-41bc-45ca-8f9a-fa6ac0cc2b3c,2032-02-08,2032-02-09,Amazon UK,5942,Shopping,Online Retail,-39.64,GBP,-186503.28,E-Com,London,GB,2219,user_002,,
526b2b23-50bd-432a-bd42-f64ad831aba9,2032-02-08,2032-02-09,Sainsbury's,5411,Groceries,Supermarket,-21.72,GBP,-186525.0,POS,London,GB,2219,user_001,,
6a5082f1-1f9f-483f-9f03-8df144f7739a,2032-02-08,2032-02-10,Amazon UK,5942,Shopping,Online Retail,-14.91,GBP,-186539.91,E-Com,London,GB,4488,user_002,,
92c3f59b-a082-4370-9397-604c7019533c,2032-02-08,2032-02-10,Apple.com/bill,5734,Shopping,Electronics,-6.73,USD,-186546.64,E-Com,Cupertino,US,4488,user_001,,FX purchase 8.59 USD @ rate 1.28
a9914f12-2fab-4c1a-9f88-d3df2bf17b8d,2032-02-08,2032-02-10,Transport for London,4111,Transport,Transit,-5.34,GBP,-186551.98,POS,London,GB,1045,user_002,,
21a4423f-9c87-4216-86b1-bdbda5f33e85,2032-02-09,2032-02-10,Octopus Energy,4900,Utilities,Electricity,-125.76,GBP,-186677.74,Direct Debit,London,GB,2219,user_001,rec_141a4a0666,
45ddd34a-6f52-486c-ad8c-45d97b78b618,2032-02-09,2032-02-11,Deliveroo,5812,Food & Drink,Delivery,-14.3,GBP,-186692.04,E-Com,London,GB,1045,user_001,,
bffb4ea0-913f-4957-b5fa-ce0608f8e0e5,2032-02-09,2032-02-11,Apple.com/bill,5734,Shopping,Electronics,-25.99,GBP,-186718.03,E-Com,Cupertino,US,9074,user_001,,
14e9b613-7112-4da6-ba2a-2ec306050bd6,2032-02-11,2032-02-13,Uber UK,4121,Transport,Ride Hailing,-33.57,GBP,-186751.6,E-Com,London,GB,4488,user_001,,
84e4219c-fc02-4b3e-b1c8-f2655e8e23b4,2032-02-11,2032-02-13,Waitrose,5411,Groceries,Supermarket,-51.47,GBP,-186803.07,POS,London,GB,4488,user_001,,
df3c6f77-623a-4c67-b45c-fe7cf25b6029,2032-02-11,2032-02-11,Local Market,5499,Groceries,Specialty,-15.57,GBP,-186818.64,POS,London,GB,9074,user_001,,
ffb8859b-f57f-4a77-9ef5-b5e9063a3b62,2032-02-11,2032-02-13,Thames Water,4900,Utilities,Water,-41.91,GBP,-186860.55,Direct Debit,Reading,GB,1045,user_002,rec_954d02400c,
533a1fbe-21f8-4f53-b3de-5b5815442025,2032-02-12,2032-02-13,Sainsbury's,5411,Groceries,Supermarket,-22.44,GBP,-186882.99,POS,London,GB,4488,user_001,,
adfc25dc-83a3-460f-84ff-d8aced5adf58,2032-02-12,2032-02-13,Deliveroo,5812,Food & Drink,Delivery,-17.89,GBP,-186900.88,E-Com,London,GB,4488,user_002,,
5e544110-d7c9-4b5d-b0cf-8b6a30678e77,2032-02-13,2032-02-16,Airbnb,7011,Travel,Accommodation,-363.77,GBP,-187264.65,E-Com,Dublin,IE,9074,user_001,,Holiday booking
72afe597-b75e-4f06-bf3e-8491ccd7c5cf,2032-02-13,2032-02-16,City Council Tax,9399,Utilities,Council Tax,-184.93,GBP,-187449.58,Direct Debit,London,GB,1045,user_001,rec_f531495db5,
02864dd6-990b-495e-b51d-e3902c52f423,2032-02-14,2032-02-16,Tesco,5411,Groceries,Supermarket,-66.36,GBP,-187515.94,POS,London,GB,2219,user_001,,
3f1ba300-bfd4-431b-9efc-6de2f2d0be0f,2032-02-14,2032-02-16,Sainsbury's,5411,Groceries,Supermarket,-33.81,GBP,-187549.75,POS,London,GB,2219,user_001,,
4ea1aad6-cdef-43c8-9bfa-ac7b125fcb17,2032-02-14,2032-02-16,Apple.com/bill,5734,Shopping,Electronics,-6.83,USD,-187556.58,E-Com,Cupertino,US,9074,user_002,,FX purchase 8.56 USD @ rate 1.25
bc385fc8-9b15-41e9-a837-21578289aea9,2032-02-14,2032-02-16,Tesco,5411,Groceries,Supermarket,-40.61,GBP,-187597.19,POS,London,GB,2219,user_001,,
e786a1a4-9b3e-4a46-ba79-cd2ac8cb5bb3,2032-02-14,2032-02-16,Transport for London,4111,Transport,Transit,-7.78,GBP,-187604.97,POS,London,GB,2219,user_001,,
0c4335f2-252f-4a04-9dc0-900bb5bf50c4,2032-02-15,2032-02-16,Sainsbury's,5411,Groceries,Supermarket,-56.19,GBP,-187661.16,POS,London,GB,4488,user_001,,
5117f996-8be1-4d81-b580-76dcca751703,2032-02-15,2032-02-16,Tesco,5411,Groceries,Supermarket,-59.94,GBP,-187721.1,POS,London,GB,4488,user_002,,
5cf72642-0f7f-4be7-9282-7850e39f77fc,2032-02-15,2032-02-16,Deliveroo,5812,Food & Drink,Delivery,-23.58,GBP,-187744.68,E-Com,London,GB,4488,user_001,,
60ce3dc5-b25c-495c-8be3-ebd4966530d8,2032-02-16,2032-02-17,Apple.com/bill,5734,Shopping,Electronics,-5.68,GBP,-187750.36,E-Com,Cupertino,US,1045,user_001,,
c1859828-426c-4b3b-891c-c42c6735421d,2032-02-16,2032-02-16,Uber UK,4121,Transport,Ride Hailing,-11.21,GBP,-187761.57,E-Com,London,GB,2219,user_001,,
db764c90-f0c6-4edc-81b4-5b1ebc442ed4,2032-02-16,2032-02-16,O2 UK,4814,Bills,Mobile,-50.44,GBP,-187812.01,Direct Debit,Slough,GB,2219,user_001,rec_95042d8101,
9e106fee-4e48-4a44-b54f-22b0ff83254a,2032-02-17,2032-02-19,Local Market,5499,Groceries,Specialty,-18.89,GBP,-187830.9,POS,London,GB,2219,user_001,,
fefb4b4a-2fd3-45de-acfe-7c98f079c596,2032-02-17,2032-02-18,GymBox,7997,Wellness,Gym,-64.18,GBP,-187895.08,Direct Debit,London,GB,9074,user_002,rec_19771e79cd,
0808cca7-cc88-4bd1-be61-7f8b7f5ebd20,2032-02-18,2032-02-20,Amazon UK,5942,Shopping,Online Retail,-44.61,GBP,-187939.69,E-Com,London,GB,4488,user_001,,
6a498424-cd7c-4253-8859-080df8734b73,2032-02-18,2032-02-20,Local Market,5499,Groceries,Specialty,-9.84,GBP,-187949.53,POS,London,GB,1045,user_001,,
898d97df-ff6d-4fd2-94bc-dd1f683427f1,2032-02-18,2032-02-18,Tesco,5411,Groceries,Supermarket,-59.83,GBP,-188009.36,POS,London,GB,4488,user_001,,
3fa224a4-fa16-40fa-8a41-125c63b7d998,2032-02-19,2032-02-19,Local Market,5499,Groceries,Specialty,-7.64,GBP,-188017.0,POS,London,GB,1045,user_001,,
bbe85b65-601f-4887-8789-9cacf1ebdbbd,2032-02-19,2032-02-20,Deliveroo,5812,Food & Drink,Delivery,-18.14,GBP,-188035.14,E-Com,London,GB,9074,user_001,,
e629fe0c-6158-4b00-929d-3de07df6a9ce,2032-02-19,2032-02-23,Spotify,5735,Entertainment,Subscriptions,-9.03,GBP,-188044.17,E-Com,Stockholm,SE,2219,user_002,rec_34b6e9e33f,
3267196a-ebd9-4223-b575-5d515f47943b,2032-02-21,2032-02-23,Tesco,5411,Groceries,Supermarket,-77.58,GBP,-188121.75,POS,London,GB,4488,user_001,,
3b0d0b70-cb15-4ea9-9abf-590f3f58641c,2032-02-21,2032-02-23,Uber UK,4121,Transport,Ride Hailing,-26.9,GBP,-188148.65,E-Com,London,GB,4488,user_002,,
eed955e0-d61b-4a4d-a9e5-f81b6592000a,2032-02-21,2032-02-23,Sainsbury's,5411,Groceries,Supermarket,-50.38,GBP,-188199.03,POS,London,GB,2219,user_001,,
b030daa0-c1e9-4b63-bebe-079a23463c02,2032-02-22,2032-02-23,Deliveroo,5812,Food & Drink,Delivery,-26.99,GBP,-188226.02,E-Com,London,GB,4488,user_001,,
0acf3c90-2b8f-475d-8ffe-3b610674a53d,2032-02-23,2032-02-23,Netflix,7841,Entertainment,Subscriptions,-10.61,USD,-188236.63,E-Com,Los Gatos,US,9074,user_001,rec_1bfe33738d,FX purchase 13.33 USD @ rate 1.26
9cda3dfd-6276-4561-a674-c0cab26c4786,2032-02-24,2032-02-24,Tesco,5411,Groceries,Supermarket,-24.33,GBP,-188260.96,POS,London,GB,9074,user_002,,
9210058c-ce25-4d72-a637-881ef2f36865,2032-02-25,2032-02-25,T212 Capital,6011,Income,Salary,3170.17,GBP,-185090.79,Credit,London,GB,2219,user_001,rec_2ff8f778d0,
63538a51-3124-4b99-bdff-bbec5d7588a6,2032-02-27,2032-03-01,Uber UK,4121,Transport,Ride Hailing,-29.7,GBP,-185120.49,E-Com,London,GB,2219,user_001,,
80f0c219-f664-4e7c-a6c2-c84928d1bd47,2032-02-27,2032-03-01,Waitrose,5411,Groceries,Supermarket,-40.28,GBP,-185160.77,POS,London,GB,2219,user_001,,
828b15c2-ec8d-4180-8bfd-72f9f80c9baf,2032-02-27,2032-02-27,Amazon UK,5942,Shopping,Online Retail,-84.47,GBP,-185245.24,E-Com,London,GB,2219,user_001,,
a1028cde-c0c1-4c82-a3ea-7ff96e633121,2032-02-27,2032-02-27,Uber UK,4121,Transport,Ride Hailing,-19.55,GBP,-185264.79,E-Com,London,GB,1045,user_001,,
277d1e9a-8437-4bf2-b31d-a87b6e8eca8c,2032-02-28,2032-03-01,Transport for London,4111,Transport,Transit,-11.89,GBP,-185276.68,POS,London,GB,2219,user_001,,
2fbf6b75-e47f-4417-a3f7-868668cc2689,2032-02-28,2032-03-01,Deliveroo,5812,Food & Drink,Delivery,-30.95,GBP,-185307.63,E-Com,London,GB,1045,user_001,,
3ccea9db-4a89-41e6-a60e-3aef82c584a1,2032-02-28,2032-03-01,Amazon UK,5942,Shopping,Online Retail,-43.14,GBP,-185350.77,E-Com,London,GB,9074,user_002,,
603d986d-daea-4fa3-83f3-be57565ebe08,2032-02-28,2032-03-01,Transport for London,4111,Transport,Transit,-9.89,GBP,-185360.66,POS,London,GB,1045,user_001,,
6620034d-e55c-49ee-965a-0e54110d8b07,2032-02-28,2032-03-01,Waitrose,5411,Groceries,Supermarket,-76.83,GBP,-185437.49,POS,London,GB,4488,user_001,,
25b3ff73-04bf-4a7e-8552-e1060de699ab,2032-02-29,2032-03-01,Shell,5541,Transport,Fuel,-50.87,GBP,-185488.36,POS,London,GB,2219,user_001,,
30a5574f-9b93-47fc-a37e-886e9a604571,2032-02-29,2032-03-02,Apple.com/bill,5734,Shopping,Electronics,-14.13,USD,-185502.49,E-Com,Cupertino,US,9074,user_001,,FX purchase 17.2 USD @ rate 1.22
e84c3191-b32b-44a4-9960-e8a63a5f0d0c,2032-02-29,2032-03-02,Pret A Manger,5814,Food & Drink,Eating Out,-7.84,GBP,-185510.33,POS,London,GB,1045,user_001,,
2928ed20-5d25-45b0-8fc5-199680dc8569,2032-03-01,2032-03-03,Deliveroo,5812,Food & Drink,Delivery,-27.45,GBP,-185537.78,E-Com,London,GB,2219,user_001,,
3e1693b4-6f6f-4df6-bb59-166734fa153f,2032-03-01,2032-03-02,Crown Estates Lettings,6513,Housing,Rent,-1468.23,GBP,-187006.01,POS,London,GB,9074,user_002,rec_fc2ae06846,
7fefb6d0-7728-4579-9908-539671d9bc9c,2032-03-01,2032-03-02,Uber UK,4121,Transport,Ride Hailing,-19.98,GBP,-187025.99,E-Com,London,GB,9074,user_002,,
8a61308b-2da8-4903-9242-930c8511a850,2032-03-01,2032-03-01,Amazon UK,5942,Shopping,Online Retail,-74.7,GBP,-187100.69,E-Com,London,GB,9074,user_002,,
221746db-f6d6-413c-be1c-2a5e10e27f68,2032-03-02,2032-03-04,Local Market,5499,Groceries,Specialty,-21.56,GBP,-187122.25,POS,London,GB,4488,user_001,,
b2adfb8f-d4a4-4d4d-9f6f-a71858956c61,2032-03-02,2032-03-04,Sainsbury's,5411,Groceries,Supermarket,-64.63,GBP,-187186.88,POS,London,GB,4488,user_001,,
7799969b-3e4e-46cd-a0c3-e5fa91b4bdc6,2032-03-03,2032-03-05,Pret A Manger,5814,Food & Drink,Eating Out,-8.67,GBP,-187195.55,POS,London,GB,2219,user_001,,
a5ebc813-e099-4cb1-9ff0-4f5175b38232,2032-03-04,2032-03-08,Amazon UK,5942,Shopping,Online Retail,-61.81,GBP,-187257.36,E-Com,London,GB,1045,user_001,,
6bcf81fb-30cf-4cbf-93b8-8213566984df,2032-03-05,2032-03-08,Apple.com/bill,5734,Shopping,Electronics,-135.94,USD,-187393.3,E-Com,Cupertino,US,4488,user_001,,FX purchase 163.86 USD @ rate 1.21
d31f96d0-6a68-4a02-889f-5b7781563bb0,2032-03-05,2032-03-05,Uber UK,4121,Transport,Ride Hailing,-14.78,GBP,-187408.08,E-Com,London,GB,9074,user_001,,
1adccb0f-3d87-4019-905c-86627c06a9d6,2032-03-06,2032-03-08,Apple.com/bill,5734,Shopping,Electronics,-125.8,GBP,-187533.88,E-Com,Cupertino,US,4488,user_001,,
2b55ada7-413c-4755-9cd2-efbfe8e29138,2032-03-06,2032-03-08,Sainsbury's,5411,Groceries,Supermarket,-35.94,GBP,-187569.82,POS,London,GB,9074,user_002,,
89e7d9d3-f9f8-4b37-bbaf-3ad034ae383b,2032-03-06,2032-03-08,Pret A Manger,5814,Food & Drink,Eating Out,-10.26,GBP,-187580.08,POS,London,GB,4488,user_001,,
b432a3c4-5663-49de-b72f-b75b9aebb4c5,2032-03-06,2032-03-08,Waitrose,5411,Groceries,Supermarket,-82.71,GBP,-187662.79,POS,London,GB,2219,user_001,,
d0ece8e2-70ba-445a-8473-a1293e91e8d0,2032-03-06,2032-03-08,Pret A Manger,5814,Food & Drink,Eating Out,-6.04,GBP,-187668.83,POS,London,GB,9074,user_001,,
ef2d5530-869e-404d-a35a-24bd50d05e59,2032-03-06,2032-03-08,Waitrose,5411,Groceries,Supermarket,-23.12,GBP,-187691.95,POS,London,GB,1045,user_001,,
f5e5504f-bc75-4987-a693-8f5b6ea4f13b,2032-03-06,2032-03-08,Transport for London,4111,Transport,Transit,-8.68,GBP,-187700.63,POS,London,GB,1045,user_001,,
0530d0ce-768e-45b3-bffc-2b96d882e7c7,2032-03-07,2032-03-08,Transport for London,4111,Transport,Transit,-4.68,GBP,-187705.31,POS,London,GB,1045,user_001,,
06679c16-d265-4165-884b-ad7ddd05ee78,2032-03-07,2032-03-08,Tesco,5411,Groceries,Supermarket,-21.78,GBP,-187727.09,POS,London,GB,2219,user_001,,
265fb4a7-2e0e-4263-be04-66d919fe478e,2032-03-08,2032-03-09,Octopus Energy,4900,Utilities,Electricity,-125.43,GBP,-187852.52,Direct Debit,London,GB,2219,user_001,rec_141a4a0666,
ad40ec7a-4367-4fe3-828e-d026ae57fb18,2032-03-08,2032-03-09,Shell,5541,Transport,Fuel,-45.92,GBP,-187898.44,POS,London,GB,2219,user_001,,
5cf71333-2552-422d-8588-6cd430e32f94,2032-03-09,2032-03-09,Transport for London,4111,Transport,Transit,-9.36,GBP,-187907.8,POS,London,GB,2219,user_001,,
c231b9ae-19df-4d20-9ea5-79de596e6622,2032-03-09,2032-03-11,Transport for London,4111,Transport,Transit,-4.41,GBP,-187912.21,POS,London,GB,2219,user_001,,
fe39ec25-0ea7-4c49-9561-39182f198557,2032-03-09,2032-03-09,Tesco,5411,Groceries,Supermarket,-29.83,GBP,-187942.04,POS,London,GB,2219,user_001,,
3bf45891-7a95-4ed9-a625-41f2d2c27988,2032-03-10,2032-03-12,Sainsbury's,5411,Groceries,Supermarket,-30.26,GBP,-187972.3,POS,London,GB,9074,user_001,,
d595af0a-2951-41ae-93f2-eed3aa9f1999,2032-03-10,2032-03-10,Apple.com/bill,5734,Shopping,Electronics,-144.89,USD,-188117.19,E-Com,Cupertino,US,9074,user_001,,FX purchase 176.3 USD @ rate 1.22
2bea46f3-d79b-4919-a97d-6ed717ef77b0,2032-03-11,2032-03-12,Apple.com/bill,5734,Shopping,Electronics,-198.36,GBP,-188315.55,E-Com,Cupertino,US,1045,user_001,,
5f38a844-0fb0-4bc5-9cfc-05c39378f406,2032-03-11,2032-03-15,Sainsbury's,5411,Groceries,Supermarket,-60.32,GBP,-188375.87,POS,London,GB,4488,user_001,,
758aba0f-44a0-4dce-81a8-a17b2fc439eb,2032-03-11,2032-03-11,Tesco,5411,Groceries,Supermarket,-33.68,GBP,-188409.55,POS,London,GB,2219,user_001,,
c282f649-eec4-42e5-82de-cc341404d7e1,2032-03-11,2032-03-11,Thames Water,4900,Utilities,Water,-35.56,GBP,-188445.11,Direct Debit,Reading,GB,4488,user_002,rec_954d02400c,
4c12709f-6eea-4b09-8503-0b560bf0b2d9,2032-03-12,2032-03-12,Tesco,5411,Groceries,Supermarket,-46.84,GBP,-188491.95,POS,London,GB,2219,user_002,,
72db5dbc-b19d-42d8-8aa6-6f896432af04,2032-03-12,2032-03-15,Local Market,5499,Groceries,Specialty,-10.08,GBP,-188502.03,POS,London,GB,1045,user_001,,
2700ebad-dc16-4f45-86ba-c0c675d8a325,2032-03-13,2032-03-15,Sainsbury's,5411,Groceries,Supermarket,-36.75,GBP,-188538.78,POS,London,GB,4488,user_001,,
8b4f57d5-cc18-429f-96c7-42a5a487ec29,2032-03-13,2032-03-15,Waitrose,5411,Groceries,Supermarket,-40.08,GBP,-188578.86,POS,London,GB,4488,user_001,,
a1540d47-f385-40b7-8851-f489b0041d4f,2032-03-13,2032-03-15,Tesco,5411,Groceries,Supermarket,-56.88,GBP,-188635.74,POS,London,GB,9074,user_001,,
cd6e5d93-5f13-49ec-8a15-476bfe4fc980,2032-03-13,2032-03-15,Apple.com/bill,5734,Shopping,Electronics,-173.34,USD,-188809.08,E-Com,Cupertino,US,4488,user_001,,FX purchase 215.61 USD @ rate 1.24
e8020fd5-b2b7-45a3-89c1-6f2d54c00114,2032-03-13,2032-03-15,Apple.com/bill,5734,Shopping,Electronics,-22.26,USD,-188831.34,E-Com,Cupertino,US,2219,user_001,,FX purchase 27.44 USD @ rate 1.23
1e32064b-ecb0-4dc5-ba8c-4399f864420c,2032-03-14,2032-03-16,Waitrose,5411,Groceries,Supermarket,-25.64,GBP,-188856.98,POS,London,GB,1045,user_002,,
1fac4bcc-c637-4529-b68a-45fa43e8d410,2032-03-14,2032-03-15,Shell,5541,Transport,Fuel,-50.96,GBP,-188907.94,POS,London,GB,2219,user_001,,
2287109e-4857-44a6-8d1d-5d479e1ef625,2032-03-14,2032-03-15,Local Market,5499,Groceries,Specialty,-8.2,GBP,-188916.14,POS,London,GB,1045,user_001,,
6727e941-b5b7-4b3f-ae9e-973f3cddff29,2032-03-14,2032-03-15,Deliveroo,5812,Food & Drink,Delivery,-20.7,GBP,-188936.84,E-Com,London,GB,1045,user_001,,
7c88547b-6026-4b4d-97ff-b39dd55c23f2,2032-03-14,2032-03-15,Waitrose,5411,Groceries,Supermarket,-76.34,GBP,-189013.18,POS,London,GB,2219,user_001,,
509b37aa-104e-45eb-b1f8-356b20655c91,2032-03-15,2032-03-17,Deliveroo,5812,Food & Drink,Delivery,-22.0,GBP,-189035.18,E-Com,London,GB,1045,user_001,,
8915e6a6-5777-4588-8f5e-3fe3c3b1822f,2032-03-15,2032-03-17,O2 UK,4814,Bills,Mobile,-35.57,GBP,-189070.75,Direct Debit,Slough,GB,4488,user_001,rec_95042d8101,
dee47675-ec2a-4444-9996-7dc257e1fa3e,2032-03-15,2032-03-16,City Council Tax,9399,Utilities,Council Tax,-165.32,GBP,-189236.07,Direct Debit,London,GB,9074,user_001,rec_f531495db5,
3b6caac8-6101-41e7-b18e-54b57a41a9d0,2032-03-17,2032-03-19,Pret A Manger,5814,Food & Drink,Eating Out,-10.0,GBP,-189246.07,POS,London,GB,9074,user_001,,
6a7d1112-285f-4b5c-8bfe-b3a5a42413cb,2032-03-17,2032-03-18,Airbnb,7011,Travel,Accommodation,-197.23,GBP,-189443.3,E-Com,Dublin,IE,4488,user_001,,Holiday booking
a214d899-bdf0-4b75-9afc-0aaad0a1630f,2032-03-17,2032-03-17,Tesco,5411,Groceries,Supermarket,-36.42,GBP,-189479.72,POS,London,GB,2219,user_001,,
b89a07df-01c8-472d-9ed9-bc5e5fa262d3,2032-03-17,2032-03-19,Local Market,5499,Groceries,Specialty,-11.15,GBP,-189490.87,POS,London,GB,4488,user_001,,
e16fb807-6932-4a75-a65b-ab9ccc4f55df,2032-03-17,2032-03-19,GymBox,7997,Wellness,Gym,-60.49,GBP,-189551.36,Direct Debit,London,GB,4488,user_001,rec_3906953fd2,
0e5dcba8-9cc0-46ac-8b95-8de5d14b5263,2032-03-18,2032-03-22,Tesco,5411,Groceries,Supermarket,-60.09,GBP,-189611.45,POS,London,GB,1045,user_001,,
96b96534-3526-4cb4-9a0b-390c9e61107c,2032-03-18,2032-03-19,Sainsbury's,5411,Groceries,Supermarket,-32.09,GBP,-189643.54,POS,London,GB,2219,user_001,,
566fda0d-6f2f-4e08-9584-bccd158872f3,2032-03-19,2032-03-22,Local Market,5499,Groceries,Specialty,-17.31,GBP,-189660.85,POS,London,GB,2219,user_001,,
5fb275ee-27a1-43f7-9d55-ce9cb85a535f,2032-03-19,2032-03-22,Local Market,5499,Groceries,Specialty,-14.41,GBP,-189675.26,POS,London,GB,9074,user_002,,
a7ae7b68-a959-402f-8c0f-2f3e9bd33cc4,2032-03-19,2032-03-19,Spotify,5735,Entertainment,Subscriptions,-8.54,EUR,-189683.8,E-Com,Stockholm,SE,9074,user_001,rec_4c746d2c3b,FX purchase 9.46 EUR @ rate 1.11
ef63d0fe-89c0-4898-9546-ac3fac07d154,2032-03-19,2032-03-19,Pret A Manger,5814,Food & Drink,Eating Out,-9.48,GBP,-189693.28,POS,London,GB,9074,user_001,,
42e6dc8f-076d-4647-a557-0984fea5f02b,2032-03-20,2032-03-22,Apple.com/bill,5734,Shopping,Electronics,-175.89,GBP,-189869.17,E-Com,Cupertino,US,2219,user_001,,
52f06439-aabc-4eb6-b153-77f21cb86d11,2032-03-20,2032-03-22,Local Market,5499,Groceries,Specialty,-9.72,GBP,-189878.89,POS,London,GB,9074,user_001,,
74bee904-beac-4290-8fb7-00ddceb1490e,2032-03-20,2032-03-22,Waitrose,5411,Groceries,Supermarket,-46.03,GBP,-189924.92,POS,London,GB,2219,user_001,,
8220e4d6-1691-4dd7-a14f-3032d90c323b,2032-03-20,2032-03-22,Tesco,5411,Groceries,Supermarket,-34.39,GBP,-189959.31,POS,London,GB,9074,user_001,,
060679b4-c99e-4df2-8392-9be8c9cdc3fa,2032-03-21,2032-03-22,Waitrose,5411,Groceries,Supermarket,-23.4,GBP,-189982.71,POS,London,GB,2219,user_001,,
1612ad70-3d3d-4818-8088-2b16f57a33c4,2032-03-21,2032-03-22,Transport for London,4111,Transport,Transit,-11.55,GBP,-189994.26,POS,London,GB,2219,user_001,,
41908236-3b96-4f53-8018-c65984f0dfc3,2032-03-21,2032-03-23,Amazon UK,5942,Shopping,Online Retail,-17.07,GBP,-190011.33,E-Com,London,GB,4488,user_001,,
a69602ca-01e0-407a-920e-aad5114731cc,2032-03-21,2032-03-23,Sainsbury's,5411,Groceries,Supermarket,-17.56,GBP,-190028.89,POS,London,GB,9074,user_001,,
ec0fd0b9-6d8a-467d-93a7-9aee0f1cdcd5,2032-03-21,2032-03-22,Amazon UK,5942,Shopping,Online Retail,-76.36,GBP,-190105.25,E-Com,London,GB,2219,user_001,,
f91a5655-0018-4e0b-8d9e-534b647e6551,2032-03-21,2032-03-22,Uber UK,4121,Transport,Ride Hailing,-35.08,GBP,-190140.33,E-Com,London,GB,2219,user_001,,
3bd46678-5207-4cac-afb9-51564035335a,2032-03-22,2032-03-23,Transport for London,4111,Transport,Transit,-11.26,GBP,-190151.59,POS,London,GB,4488,user_001,,
5354d863-97b0-47e6-a2e3-3a56640afa72,2032-03-22,2032-03-24,Netflix,7841,Entertainment,Subscriptions,-12.48,GBP,-190164.07,E-Com,Los Gatos,US,1045,user_001,rec_1bfe33738d,
f4e1f578-a195-4d4c-9fdd-14a83c4d1e40,2032-03-22,2032-03-24,Transport for London,4111,Transport,Transit,-7.59,GBP,-190171.66,POS,London,GB,2219,user_001,,
f5b6226e-cda9-49ab-b30a-d9e5f1643394,2032-03-22,2032-03-24,Waitrose,5411,Groceries,Supermarket,-56.28,GBP,-190227.94,POS,London,GB,2219,user_001,,
f81a4e1d-1202-4d77-82a1-6626193db925,2032-03-22,2032-03-23,Waitrose,5411,Groceries,Supermarket,-30.94,GBP,-190258.88,POS,London,GB,2219,user_001,,
232b9e2e-df54-4d45-a6d5-4ad51bf158f2,2032-03-23,2032-03-23,Amazon UK,5942,Shopping,Online Retail,-117.34,GBP,-190376.22,E-Com,London,GB,2219,user_001,,
f87cb600-c4b8-4d45-a200-dd101e5685ca,2032-03-23,2032-03-23,Uber UK,4121,Transport,Ride Hailing,-23.94,GBP,-190400.16,E-Com,London,GB,9074,user_001,,
4597597e-af30-4bcc-834c-c903aad52900,2032-03-25,2032-03-25,T212 Capital,6011,Income,Salary,3177.37,GBP,-187222.79,Credit,London,GB,2219,user_001,rec_2ff8f778d0,
5bc01cd7-e0db-4ca8-a63e-8f80975a864c,2032-03-25,2032-03-29,Tesco,5411,Groceries,Supermarket,-74.25,GBP,-187297.04,POS,London,GB,4488,user_002,,
665e06cd-a596-4a7d-9009-4ddebbbedbba,2032-03-25,2032-03-26,Sainsbury's,5411,Groceries,Supermarket,-28.08,GBP,-187325.12,POS,London,GB,9074,user_001,,
819091ff-2789-4e5f-b431-b3f661c78ee0,2032-03-25,2032-03-25,Tesco,5411,Groceries,Supermarket,-22.8,GBP,-187347.92,POS,London,GB,2219,user_001,,
b1a53bb1-b3fd-481a-9c57-574c5e005dae,2032-03-25,2032-03-25,Local Market,5499,Groceries,Specialty,-8.68,GBP,-187356.6,POS,London,GB,9074,user_001,,
2c45f42e-3f9b-4882-a39f-07cd6ff4dd6d,2032-03-26,2032-03-26,Amazon UK,5942,Shopping,Online Retail,-66.06,GBP,-187422.66,E-Com,London,GB,1045,user_001,,
6b3fc0e2-c262-40bb-93a7-3d823b371004,2032-03-26,2032-03-29,Pret A Manger,5814,Food & Drink,Eating Out,-10.84,GBP,-187433.5,POS,London,GB,2219,user_002,,
448cfded-a6ca-4ba9-b802-4f7f6b9d94b3,2032-03-27,2032-03-29,Amazon UK,5942,Shopping,Online Retail,-56.42,GBP,-187489.92,E-Com,London,GB,9074,user_001,,
5ed98324-c129-4fa9-88cc-06545d65feae,2032-03-27,2032-03-29,Shell,5541,Transport,Fuel,-37.93,GBP,-187527.85,POS,London,GB,4488,user_001,,
7af00db9-d1ed-458c-9da7-025f295d778c,2032-03-27,2032-03-29,Apple.com/bill,5734,Shopping,Electronics,-37.31,GBP,-187565.16,E-Com,Cupertino,US,9074,user_002,,
ac9a9a93-fc1d-4085-9f5d-c25c9735a139,2032-03-28,2032-03-30,Pret A Manger,5814,Food & Drink,Eating Out,-6.01,GBP,-187571.17,POS,London,GB,4488,user_001,,
d468be42-956d-42c5-8a70-9516d65e72c4,2032-03-29,2032-03-30,Uber UK,4121,Transport,Ride Hailing,-30.42,GBP,-187601.59,E-Com,London,GB,2219,user_001,,
10711e81-f01f-4c61-a483-8032c94a84f8,2032-03-30,2032-03-30,Transport for London,4111,Transport,Transit,-5.82,GBP,-187607.41,POS,London,GB,1045,user_001,,
5a113da2-01fd-40fa-a193-7c0df68d3359,2032-03-30,2032-04-01,Transport for London,4111,Transport,Transit,-3.77,GBP,-187611.18,POS,London,GB,1045,user_002,,
da70c7b6-22de-490a-a9e0-4bd87c13a4f1,2032-03-31,2032-03-31,ATM Withdrawal,6011,Cash,ATM,-118.98,GBP,-187730.16,ATM,London,GB,1045,user_002,,
79c2b77b-60fb-4a32-aead-318f14595cbf,2032-04-01,2032-04-05,Crown Estates Lettings,6513,Housing,Rent,-1490.49,GBP,-189220.65,POS,London,GB,1045,user_001,rec_19f70fbcce,
906e424b-7460-401d-859c-33d2044db42f,2032-04-01,2032-04-05,Amazon UK,5942,Shopping,Online Retail,-59.07,GBP,-189279.72,E-Com,London,GB,4488,user_001,,
fdcd89ea-cb24-4a5d-8acd-5f50fd4e4229,2032-04-01,2032-04-01,HM Revenue & Customs,9311,Income,Tax Refund,25.68,GBP,-189254.04,Credit,London,GB,4488,user_001,,Refund for Tesco
5dfee59d-0305-4b93-b2e1-a3828c56ded3,2032-04-02,2032-04-05,Uber UK,4121,Transport,Ride Hailing,-22.03,GBP,-189276.07,E-Com,London,GB,4488,user_001,,
02bc3085-51ba-4604-bcf1-7ca7c271bb13,2032-04-03,2032-04-05,Local Market,5499,Groceries,Specialty,-20.08,GBP,-189296.15,POS,London,GB,4488,user_002,,
552ced16-9e72-41ac-ae52-bb83627c0582,2032-04-03,2032-04-05,Local Market,5499,Groceries,Specialty,-17.29,GBP,-189313.44,POS,London,GB,2219,user_001,,
de192dbf-9444-4aa6-a7e7-8b2d793404aa,2032-04-03,2032-04-05,Deliveroo,5812,Food & Drink,Delivery,-27.98,GBP,-189341.42,E-Com,London,GB,9074,user_001,,
44a7075b-fe68-489c-aa42-163994e715ca,2032-04-04,2032-04-05,Deliveroo,5812,Food & Drink,Delivery,-24.06,GBP,-189365.48,E-Com,London,GB,9074,user_002,,
48e24eef-b1cc-496a-84bb-49968916ec0f,2032-04-04,2032-04-05,Deliveroo,5812,Food & Drink,Delivery,-25.61,GBP,-189391.09,E-Com,London,GB,2219,user_001,,
8e3bf04c-7dc0-415b-a5e9-93b013197c14,2032-04-04,2032-04-05,Shell,5541,Transport,Fuel,-43.08,GBP,-189434.17,POS,London,GB,4488,user_001,,
2a0f2763-83a4-4bec-a5cd-43af253db4ba,2032-04-07,2032-04-08,Octopus Energy,4900,Utilities,Electricity,-114.57,GBP,-189548.74,Direct Debit,London,GB,9074,user_002,rec_09c3f12b18,
c5a45c6d-992e-4e2d-bb8a-003505c41a34,2032-04-07,2032-04-07,Sainsbury's,5411,Groceries,Supermarket,-31.16,GBP,-189579.9,POS,London,GB,9074,user_001,,
eb11eede-b06a-4841-a710-79cb0319bf41,2032-04-07,2032-04-08,Waitrose,5411,Groceries,Supermarket,-85.88,GBP,-189665.78,POS,London,GB,9074,user_002,,
113b5e28-2ee2-4a96-9094-f4fb18a34f2f,2032-04-08,2032-04-09,Transport for London,4111,Transport,Transit,-11.08,GBP,-189676.86,POS,London,GB,4488,user_001,,
c87617a2-6720-45d7-917e-c2ae961fd269,2032-04-08,2032-04-08,HM Revenue & Customs,9311,Income,Tax Refund,21.72,GBP,-189655.14,Credit,London,GB,1045,user_001,,Refund for Waitrose
2b4007b3-9c67-4ca4-b1ef-b1ef869fcd60,2032-04-09,2032-04-12,Transport for London,4111,Transport,Transit,-11.79,GBP,-189666.93,POS,London,GB,2219,user_001,,
6f008d41-5940-431a-810e-e46476e1de95,2032-04-09,2032-04-12,Sainsbury's,5411,Groceries,Supermarket,-32.13,GBP,-189699.06,POS,London,GB,2219,user_001,,
eebe7ed4-0e75-4b39-87c6-3131d32e591a,2032-04-09,2032-04-09,Pret A Manger,5814,Food & Drink,Eating Out,-11.09,GBP,-189710.15,POS,London,GB,1045,user_001,,
2bb2d847-88df-4d5d-9ebb-6536b4b24792,2032-04-10,2032-04-12,Pret A Manger,5814,Food & Drink,Eating Out,-10.11,GBP,-189720.26,POS,London,GB,1045,user_001,,
8367f599-0a5d-4e0f-a0e4-3de1eb5c25b0,2032-04-10,2032-04-12,Pret A Manger,5814,Food & Drink,Eating Out,-7.93,GBP,-189728.19,POS,London,GB,4488,user_001,,
f4e3c9a7-88a9-4ab4-8c45-6fabbb46bc2d,2032-04-10,2032-04-12,Sainsbury's,5411,Groceries,Supermarket,-65.01,GBP,-189793.2,POS,London,GB,4488,user_001,,
43ab35a6-46a7-4b99-ba9e-ed6963b39008,2032-04-11,2032-04-13,Deliveroo,5812,Food & Drink,Delivery,-16.87,GBP,-189810.07,E-Com,London,GB,9074,user_001,,
f1c1f024-0ccf-4457-82d2-cd6af6f3392e,2032-04-11,2032-04-12,Amazon UK,5942,Shopping,Online Retail,-109.82,GBP,-189919.89,E-Com,London,GB,4488,user_001,,
579bc7d3-3084-4fda-8887-b213008d34f8,2032-04-12,2032-04-12,Sainsbury's,5411,Groceries,Supermarket,-54.01,GBP,-189973.9,POS,London,GB,2219,user_001,,
c2e2ce6e-24aa-40b9-9bb3-a48e5e596390,2032-04-12,2032-04-13,Thames Water,4900,Utilities,Water,-41.61,GBP,-190015.51,Direct Debit,Reading,GB,2219,user_001,rec_3a34d62842,
db0be2aa-95cb-4730-a7bf-f1dbfbcce38b,2032-04-12,2032-04-13,Pret A Manger,5814,Food & Drink,Eating Out,-5.96,GBP,-190021.47,POS,London,GB,4488,user_001,,
45a6d840-3778-41d7-8c3d-5749ac37ed98,2032-04-13,2032-04-13,City Council Tax,9399,Utilities,Council Tax,-162.08,GBP,-190183.55,Direct Debit,London,GB,2219,user_001,rec_f531495db5,
e6581020-ceda-4a69-99ab-4cff52b7d837,2032-04-13,2032-04-14,Sainsbury's,5411,Groceries,Supermarket,-22.39,GBP,-190205.94,POS,London,GB,2219,user_001,,
3a79cbcd-b064-4226-8522-0f9e709876bc,2032-04-14,2032-04-16,Transport for London,4111,Transport,Transit,-4.52,GBP,-190210.46,POS,London,GB,2219,user_001,,
4f51842f-d116-4826-8647-2376b2a2b9c1,2032-04-14,2032-04-15,Local Market,5499,Groceries,Specialty,-18.79,GBP,-190229.25,POS,London,GB,4488,user_002,,
20172c82-41a8-4076-8fec-2fdfa44a90f6,2032-04-15,2032-04-16,O2 UK,4814,Bills,Mobile,-50.26,GBP,-190279.51,Direct Debit,Slough,GB,2219,user_002,rec_d2dce4c42f,
8802fa05-b21a-47ec-9835-7002aa8701fb,2032-04-15,2032-04-15,Transport for London,4111,Transport,Transit,-5.25,GBP,-190284.76,POS,London,GB,4488,user_002,,
b9703944-6819-4995-b0fa-a1ebbccd81fd,2032-04-15,2032-04-19,Transport for London,4111,Transport,Transit,-8.18,GBP,-190292.94,POS,London,GB,1045,user_001,,
cdc63aa7-d9c0-42c3-8cf8-60f4188f93dd,2032-04-16,2032-04-19,Waitrose,5411,Groceries,Supermarket,-89.8,GBP,-190382.74,POS,London,GB,9074,user_001,,
2713aea7-8d63-4feb-b798-ce81f3ab11b7,2032-04-17,2032-04-19,Apple.com/bill,5734,Shopping,Electronics,-182.07,GBP,-190564.81,E-Com,Cupertino,US,1045,user_001,,
89337f57-5ce8-435f-9717-132eddce9efa,2032-04-17,2032-04-19,Waitrose,5411,Groceries,Supermarket,-43.01,GBP,-190607.82,POS,London,GB,4488,user_001,,
350a9d9f-331f-4aff-8f78-60405e9d3767,2032-04-18,2032-04-20,Pret A Manger,5814,Food & Drink,Eating Out,-9.91,GBP,-190617.73,POS,London,GB,4488,user_001,,
55ce0994-3449-46bd-958a-6d997ba6a61a,2032-04-18,2032-04-20,Waitrose,5411,Groceries,Supermarket,-29.92,GBP,-190647.65,POS,London,GB,9074,user_001,,
e3ab8cbc-9e54-4615-bfa3-0dd3a0301261,2032-04-18,2032-04-19,Sainsbury's,5411,Groceries,Supermarket,-56.73,GBP,-190704.38,POS,London,GB,2219,user_001,,
f0499990-64fc-42eb-ba40-7b855b46c8cf,2032-04-18,2032-04-19,Waitrose,5411,Groceries,Supermarket,-59.28,GBP,-190763.66,POS,London,GB,1045,user_001,,
2de3c91a-8b48-4c9e-bf0a-222ac630b090,2032-04-19,2032-04-21,GymBox,7997,Wellness,Gym,-45.88,GBP,-190809.54,Direct Debit,London,GB,4488,user_001,rec_3906953fd2,
4adb6b25-0e36-4328-a54f-1bafac759443,2032-04-19,2032-04-19,Spotify,5735,Entertainment,Subscriptions,-9.54,EUR,-190819.08,E-Com,Stockholm,SE,1045,user_002,rec_34b6e9e33f,FX purchase 10.83 EUR @ rate 1.14
4f1c5106-d263-41e2-82b4-cecbcafcba69,2032-04-19,2032-04-19,Waitrose,5411,Groceries,Supermarket,-58.29,GBP,-190877.37,POS,London,GB,4488,user_001,,
8dc8cdb7-3e4c-40e7-8b2e-cb921151d575,2032-04-19,2032-04-20,Uber UK,4121,Transport,Ride Hailing,-10.56,GBP,-190887.93,E-Com,London,GB,4488,user_001,,
0cfc8f7e-2526-456e-9756-49f8c194c0a6,2032-04-20,2032-04-22,Tesco,5411,Groceries,Supermarket,-63.67,GBP,-190951.6,POS,London,GB,2219,user_001,,
23aadfc0-9516-4002-a402-b55de2331abf,2032-04-20,2032-04-22,Sainsbury's,5411,Groceries,Supermarket,-54.82,GBP,-191006.42,POS,London,GB,2219,user_001,,
285d6d4e-2371-46e1-8165-c09bcf0f9432,2032-04-20,2032-04-21,Waitrose,5411,Groceries,Supermarket,-72.19,GBP,-191078.61,POS,London,GB,2219,user_001,,
769c93bc-f68e-44d2-ac9b-da66ef96f5d9,2032-04-20,2032-04-20,Sainsbury's,5411,Groceries,Supermarket,-56.21,GBP,-191134.82,POS,London,GB,1045,user_001,,
3c1b2684-bfc7-4c16-8a4e-090ad2217ecd,2032-04-21,2032-04-23,Local Market,5499,Groceries,Specialty,-21.9,GBP,-191156.72,POS,London,GB,2219,user_001,,
a756fd44-8e48-41a2-bbd5-6e19bba67442,2032-04-21,2032-04-21,Netflix,7841,Entertainment,Subscriptions,-12.14,GBP,-191168.86,E-Com,Los Gatos,US,9074,user_001,rec_1bfe33738d,
de9382a8-492e-4dda-ad89-2f051b27210b,2032-04-21,2032-04-22,Sainsbury's,5411,Groceries,Supermarket,-22.05,GBP,-191190.91,POS,London,GB,4488,user_001,,
4e00f0cc-f315-4a70-8b50-6c129a0ed7b0,2032-04-22,2032-04-26,Local Market,5499,Groceries,Specialty,-7.71,GBP,-191198.62,POS,London,GB,4488,user_001,,
68dd9443-5e0e-4017-8e58-2377c32aadea,2032-04-22,2032-04-23,Deliveroo,5812,Food & Drink,Delivery,-19.7,GBP,-191218.32,E-Com,London,GB,1045,user_001,,
1c8403a5-a5eb-488a-b2d9-53bdbb627190,2032-04-23,2032-04-23,T212 Capital,6011,Income,Salary,3114.23,GBP,-188104.09,Credit,London,GB,1045,user_002,rec_c649d24d0f,
68635f17-fb97-4d59-aeae-f57762928171,2032-04-23,2032-04-23,Tesco,5411,Groceries,Supermarket,-69.31,GBP,-188173.4,POS,London,GB,9074,user_002,,
746ebf54-3582-499a-96ee-3970b9d60d73,2032-04-23,2032-04-23,Amazon UK,5942,Shopping,Online Retail,-33.73,GBP,-188207.13,E-Com,London,GB,9074,user_001,,
a1540bfb-1a52-4ae0-8019-eb94f6925fb3,2032-04-23,2032-04-26,Uber UK,4121,Transport,Ride Hailing,-26.86,GBP,-188233.99,E-Com,London,GB,9074,user_001,,
b4a32ae6-3527-4ad6-b73d-5e24f27a0d00,2032-04-23,2032-04-26,Tesco,5411,Groceries,Supermarket,-25.37,GBP,-188259.36,POS,London,GB,2219,user_001,,
9392d51f-638b-42ab-ade6-050f31e9ded9,2032-04-24,2032-04-26,Shell,5541,Transport,Fuel,-62.67,GBP,-188322.03,POS,London,GB,2219,user_002,,
a11bb01b-92f1-49cb-8b6d-32c2b71e5758,2032-04-24,2032-04-26,Local Market,5499,Groceries,Specialty,-19.8,GBP,-188341.83,POS,London,GB,2219,user_001,,
535bb650-9b2a-43dd-bd66-8f8f823869e4,2032-04-25,2032-04-26,Waitrose,5411,Groceries,Supermarket,-46.78,GBP,-188388.61,POS,London,GB,1045,user_001,,
5b34e858-1542-40a9-9916-58aeeec911ff,2032-04-25,2032-04-26,Tesco,5411,Groceries,Supermarket,-24.7,GBP,-188413.31,POS,London,GB,9074,user_001,,
842693ce-812b-4d0a-ab63-beff5fd18d02,2032-04-25,2032-04-26,Amazon UK,5942,Shopping,Online Retail,-81.76,GBP,-188495.07,E-Com,London,GB,2219,user_001,,
49fceff6-39b0-4391-9372-98de9c1b46ef,2032-04-26,2032-04-28,Pret A Manger,5814,Food & Drink,Eating Out,-9.79,GBP,-188504.86,POS,London,GB,1045,user_002,,
ab48aedb-877d-4243-8553-dd2d83716263,2032-04-26,2032-04-28,Local Market,5499,Groceries,Specialty,-10.64,GBP,-188515.5,POS,London,GB,9074,user_001,,
f7cede0d-cc4b-44ed-8540-7f7d7c35f7a3,2032-04-26,2032-04-26,Uber UK,4121,Transport,Ride Hailing,-30.87,GBP,-188546.37,E-Com,London,GB,9074,user_002,,
fabf9a40-d00b-4b90-b2fd-37ffd9fa79e2,2032-04-27,2032-04-29,Amazon UK,5942,Shopping,Online Retail,-103.68,GBP,-188650.05,E-Com,London,GB,9074,user_002,,
023f6dee-2a9c-4366-91be-98f23267948e,2032-04-29,2032-05-03,Amazon UK,5942,Shopping,Online Retail,-46.73,GBP,-188696.78,E-Com,London,GB,9074,user_002,,
ea9712a5-fc6b-425e-b8c4-e4b61973e1b4,2032-04-29,2032-04-30,Waitrose,5411,Groceries,Supermarket,-51.83,GBP,-188748.61,POS,London,GB,1045,user_001,,
03973e06-047f-4a71-8d36-9ab031b20130,2032-04-30,2032-05-03,Amazon UK,5942,Shopping,Online Retail,-71.36,GBP,-188819.97,E-Com,London,GB,9074,user_001,,
0ded6777-57eb-42ec-a7dc-d3ed0991be1c,2032-05-01,2032-05-03,Apple.com/bill,5734,Shopping,Electronics,-136.35,GBP,-188956.32,E-Com,Cupertino,US,4488,user_001,,
101db35d-1910-43f5-b7ad-4da14aee3d4e,2032-05-02,2032-05-03,Transport for London,4111,Transport,Transit,-9.34,GBP,-188965.66,POS,London,GB,4488,user_001,,
3981e56a-0244-4527-bcdd-db81d569f320,2032-05-02,2032-05-03,Local Market,5499,Groceries,Specialty,-19.39,GBP,-188985.05,POS,London,GB,4488,user_001,,
b7c1c82c-4a84-4b91-b052-df04483e4940,2032-05-02,2032-05-04,Deliveroo,5812,Food & Drink,Delivery,-22.82,GBP,-189007.87,E-Com,London,GB,4488,user_001,,
ba39509b-484d-43f0-a1cd-330b30563145,2032-05-02,2032-05-04,Shell,5541,Transport,Fuel,-55.51,GBP,-189063.38,POS,London,GB,2219,user_001,,
d5a8791a-77e5-4e57-a97f-1b2c626c85ad,2032-05-02,2032-05-04,Apple.com/bill,5734,Shopping,Electronics,-135.63,GBP,-189199.01,E-Com,Cupertino,US,4488,user_002,,
da935f48-35c5-4c5b-b05b-e4743864f5f8,2032-05-02,2032-05-03,Shell,5541,Transport,Fuel,-52.37,GBP,-189251.38,POS,London,GB,4488,user_001,,
fcdbb0df-987f-408b-879d-57155bcac807,2032-05-02,2032-05-04,Tesco,5411,Groceries,Supermarket,-21.59,GBP,-189272.97,POS,London,GB,4488,user_002,,
1cc47a2f-293c-45f7-9d44-2a628b1675a7,2032-05-03,2032-05-03,Crown Estates Lettings,6513,Housing,Rent,-1549.83,GBP,-190822.8,POS,London,GB,1045,user_001,rec_19f70fbcce,
64cba4d9-554b-4a8d-8de8-abe4fb328c50,2032-05-03,2032-05-03,Waitrose,5411,Groceries,Supermarket,-51.49,GBP,-190874.29,POS,London,GB,4488,user_002,,
76d44499-4985-407f-8ea0-026b3947f6df,2032-05-03,2032-05-04,Local Market,5499,Groceries,Specialty,-10.79,GBP,-190885.08,POS,London,GB,9074,user_001,,
8dd50ed8-7f19-4d54-a7e3-317b57ba655d,2032-05-03,2032-05-05,Uber UK,4121,Transport,Ride Hailing,-28.86,GBP,-190913.94,E-Com,London,GB,4488,user_002,,
a476b00d-7b7a-4f00-a80e-e03a54f9a6c9,2032-05-03,2032-05-04,Transport for London,4111,Transport,Transit,-7.07,GBP,-190921.01,POS,London,GB,9074,user_001,,
f6801e63-0048-4804-9454-ca43992e2d28,2032-05-04,2032-05-06,Sainsbury's,5411,Groceries,Supermarket,-36.15,GBP,-190957.16,POS,London,GB,9074,user_001,,
a9d544ea-c470-4966-abe4-c4ab70eca869,2032-05-05,2032-05-06,Pret A Manger,5814,Food & Drink,Eating Out,-11.52,GBP,-190968.68,POS,London,GB,4488,user_001,,
17c27bb9-be1e-4a47-96e8-63f5f144e435,2032-05-07,2032-05-07,Waitrose,5411,Groceries,Supermarket,-30.08,GBP,-190998.76,POS,London,GB,4488,user_002,,
61827cb4-151b-4a85-9fb7-2fdc14741aa8,2032-05-07,2032-05-07,Octopus Energy,4900,Utilities,Electricity,-137.04,GBP,-191135.8,Direct Debit,London,GB,1045,user_001,rec_141a4a0666,
8beba7a9-a821-4200-8d37-f0c55b2843df,2032-05-07,2032-05-07,Deliveroo,5812,Food & Drink,Delivery,-17.62,GBP,-191153.42,E-Com,London,GB,9074,user_001,,
7082f7d9-39c8-4957-bd55-3a859ce45ba1,2032-05-08,2032-05-10,Pret A Manger,5814,Food & Drink,Eating Out,-9.3,GBP,-191162.72,POS,London,GB,9074,user_001,,
c4c00a73-d662-4740-9fce-07202d4dc16a,2032-05-08,2032-05-10,Apple.com/bill,5734,Shopping,Electronics,-86.48,USD,-191249.2,E-Com,Cupertino,US,1045,user_002,,FX purchase 108.43 USD @ rate 1.25
c6c3f588-36cc-4985-9488-c0fb89bd4831,2032-05-08,2032-05-10,Local Market,5499,Groceries,Specialty,-19.42,GBP,-191268.62,POS,London,GB,4488,user_001,,
6a1ba553-66dc-42ec-8474-02ca0c627382,2032-05-09,2032-05-10,Local Market,5499,Groceries,Specialty,-19.45,GBP,-191288.07,POS,London,GB,2219,user_002,,
bdf237d9-8b7b-4cc7-916b-7012a446cf27,2032-05-10,2032-05-11,Shell,5541,Transport,Fuel,-92.21,GBP,-191380.28,POS,London,GB,1045,user_001,,
0bf720c4-ca6e-4f4f-adf1-e3599dcd90f4,2032-05-11,2032-05-12,Pret A Manger,5814,Food & Drink,Eating Out,-8.14,GBP,-191388.42,POS,London,GB,2219,user_001,,
28e9c85a-2666-4fdc-82f5-2b898d86738f,2032-05-11,2032-05-12,Uber UK,4121,Transport,Ride Hailing,-13.03,GBP,-191401.45,E-Com,London,GB,2219,user_001,,
5708b091-23fe-44d8-bdbb-0a8eb955951e,2032-05-11,2032-05-12,Local Market,5499,Groceries,Specialty,-14.19,GBP,-191415.64,POS,London,GB,9074,user_001,,
94080ca4-f78d-4821-804e-f1c354c86b2d,2032-05-11,2032-05-12,Thames Water,4900,Utilities,Water,-41.4,GBP,-191457.04,Direct Debit,Reading,GB,9074,user_001,rec_3a34d62842,
ab21cbc2-83ca-4b79-8666-877d8d84f07e,2032-05-11,2032-05-12,Amazon UK,5942,Shopping,Online Retail,-116.37,GBP,-191573.41,E-Com,London,GB,4488,user_002,,
6ceb0345-1558-43a5-9414-80c54b0f78e2,2032-05-13,2032-05-14,City Council Tax,9399,Utilities,Council Tax,-164.04,GBP,-191737.45,Direct Debit,London,GB,2219,user_001,rec_f531495db5,
b83c1411-b929-4236-9b58-c3e3d6ba8935,2032-05-13,2032-05-13,Uber UK,4121,Transport,Ride Hailing,-31.84,GBP,-191769.29,E-Com,London,GB,9074,user_001,,
fd173742-a106-4daf-9771-622273d6eea2,2032-05-13,2032-05-17,Transport for London,4111,Transport,Transit,-3.95,GBP,-191773.24,POS,London,GB,4488,user_001,,
3254a1b5-4a02-415a-82bf-9c392073dd1f,2032-05-14,2032-05-17,Uber UK,4121,Transport,Ride Hailing,-18.04,GBP,-191791.28,E-Com,London,GB,2219,user_001,,
eabc9f04-ee8a-4d7a-8a4a-440ef20779a8,2032-05-14,2032-05-17,Sainsbury's,5411,Groceries,Supermarket,-65.25,GBP,-191856.53,POS,London,GB,2219,user_001,,
fe80f831-be3a-4306-a72f-3df720c1dad1,2032-05-14,2032-05-17,Sainsbury's,5411,Groceries,Supermarket,-15.32,GBP,-191871.85,POS,London,GB,2219,user_001,,
307e66a8-3c06-43c0-8882-00d3d24a1439,2032-05-15,2032-05-17,Tesco,5411,Groceries,Supermarket,-58.62,GBP,-191930.47,POS,London,GB,4488,user_002,,
487cf31a-fbc5-403f-a55b-f5f0a7f00e27,2032-05-15,2032-05-17,Waitrose,5411,Groceries,Supermarket,-71.79,GBP,-192002.26,POS,London,GB,2219,user_001,,
5d9cfb5c-d424-4a21-9b69-433459e8acc5,2032-05-15,2032-05-17,Sainsbury's,5411,Groceries,Supermarket,-51.59,GBP,-192053.85,POS,London,GB,4488,user_001,,
b0a06f86-7ff5-469e-ab7a-8a09aeb6e95a,2032-05-15,2032-05-17,Waitrose,5411,Groceries,Supermarket,-26.52,GBP,-192080.37,POS,London,GB,2219,user_002,,
2e591469-d411-4cd1-bc4f-bb3fef8d9716,2032-05-16,2032-05-17,Tesco,5411,Groceries,Supermarket,-82.13,GBP,-192162.5,POS,London,GB,2219,user_001,,
460a8766-2161-4a6b-a9ee-d39db2ba1b03,2032-05-16,2032-05-18,Sainsbury's,5411,Groceries,Supermarket,-45.65,GBP,-192208.15,POS,London,GB,2219,user_001,,
d9f803a8-4b1a-44c5-bbfb-38b60195559d,2032-05-16,2032-05-18,Waitrose,5411,Groceries,Supermarket,-86.32,GBP,-192294.47,POS,London,GB,4488,user_002,,
2b711e5a-04e1-489f-bf0d-feba92cc2705,2032-05-17,2032-05-19,O2 UK,4814,Bills,Mobile,-39.65,GBP,-192334.12,Direct Debit,Slough,GB,4488,user_001,rec_95042d8101,
59d77bd5-28ba-4445-802b-7612d7305338,2032-05-17,2032-05-18,GymBox,7997,Wellness,Gym,-49.32,GBP,-192383.44,Direct Debit,London,GB,4488,user_001,rec_3906953fd2,
6c19423b-ce37-4527-afce-5bc4547633ed,2032-05-17,2032-05-19,Tesco,5411,Groceries,Supermarket,-54.53,GBP,-192437.97,POS,London,GB,2219,user_001,,
6cf09fa7-00e7-480a-9b84-332bbd772614,2032-05-17,2032-05-17,Uber UK,4121,Transport,Ride Hailing,-14.71,GBP,-192452.68,E-Com,London,GB,4488,user_001,,
ae61526f-694b-4368-bac6-b082eaff80ee,2032-05-17,2032-05-18,Apple.com/bill,5734,Shopping,Electronics,-193.74,GBP,-192646.42,E-Com,Cupertino,US,2219,user_001,,
f3129629-de6a-4f17-9482-3162e1024553,2032-05-17,2032-05-17,Sainsbury's,5411,Groceries,Supermarket,-24.07,GBP,-192670.49,POS,London,GB,2219,user_001,,
f5b682ce-af6e-42fe-b1aa-4ff47e081f2b,2032-05-18,2032-05-20,Tesco,5411,Groceries,Supermarket,-84.92,GBP,-192755.41,POS,London,GB,1045,user_001,,
07be1d09-c623-4327-b2b0-26db8fb0dbec,2032-05-19,2032-05-19,Spotify,5735,Entertainment,Subscriptions,-8.44,GBP,-192763.85,E-Com,Stockholm,SE,1045,user_001,rec_4c746d2c3b,
3056241d-aa7a-427d-a64d-26b7e847164c,2032-05-19,2032-05-20,Local Market,5499,Groceries,Specialty,-11.59,GBP,-192775.44,POS,London,GB,2219,user_001,,
97fa1b64-6942-489e-9187-a388bfc92311,2032-05-19,2032-05-20,Transport for London,4111,Transport,Transit,-7.04,GBP,-192782.48,POS,London,GB,2219,user_002,,
1e153955-6307-4f1e-a4b1-ba5ab108a359,2032-05-20,2032-05-21,Apple.com/bill,5734,Shopping,Electronics,-155.64,GBP,-192938.12,E-Com,Cupertino,US,1045,user_001,,
417476f9-4efc-4da2-b5ea-cf3335792226,2032-05-20,2032-05-24,Pret A Manger,5814,Food & Drink,Eating Out,-8.22,GBP,-192946.34,POS,London,GB,4488,user_002,,
46173643-edbb-4a7d-ac09-cb3d4cfc9ee4,2032-05-20,2032-05-24,Uber UK,4121,Transport,Ride Hailing,-34.95,GBP,-192981.29,E-Com,London,GB,2219,user_002,,
75fab860-4a64-45e1-8ef2-b2f4c4664b50,2032-05-20,2032-05-24,Uber UK,4121,Transport,Ride Hailing,-29.71,GBP,-193011.0,E-Com,London,GB,1045,user_001,,
cc49c4b5-9cf2-440e-a807-1f3ea52962da,2032-05-20,2032-05-20,Sainsbury's,5411,Groceries,Supermarket,-50.54,GBP,-193061.54,POS,London,GB,2219,user_002,,
b9e21b28-ee4f-491f-a6c0-7a9a5a3a48c7,2032-05-21,2032-05-24,Netflix,7841,Entertainment,Subscriptions,-12.96,USD,-193074.5,E-Com,Los Gatos,US,4488,user_001,rec_1bfe33738d,FX purchase 15.99 USD @ rate 1.23
cb08dffb-c5d5-4810-bcce-e1d370fe493f,2032-05-21,2032-05-21,Amazon UK,5942,Shopping,Online Retail,-105.98,GBP,-193180.48,E-Com,London,GB,9074,user_002,,
66a1c986-f8f2-4ea8-b149-e73aeaa98325,2032-05-22,2032-05-24,Deliveroo,5812,Food & Drink,Delivery,-29.19,GBP,-193209.67,E-Com,London,GB,4488,user_001,,
0a63c685-55cd-4a21-8f97-c37f97d72b22,2032-05-23,2032-05-24,Amazon UK,5942,Shopping,Online Retail,-20.01,GBP,-193229.68,E-Com,London,GB,4488,user_001,,
250d817c-ef93-4ddd-a2c5-8c4bfbbd6eed,2032-05-23,2032-05-24,Sainsbury's,5411,Groceries,Supermarket,-22.9,GBP,-193252.58,POS,London,GB,2219,user_001,,
f5e052f6-a7b2-4255-8a74-5dc0d8bd7f7f,2032-05-23,2032-05-25,Tesco,5411,Groceries,Supermarket,-29.58,GBP,-193282.16,POS,London,GB,4488,user_001,,
fccab99d-a86b-4ffd-bbe3-9cd6b242fe86,2032-05-23,2032-05-24,ATM Withdrawal,6011,Cash,ATM,-76.91,GBP,-193359.07,ATM,London,GB,1045,user_001,,
8685150f-6d17-4aba-90e0-2c77a0c1f8c6,2032-05-24,2032-05-25,Uber UK,4121,Transport,Ride Hailing,-8.28,GBP,-193367.35,E-Com,London,GB,9074,user_001,,
6d8d888f-ee1b-4118-93fa-293c79a4f6f3,2032-05-25,2032-05-27,Apple.com/bill,5734,Shopping,Electronics,-141.33,GBP,-193508.68,E-Com,Cupertino,US,4488,user_001,,
c884e786-da0b-4aac-9c52-933c5429fa7c,2032-05-25,2032-05-25,T212 Capital,6011,Income,Salary,3047.63,GBP,-190461.05,Credit,London,GB,4488,user_001,rec_2ff8f778d0,
eccabaa3-2283-4ae9-b959-7c30b92e403e,2032-05-25,2032-05-25,Uber UK,4121,Transport,Ride Hailing,-27.98,GBP,-190489.03,E-Com,London,GB,1045,user_001,,
f1b16c06-bf73-493a-bca4-8342d5cf6de9,2032-05-25,2032-05-25,Amazon UK,5942,Shopping,Online Retail,-54.52,GBP,-190543.55,E-Com,London,GB,9074,user_001,,
1f335f30-f580-4af7-9c0f-371fafcc5ff0,2032-05-26,2032-05-26,Transport for London,4111,Transport,Transit,-8.32,GBP,-190551.87,POS,London,GB,4488,user_001,,
bfc11b07-1692-493c-88ab-89f31b868c8f,2032-05-27,2032-05-27,Transport for London,4111,Transport,Transit,-5.35,GBP,-190557.22,POS,London,GB,4488,user_001,,
cb037c18-16a1-414b-9e1c-ccd0ae9f5e43,2032-05-27,2032-05-31,Waitrose,5411,Groceries,Supermarket,-38.03,GBP,-190595.25,POS,London,GB,9074,user_001,,
e6ba0d35-6062-4563-93c4-1c389d6f59fa,2032-05-27,2032-05-27,Local Market,5499,Groceries,Specialty,-9.32,GBP,-190604.57,POS,London,GB,9074,user_001,,
1cdc13d6-646d-4fe7-bc73-d5002f1c6d24,2032-05-28,2032-05-28,Amazon UK,5942,Shopping,Online Retail,-117.73,GBP,-190722.3,E-Com,London,GB,4488,user_002,,
b417bd12-ec7f-49e9-a825-59a6c496fde9,2032-05-28,2032-05-28,Uber UK,4121,Transport,Ride Hailing,-21.22,GBP,-190743.52,E-Com,London,GB,9074,user_001,,
cfc0d5d9-22a9-487e-941d-b2d5e5b9c3c4,2032-05-28,2032-05-31,Tesco,5411,Groceries,Supermarket,-18.09,GBP,-190761.61,POS,London,GB,1045,user_001,,
efe9363a-0d0e-436c-901a-c707b65d1615,2032-05-28,2032-05-31,Local Market,5499,Groceries,Specialty,-7.41,GBP,-190769.02,POS,London,GB,1045,user_001,,
6acc3dec-a531-4b0d-a4ba-b871ea0cf88a,2032-05-29,2032-05-31,Apple.com/bill,5734,Shopping,Electronics,-50.45,USD,-190819.47,E-Com,Cupertino,US,1045,user_001,,FX purchase 62.45 USD @ rate 1.24
92a5339a-de3c-4982-a490-cb7fb283d049,2032-05-29,2032-05-31,Uber UK,4121,Transport,Ride Hailing,-18.02,GBP,-190837.49,E-Com,London,GB,9074,user_002,,
c2a98e72-03d4-4682-99a3-eee479d27e0c,2032-05-29,2032-05-31,Uber UK,4121,Transport,Ride Hailing,-23.89,GBP,-190861.38,E-Com,London,GB,1045,user_001,,
e025a169-221d-4396-b374-9bb88a165d81,2032-05-29,2032-05-31,Shell,5541,Transport,Fuel,-93.67,GBP,-190955.05,POS,London,GB,9074,user_001,,
56238b3a-007c-43ff-b220-b8325ee784e1,2032-05-30,2032-05-31,Pret A Manger,5814,Food & Drink,Eating Out,-9.71,GBP,-190964.76,POS,London,GB,2219,user_001,,
5d5fdc08-ec1f-45b6-b673-71824070812c,2032-05-30,2032-05-31,Amazon UK,5942,Shopping,Online Retail,-23.66,GBP,-190988.42,E-Com,London,GB,9074,user_001,,
75f0523e-cda9-4cae-bb00-3aed69cb4490,2032-05-30,2032-05-31,Tesco,5411,Groceries,Supermarket,-42.77,GBP,-191031.19,POS,London,GB,1045,user_001,,
df07b0b2-ebfd-4089-bae5-491741d38375,2032-05-30,2032-05-31,Transport for London,4111,Transport,Transit,-11.93,GBP,-191043.12,POS,London,GB,1045,user_002,,
e3437a9c-4159-4d5a-95c3-f48f0ec9e0b6,2032-05-30,2032-05-31,Uber UK,4121,Transport,Ride Hailing,-21.61,GBP,-191064.73,E-Com,London,GB,4488,user_001,,
2e4e9c44-2b59-4115-935c-fdf94437274b,2032-05-31,2032-06-02,Amazon UK,5942,Shopping,Online Retail,-48.74,GBP,-191113.47,E-Com,London,GB,2219,user_001,,
4512de02-a952-4b03-9863-f750e817cc32,2032-05-31,2032-06-01,Waitrose,5411,Groceries,Supermarket,-53.06,GBP,-191166.53,POS,London,GB,1045,user_001,,
7dd06270-bec2-4e22-a9ec-a08419934a13,2032-05-31,2032-06-01,Transport for London,4111,Transport,Transit,-10.34,GBP,-191176.87,POS,London,GB,4488,user_002,,
a1236e95-f789-424f-a150-b5269716f1a2,2032-05-31,2032-06-02,Apple.com/bill,5734,Shopping,Electronics,-28.36,GBP,-191205.23,E-Com,Cupertino,US,4488,user_001,,
99c79bcc-b336-42f0-97fa-8a92ae6d75fe,2032-06-01,2032-06-02,Crown Estates Lettings,6513,Housing,Rent,-1627.65,GBP,-192832.88,POS,London,GB,4488,user_001,rec_19f70fbcce,
1e6b308e-c96a-4163-a4dc-67669bb10630,2032-06-04,2032-06-07,Uber UK,4121,Transport,Ride Hailing,-10.22,GBP,-192843.1,E-Com,London,GB,9074,user_001,,
f0bd599a-01ad-4fd0-ab74-e3784c56c231,2032-06-04,2032-06-07,Pret A Manger,5814,Food & Drink,Eating Out,-10.2,GBP,-192853.3,POS,London,GB,4488,user_001,,
29173ede-2e52-44a5-9e1a-cc13eda2f3e2,2032-06-05,2032-06-07,Apple.com/bill,5734,Shopping,Electronics,-15.72,GBP,-192869.02,E-Com,Cupertino,US,1045,user_001,,
f4ddf9ef-bc59-45a4-94d2-1c23a27c80f9,2032-06-05,2032-06-07,Deliveroo,5812,Food & Drink,Delivery,-27.15,GBP,-192896.17,E-Com,London,GB,2219,user_001,,
fe7f1677-741e-4b94-9275-8bc555fd3819,2032-06-06,2032-06-07,Pret A Manger,5814,Food & Drink,Eating Out,-8.23,GBP,-192904.4,POS,London,GB,2219,user_001,,
1bff69a1-a31b-4475-ba91-a2e423db937f,2032-06-07,2032-06-07,Amazon UK,5942,Shopping,Online Retail,-72.78,GBP,-192977.18,E-Com,London,GB,1045,user_001,,
95af99d4-f019-49c2-862d-bfb39043fb71,2032-06-07,2032-06-09,Octopus Energy,4900,Utilities,Electricity,-136.29,GBP,-193113.47,Direct Debit,London,GB,1045,user_001,rec_141a4a0666,
a2e66f50-cd42-49d6-a9c3-871080415160,2032-06-07,2032-06-09,Sainsbury's,5411,Groceries,Supermarket,-47.29,GBP,-193160.76,POS,London,GB,9074,user_001,,
23e7f4b8-5c36-4fd2-b4cd-d80701103f05,2032-06-08,2032-06-10,Local Market,5499,Groceries,Specialty,-7.4,GBP,-193168.16,POS,London,GB,1045,user_001,,
4b173aaa-6a0f-4da8-bcbd-ba01bc71d272,2032-06-08,2032-06-08,ATM Withdrawal,6011,Cash,ATM,-83.91,GBP,-193252.07,ATM,London,GB,4488,user_002,,
e43bd0d5-1e0c-4d82-9fbc-76dc4e1b7bf0,2032-06-08,2032-06-10,Uber UK,4121,Transport,Ride Hailing,-11.73,GBP,-193263.8,E-Com,London,GB,1045,user_001,,
dfddbb19-3c9f-441b-a700-215316652a84,2032-06-09,2032-06-10,Deliveroo,5812,Food & Drink,Delivery,-30.45,GBP,-193294.25,E-Com,London,GB,1045,user_001,,
1c485a37-02de-43a2-a6c9-18004b67a58b,2032-06-10,2032-06-11,Shell,5541,Transport,Fuel,-42.64,GBP,-193336.89,POS,London,GB,4488,user_002,,
648c2190-c299-40f3-9130-c56fed3f5d56,2032-06-10,2032-06-11,Sainsbury's,5411,Groceries,Supermarket,-65.32,GBP,-193402.21,POS,London,GB,2219,user_001,,
5453ce3f-bc6d-4348-865e-cd9d23bf32c8,2032-06-11,2032-06-14,Waitrose,5411,Groceries,Supermarket,-70.44,GBP,-193472.65,POS,London,GB,9074,user_002,,
8394d6a6-0c55-4586-ab3b-8c12ef5524da,2032-06-11,2032-06-14,Thames Water,4900,Utilities,Water,-43.33,GBP,-193515.98,Direct Debit,Reading,GB,1045,user_001,rec_3a34d62842,
d1d507d7-6f1f-49eb-be1b-fa895b3d6226,2032-06-11,2032-06-11,Apple.com/bill,5734,Shopping,Electronics,-194.28,GBP,-193710.26,E-Com,Cupertino,US,2219,user_001,,
93830727-e134-463c-9641-27c0c505e187,2032-06-12,2032-06-14,Apple.com/bill,5734,Shopping,Electronics,-88.49,GBP,-193798.75,E-Com,Cupertino,US,2219,user_001,,
a39c3593-34d5-4844-9304-e36d3e2b082b,2032-06-12,2032-06-14,Apple.com/bill,5734,Shopping,Electronics,-141.33,GBP,-193940.08,E-Com,Cupertino,US,2219,user_001,,
e14aa10f-cd5d-4d26-8aa8-dc47697db0e7,2032-06-12,2032-06-14,Apple.com/bill,5734,Shopping,Electronics,-38.58,GBP,-193978.66,E-Com,Cupertino,US,1045,user_002,,
e9ede9dd-51d6-4370-ae20-86e8c65d2e31,2032-06-12,2032-06-14,Tesco,5411,Groceries,Supermarket,-46.37,GBP,-194025.03,POS,London,GB,9074,user_001,,
04d26541-614c-4daf-b83a-7f083f524bc9,2032-06-13,2032-06-14,Local Market,5499,Groceries,Specialty,-20.76,GBP,-194045.79,POS,London,GB,9074,user_001,,
0edc2e02-61a8-4fe0-a37f-7e897925d4ad,2032-06-13,2032-06-14,Tesco,5411,Groceries,Supermarket,-35.9,GBP,-194081.69,POS,London,GB,4488,user_001,,
5042abf9-a508-40a8-abb3-9807dadfc073,2032-06-13,2032-06-14,Sainsbury's,5411,Groceries,Supermarket,-21.35,GBP,-194103.04,POS,London,GB,9074,user_001,,
57c6faa6-429c-4d41-afbc-e247ce06078d,2032-06-14,2032-06-16,Sainsbury's,5411,Groceries,Supermarket,-65.47,GBP,-194168.51,POS,London,GB,4488,user_001,,
c8e60e21-ba9b-4e6f-a476-fd64d8675d7f,2032-06-14,2032-06-14,City Council Tax,9399,Utilities,Council Tax,-175.06,GBP,-194343.57,Direct Debit,London,GB,4488,user_002,rec_6feaa5d43f,
dee34110-9fc3-498d-b375-82356d56b131,2032-06-14,2032-06-14,Amazon UK,5942,Shopping,Online Retail,-105.82,GBP,-194449.39,E-Com,London,GB,9074,user_002,,
3f9ebd15-2cec-49a0-9225-47ae179bd952,2032-06-15,2032-06-17,O2 UK,4814,Bills,Mobile,-41.91,GBP,-194491.3,Direct Debit,Slough,GB,9074,user_001,rec_95042d8101,
89b579ad-9a0b-4c35-a99e-20d1de21f0e8,2032-06-15,2032-06-15,Pret A Manger,5814,Food & Drink,Eating Out,-10.15,GBP,-194501.45,POS,London,GB,2219,user_002,,
bb12789b-2f0b-40c4-97a5-3e5d1d60ef16,2032-06-15,2032-06-17,Uber UK,4121,Transport,Ride Hailing,-27.43,GBP,-194528.88,E-Com,London,GB,9074,user_001,,
bd13e8cc-237e-43de-95c7-dcbb59363092,2032-06-15,2032-06-16,Sainsbury's,5411,Groceries,Supermarket,-31.44,GBP,-194560.32,POS,London,GB,2219,user_002,,
d44aef05-87ea-43cc-8a15-0f96201b68bc,2032-06-15,2032-06-15,Waitrose,5411,Groceries,Supermarket,-27.28,GBP,-194587.6,POS,London,GB,1045,user_001,,
e6a59773-2f16-4dca-8173-09b1e9ff5953,2032-06-15,2032-06-15,Deliveroo,5812,Food & Drink,Delivery,-24.31,GBP,-194611.91,E-Com,London,GB,2219,user_001,,
01b715e1-dc98-4d44-bbbc-c8ee2cbc4ae3,2032-06-16,2032-06-17,Local Market,5499,Groceries,Specialty,-14.22,GBP,-194626.13,POS,London,GB,9074,user_002,,
22c45af9-96ad-4f98-b699-cfffb7cff3a7,2032-06-16,2032-06-16,Uber UK,4121,Transport,Ride Hailing,-8.27,GBP,-194634.4,E-Com,London,GB,2219,user_001,,
9e10289a-4329-4b7d-b841-7026b90ec151,2032-06-17,2032-06-21,GymBox,7997,Wellness,Gym,-47.41,GBP,-194681.81,Direct Debit,London,GB,1045,user_002,rec_19771e79cd,
e9cbc6e4-3a67-4fc7-944e-6b4a3762fdea,2032-06-17,2032-06-17,Transport for London,4111,Transport,Transit,-4.1,GBP,-194685.91,POS,London,GB,4488,user_001,,
882d1fc3-3216-4ff1-aa58-d7aca22db005,2032-06-18,2032-06-18,Deliveroo,5812,Food & Drink,Delivery,-27.94,GBP,-194713.85,E-Com,London,GB,9074,user_001,,
acb7afd4-eb16-4eb3-97df-9c231c75e6b5,2032-06-18,2032-06-21,Local Market,5499,Groceries,Specialty,-12.19,GBP,-194726.04,POS,London,GB,1045,user_001,,
ce249b4c-bbcc-4d12-8f88-93ee51c465ea,2032-06-18,2032-06-21,Deliveroo,5812,Food & Drink,Delivery,-18.1,GBP,-194744.14,E-Com,London,GB,9074,user_001,,
f1026d40-4811-4340-bd59-c49652fc77af,2032-06-19,2032-06-21,Transport for London,4111,Transport,Transit,-9.64,GBP,-194753.78,POS,London,GB,2219,user_002,,
f413bf9f-0650-4129-a780-b3c838998502,2032-06-19,2032-06-21,Apple.com/bill,5734,Shopping,Electronics,-123.16,USD,-194876.94,E-Com,Cupertino,US,2219,user_001,,FX purchase 150.82 USD @ rate 1.22
1a94a8d2-97e4-459f-a1fd-7ac463c81d81,2032-06-20,2032-06-21,Local Market,5499,Groceries,Specialty,-11.22,GBP,-194888.16,POS,London,GB,1045,user_001,,
38d7f577-54bf-4037-bc9c-d240d3ff9d97,2032-06-20,2032-06-22,Shell,5541,Transport,Fuel,-47.81,GBP,-194935.97,POS,London,GB,4488,user_001,,
727de6af-adc8-4a91-9998-762d7c9d7903,2032-06-20,2032-06-22,Transport for London,4111,Transport,Transit,-9.95,GBP,-194945.92,POS,London,GB,9074,user_001,,
359c77be-0287-4699-8d23-3439418ffe92,2032-06-21,2032-06-21,Netflix,7841,Entertainment,Subscriptions,-10.59,GBP,-194956.51,E-Com,Los Gatos,US,9074,user_001,rec_1bfe33738d,
7be22195-6542-4a78-b3f9-aa58ddba6f54,2032-06-21,2032-06-23,Tesco,5411,Groceries,Supermarket,-79.97,GBP,-195036.48,POS,London,GB,9074,user_001,,
84b08ec4-6ce4-4b24-9224-bb47613685ae,2032-06-21,2032-06-23,Amazon UK,5942,Shopping,Online Retail,-17.71,GBP,-195054.19,E-Com,London,GB,2219,user_001,,
aec45765-0b04-4e5d-b4cc-41a9f7768473,2032-06-21,2032-06-22,Waitrose,5411,Groceries,Supermarket,-72.07,GBP,-195126.26,POS,London,GB,1045,user_001,,
af3ea930-b3d9-4348-a8a2-7732fdef5087,2032-06-21,2032-06-22,Spotify,5735,Entertainment,Subscriptions,-8.37,GBP,-195134.63,E-Com,Stockholm,SE,2219,user_001,rec_4c746d2c3b,
4961df17-3526-4d9c-be1b-4b461c510ca1,2032-06-22,2032-06-22,Tesco,5411,Groceries,Supermarket,-19.15,GBP,-195153.78,POS,London,GB,9074,user_001,,
4aefd83d-b37f-4525-a176-2982f9677c18,2032-06-22,2032-06-24,British Airways,4511,Travel,Flights,-613.43,GBP,-195767.21,E-Com,London,GB,9074,user_002,,Business travel
4f1fcd18-d6f8-4f27-99fd-6011e649b294,2032-06-22,2032-06-24,Pret A Manger,5814,Food & Drink,Eating Out,-9.33,GBP,-195776.54,POS,London,GB,1045,user_001,,
5b619e80-3632-49e9-a438-061be12f2fb1,2032-06-22,2032-06-24,Apple.com/bill,5734,Shopping,Electronics,-26.73,USD,-195803.27,E-Com,Cupertino,US,1045,user_001,,FX purchase 33.46 USD @ rate 1.25
6e8320ff-0325-4af6-b751-da384a75c625,2032-06-23,2032-06-23,Tesco,5411,Groceries,Supermarket,-67.56,GBP,-195870.83,POS,London,GB,1045,user_002,,
8b3e994d-23ca-4372-929f-7c6055286eca,2032-06-24,2032-06-25,Pret A Manger,5814,Food & Drink,Eating Out,-6.93,GBP,-195877.76,POS,London,GB,1045,user_001,,
8d457122-e44b-482e-8fe5-324703e3b69b,2032-06-24,2032-06-25,Pret A Manger,5814,Food & Drink,Eating Out,-6.5,GBP,-195884.26,POS,London,GB,2219,user_001,,
1e0133ed-7819-4818-8a41-044805c12b8b,2032-06-25,2032-06-25,T212 Capital,6011,Income,Salary,2922.02,GBP,-192962.24,Credit,London,GB,4488,user_001,rec_2ff8f778d0,
58d55972-5a6c-4fb3-8677-3ae7f921f02c,2032-06-25,2032-06-25,Apple.com/bill,5734,Shopping,Electronics,-195.79,GBP,-193158.03,E-Com,Cupertino,US,2219,user_001,,
0df992c8-1023-4d8a-be48-53a8863ca45f,2032-06-26,2032-06-28,Apple.com/bill,5734,Shopping,Electronics,-23.49,USD,-193181.52,E-Com,Cupertino,US,2219,user_001,,FX purchase 27.98 USD @ rate 1.19
54edc75d-1383-4445-836b-dd174aae538a,2032-06-26,2032-06-28,Amazon UK,5942,Shopping,Online Retail,-119.31,GBP,-193300.83,E-Com,London,GB,4488,user_002,,
a8b9289d-9c49-487e-8cdf-fa3e89803587,2032-06-26,2032-06-28,Waitrose,5411,Groceries,Supermarket,-23.22,GBP,-193324.05,POS,London,GB,2219,user_001,,
c65fc475-21dd-4948-9db0-109f202e67ea,2032-06-26,2032-06-28,Shell,5541,Transport,Fuel,-82.16,GBP,-193406.21,POS,London,GB,2219,user_001,,
693b1c37-c16f-4688-a6f5-d682138dc1ce,2032-06-27,2032-06-28,Sainsbury's,5411,Groceries,Supermarket,-40.71,GBP,-193446.92,POS,London,GB,9074,user_001,,
7f2d93fc-4b19-48d7-b870-673bbda9d223,2032-06-27,2032-06-28,Sainsbury's,5411,Groceries,Supermarket,-16.3,GBP,-193463.22,POS,London,GB,4488,user_001,,
ed82187f-0e5c-41d2-9dd7-bf986a6828ad,2032-06-27,2032-06-29,Local Market,5499,Groceries,Specialty,-13.99,GBP,-193477.21,POS,London,GB,2219,user_001,,
f1fb8d2a-422e-478e-8e35-fed96657592d,2032-06-27,2032-06-28,Deliveroo,5812,Food & Drink,Delivery,-25.13,GBP,-193502.34,E-Com,London,GB,2219,user_002,,
5c273c41-356b-4f4c-9ec8-5a8b199ef897,2032-06-28,2032-06-30,Amazon UK,5942,Shopping,Online Retail,-56.86,GBP,-193559.2,E-Com,London,GB,2219,user_001,,
97165387-ac89-43b3-bd63-94f99dc1678a,2032-06-28,2032-06-30,Apple.com/bill,5734,Shopping,Electronics,-42.3,USD,-193601.5,E-Com,Cupertino,US,2219,user_001,,FX purchase 51.43 USD @ rate 1.22
df5c8861-0dcf-46ca-9d78-3e070586b9d9,2032-06-28,2032-06-30,Local Market,5499,Groceries,Specialty,-11.21,GBP,-193612.71,POS,London,GB,9074,user_001,,
1d991fc2-a27f-40ad-a0cc-e3b48e42c113,2032-06-29,2032-07-01,Local Market,5499,Groceries,Specialty,-7.97,GBP,-193620.68,POS,London,GB,9074,user_001,,
952cc2e1-a0e2-4c2f-ab9a-ca65c6be782b,2032-06-29,2032-06-29,Apple.com/bill,5734,Shopping,Electronics,-141.84,GBP,-193762.52,E-Com,Cupertino,US,1045,user_001,,
a551c202-cc2f-4b71-9542-4a9aceb26b42,2032-06-30,2032-06-30,ATM Withdrawal,6011,Cash,ATM,-80.7,GBP,-193843.22,ATM,London,GB,2219,user_001,,
dc458e0e-bd19-458b-9ccb-9d791e121410,2032-06-30,2032-06-30,Local Market,5499,Groceries,Specialty,-15.51,GBP,-193858.73,POS,London,GB,9074,user_001,,
d7c82791-15fd-4a09-9c5d-e307f3f4161d,2032-07-01,2032-07-05,Amazon UK,5942,Shopping,Online Retail,-100.62,GBP,-193959.35,E-Com,London,GB,9074,user_001,,
ec83094c-6686-486e-8bc1-6414be1f7879,2032-07-01,2032-07-02,Crown Estates Lettings,6513,Housing,Rent,-1467.42,GBP,-195426.77,POS,London,GB,4488,user_002,rec_fc2ae06846,
3e06bfa6-aedb-460a-a33a-72a19e1da63f,2032-07-02,2032-07-05,Transport for London,4111,Transport,Transit,-8.37,GBP,-195435.14,POS,London,GB,4488,user_001,,
65c4ea50-bba7-4b0a-b2b1-6f517b5955c7,2032-07-02,2032-07-02,Transport for London,4111,Transport,Transit,-4.93,GBP,-195440.07,POS,London,GB,2219,user_001,,
69969b0d-20b8-4549-933c-eed03f0a30d4,2032-07-02,2032-07-02,Tesco,5411,Groceries,Supermarket,-37.85,GBP,-195477.92,POS,London,GB,2219,user_001,,
6e452f51-c4e8-43d0-809f-a61b379f19b0,2032-07-02,2032-07-05,Apple.com/bill,5734,Shopping,Electronics,-22.07,USD,-195499.99,E-Com,Cupertino,US,4488,user_001,,FX purchase 26.91 USD @ rate 1.22
a0065bfa-ebbe-4bbc-b3e4-dbc43a386d40,2032-07-02,2032-07-05,Pret A Manger,5814,Food & Drink,Eating Out,-7.93,GBP,-195507.92,POS,London,GB,1045,user_001,,
5790204a-b8ed-47ea-88df-983b64a24f99,2032-07-03,2032-07-05,Apple.com/bill,5734,Shopping,Electronics,-185.38,GBP,-195693.3,E-Com,Cupertino,US,4488,user_001,,
83047ee3-fa28-46b1-8309-547f774f2e19,2032-07-03,2032-07-05,Local Market,5499,Groceries,Specialty,-16.53,GBP,-195709.83,POS,London,GB,2219,user_001,,
27ff2d25-ab5a-42eb-9b69-c9f0ed12afde,2032-07-04,2032-07-05,Tesco,5411,Groceries,Supermarket,-56.5,GBP,-195766.33,POS,London,GB,1045,user_001,,
2888a181-a2db-48dd-a6c2-2a286686a3dd,2032-07-04,2032-07-05,Sainsbury's,5411,Groceries,Supermarket,-48.88,GBP,-195815.21,POS,London,GB,4488,user_001,,
4f7fde29-da38-4f0f-8d4f-dec3d90151f4,2032-07-04,2032-07-06,Sainsbury's,5411,Groceries,Supermarket,-69.41,GBP,-195884.62,POS,London,GB,9074,user_001,,
5f6defba-e49d-49a8-a42e-c0ea155fcb85,2032-07-04,2032-07-06,Apple.com/bill,5734,Shopping,Electronics,-35.44,GBP,-195920.06,E-Com,Cupertino,US,2219,user_001,,
75c6ed7c-7e5d-498c-bd3f-afa9f4d8d283,2032-07-04,2032-07-05,Shell,5541,Transport,Fuel,-31.62,GBP,-195951.68,POS,London,GB,9074,user_001,,
a9d1b4d3-d485-4b0f-aacd-7ea52ee306ed,2032-07-04,2032-07-06,Uber UK,4121,Transport,Ride Hailing,-8.12,GBP,-195959.8,E-Com,London,GB,1045,user_001,,
e5dd159b-25b5-449d-b07e-e32f848e4c74,2032-07-04,2032-07-05,Shell,5541,Transport,Fuel,-39.87,GBP,-195999.67,POS,London,GB,1045,user_001,,
6c4ad12f-3be3-40df-b970-a393a248567e,2032-07-05,2032-07-06,Local Market,5499,Groceries,Specialty,-17.72,GBP,-196017.39,POS,London,GB,9074,user_001,,
7225f1c3-959e-4f24-aa5b-7aa8d96d2c16,2032-07-07,2032-07-07,Octopus Energy,4900,Utilities,Electricity,-111.45,GBP,-196128.84,Direct Debit,London,GB,9074,user_001,rec_141a4a0666,
aff0ade1-433b-4e48-bdc7-8ca448d58552,2032-07-07,2032-07-09,ATM Withdrawal,6011,Cash,ATM,-76.25,GBP,-196205.09,ATM,London,GB,4488,user_001,,
fafe70cb-33ee-4d38-bd6c-43d77e059a7d,2032-07-07,2032-07-07,HM Revenue & Customs,9311,Income,Tax Refund,41.57,GBP,-196163.52,Credit,London,GB,2219,user_002,,Refund for Tesco
4b97ac6a-d410-46f6-9399-a54983f91301,2032-07-08,2032-07-12,Uber UK,4121,Transport,Ride Hailing,-31.89,GBP,-196195.41,E-Com,London,GB,4488,user_001,,
be3e7e85-a83b-40f7-938b-5ae39ed6f751,2032-07-08,2032-07-12,Uber UK,4121,Transport,Ride Hailing,-34.73,GBP,-196230.14,E-Com,London,GB,9074,user_001,,
34040fce-9643-4bdf-92fe-3ebf1060f1dc,2032-07-09,2032-07-12,Waitrose,5411,Groceries,Supermarket,-43.86,GBP,-196274.0,POS,London,GB,9074,user_001,,
64ad07d2-3e72-47ef-a566-aef730317edb,2032-07-09,2032-07-12,Waitrose,5411,Groceries,Supermarket,-49.87,GBP,-196323.87,POS,London,GB,2219,user_001,,
852ba71c-26ed-4c90-a492-9f79753ebf6f,2032-07-09,2032-07-09,Uber UK,4121,Transport,Ride Hailing,-32.11,GBP,-196355.98,E-Com,London,GB,1045,user_001,,
2baed04c-e1c5-45fc-88c2-b4d6c496f260,2032-07-10,2032-07-12,Local Market,5499,Groceries,Specialty,-17.73,GBP,-196373.71,POS,London,GB,9074,user_002,,
910540f9-e5a2-4fac-aeb6-9151f7aa94f9,2032-07-10,2032-07-12,Sainsbury's,5411,Groceries,Supermarket,-17.29,GBP,-196391.0,POS,London,GB,2219,user_001,,
8f347720-691a-453e-affd-6b3838897dcc,2032-07-11,2032-07-12,Local Market,5499,Groceries,Specialty,-17.85,GBP,-196408.85,POS,London,GB,1045,user_001,,
b513e0ba-ce9d-488b-9718-87ab920f0bb8,2032-07-11,2032-07-13,Deliveroo,5812,Food & Drink,Delivery,-23.48,GBP,-196432.33,E-Com,London,GB,1045,user_001,,
bf629c2b-0880-462d-a5bc-787dafba35eb,2032-07-11,2032-07-12,Tesco,5411,Groceries,Supermarket,-20.07,GBP,-196452.4,POS,London,GB,9074,user_002,,
dfac7c7d-da83-45ee-a4f4-cc2f2c3f50cb,2032-07-11,2032-07-12,HM Revenue & Customs,9311,Income,Tax Refund,657.03,GBP,-195795.37,Credit,London,GB,2219,user_002,,Refund for Crown Estates Lettings
ea2f5e0b-887a-41b7-b890-1a7c94379042,2032-07-11,2032-07-12,Tesco,5411,Groceries,Supermarket,-54.44,GBP,-195849.81,POS,London,GB,4488,user_001,,
20b7a8f6-c301-41e0-8b7c-1d129c2e180c,2032-07-12,2032-07-13,Tesco,5411,Groceries,Supermarket,-71.7,GBP,-195921.51,POS,London,GB,2219,user_002,,
5c2fffe5-52c1-41d8-b256-1fe31f379ab3,2032-07-12,2032-07-13,Thames Water,4900,Utilities,Water,-40.11,GBP,-195961.62,Direct Debit,Reading,GB,2219,user_001,rec_3a34d62842,
2f098cee-6b76-444b-b4bc-02e4c01405c3,2032-07-13,2032-07-15,City Council Tax,9399,Utilities,Council Tax,-177.2,GBP,-196138.82,Direct Debit,London,GB,4488,user_002,rec_6feaa5d43f,
f8533c4c-13f7-4133-90e0-894d4c3bd366,2032-07-14,2032-07-15,Deliveroo,5812,Food & Drink,Delivery,-25.57,GBP,-196164.39,E-Com,London,GB,2219,user_001,,
f963abe2-20b2-447a-9a77-60d29d050018,2032-07-14,2032-07-14,Local Market,5499,Groceries,Specialty,-14.81,GBP,-196179.2,POS,London,GB,9074,user_001,,
71059dc7-3979-4995-92bb-3cdc0fc43cfa,2032-07-15,2032-07-16,O2 UK,4814,Bills,Mobile,-50.88,GBP,-196230.08,Direct Debit,Slough,GB,9074,user_001,rec_95042d8101,
a1ee9c99-453e-47e4-9d70-10669641db4b,2032-07-15,2032-07-19,Transport for London,4111,Transport,Transit,-5.79,GBP,-196235.87,POS,London,GB,4488,user_001,,
87344d69-82ce-4073-84a6-5136ea59a6b9,2032-07-16,2032-07-16,Waitrose,5411,Groceries,Supermarket,-68.62,GBP,-196304.49,POS,London,GB,9074,user_001,,
d0859592-7488-46c3-8485-13611495b73c,2032-07-16,2032-07-19,Sainsbury's,5411,Groceries,Supermarket,-64.02,GBP,-196368.51,POS,London,GB,2219,user_001,,
75de8279-399a-4caf-8406-230a01a09a1f,2032-07-17,2032-07-19,Deliveroo,5812,Food & Drink,Delivery,-24.63,GBP,-196393.14,E-Com,London,GB,1045,user_001,,
afc251de-9ab7-4e73-9bea-eaa31ea1b3eb,2032-07-17,2032-07-19,Pret A Manger,5814,Food & Drink,Eating Out,-9.13,GBP,-196402.27,POS,London,GB,2219,user_001,,
ce140458-c7b0-487f-bc1c-c06a69c79963,2032-07-17,2032-07-19,Tesco,5411,Groceries,Supermarket,-81.61,GBP,-196483.88,POS,London,GB,2219,user_001,,
d806d90c-4109-4977-b1bc-aa959ae0b79f,2032-07-17,2032-07-19,Deliveroo,5812,Food & Drink,Delivery,-13.33,GBP,-196497.21,E-Com,London,GB,1045,user_001,,
6eabd869-db9c-4d27-a449-6abdeb1f8190,2032-07-18,2032-07-19,Shell,5541,Transport,Fuel,-90.22,GBP,-196587.43,POS,London,GB,1045,user_001,,
c25fca35-a25d-4a02-b50b-53e5190522ed,2032-07-18,2032-07-19,Waitrose,5411,Groceries,Supermarket,-36.27,GBP,-196623.7,POS,London,GB,1045,user_001,,
dde3d1e4-d848-4c40-abde-2467363ce9bc,2032-07-18,2032-07-19,Tesco,5411,Groceries,Supermarket,-69.92,GBP,-196693.62,POS,London,GB,2219,user_002,,
e397326e-6897-465b-951a-a2caa0af01b9,2032-07-18,2032-07-19,Waitrose,5411,Groceries,Supermarket,-62.19,GBP,-196755.81,POS,London,GB,9074,user_001,,
ef289f1b-9de2-4842-8a54-5edf3960d276,2032-07-18,2032-07-19,Deliveroo,5812,Food & Drink,Delivery,-22.58,GBP,-196778.39,E-Com,London,GB,4488,user_001,,
36d96a25-8415-4610-a9f0-7c824aff3ac7,2032-07-19,2032-07-20,Transport for London,4111,Transport,Transit,-6.33,GBP,-196784.72,POS,London,GB,9074,user_001,,
6423ec4e-59a3-4787-a93c-f6ee74d682ee,2032-07-19,2032-07-19,Deliveroo,5812,Food & Drink,Delivery,-21.17,GBP,-196805.89,E-Com,London,GB,1045,user_001,,
6acbe1a1-a84b-4fae-a4fd-f1035ac0b5ab,2032-07-19,2032-07-20,Transport for London,4111,Transport,Transit,-10.38,GBP,-196816.27,POS,London,GB,4488,user_001,,
77f660e9-e58e-427c-a58a-7b61ec4595db,2032-07-19,2032-07-19,Amazon UK,5942,Shopping,Online Retail,-109.49,GBP,-196925.76,E-Com,London,GB,1045,user_001,,
7b873931-690e-4e74-8c44-59e46af6c7c2,2032-07-19,2032-07-20,Pret A Manger,5814,Food & Drink,Eating Out,-8.39,GBP,-196934.15,POS,London,GB,4488,user_001,,
8d747c95-fb80-44c6-9096-e6f5451ced94,2032-07-19,2032-07-19,GymBox,7997,Wellness,Gym,-62.63,GBP,-196996.78,Direct Debit,London,GB,1045,user_001,rec_3906953fd2,
e2384b8d-7499-44ec-8cf9-b0821cc0c86c,2032-07-19,2032-07-21,Spotify,5735,Entertainment,Subscriptions,-8.62,EUR,-197005.4,E-Com,Stockholm,SE,9074,user_002,rec_34b6e9e33f,FX purchase 10.14 EUR @ rate 1.18
2dc2d3a2-8f6e-4fdb-af16-d3f5ef211d40,2032-07-20,2032-07-22,Local Market,5499,Groceries,Specialty,-13.28,GBP,-197018.68,POS,London,GB,9074,user_001,,
8ca5ea01-80d8-4e16-a5a1-6c578d53ef74,2032-07-21,2032-07-23,Netflix,7841,Entertainment,Subscriptions,-14.97,GBP,-197033.65,E-Com,Los Gatos,US,1045,user_001,rec_1bfe33738d,
14a0c29a-d016-42a0-aca1-bb573af3ca21,2032-07-23,2032-07-26,Deliveroo,5812,Food & Drink,Delivery,-18.72,GBP,-197052.37,E-Com,London,GB,2219,user_001,,
8c28edec-70e0-46d4-9835-45cca780b399,2032-07-23,2032-07-23,Sainsbury's,5411,Groceries,Supermarket,-58.9,GBP,-197111.27,POS,London,GB,4488,user_001,,
a532c1d1-8902-406d-8ce5-252e36a0bf97,2032-07-23,2032-07-23,T212 Capital,6011,Income,Salary,3213.14,GBP,-193898.13,Credit,London,GB,9074,user_002,rec_c649d24d0f,
d27fcefe-639d-4aee-89c0-76bf9689f3e4,2032-07-23,2032-07-26,Transport for London,4111,Transport,Transit,-10.63,GBP,-193908.76,POS,London,GB,1045,user_001,,
4ddea5f2-9787-4a7a-a2dc-9d630dd20401,2032-07-24,2032-07-26,Apple.com/bill,5734,Shopping,Electronics,-41.33,GBP,-193950.09,E-Com,Cupertino,US,2219,user_001,,
67a8e2c3-dbeb-4b5f-8f8a-09c11b791579,2032-07-24,2032-07-26,Transport for London,4111,Transport,Transit,-3.66,GBP,-193953.75,POS,London,GB,4488,user_002,,
6ae04567-b0b2-42e1-ac71-79a6554333d6,2032-07-25,2032-07-26,Waitrose,5411,Groceries,Supermarket,-37.97,GBP,-193991.72,POS,London,GB,9074,user_001,,
97448d0d-49ce-4227-90a0-52c6ef795d01,2032-07-25,2032-07-26,Uber UK,4121,Transport,Ride Hailing,-35.72,GBP,-194027.44,E-Com,London,GB,2219,user_001,,
fd514258-8aaa-484c-acbf-3daf4f81f37b,2032-07-25,2032-07-26,Apple.com/bill,5734,Shopping,Electronics,-23.86,GBP,-194051.3,E-Com,Cupertino,US,2219,user_001,,
d47a81a7-f2fe-4f0f-9965-df94155208c1,2032-07-26,2032-07-26,Local Market,5499,Groceries,Specialty,-10.9,GBP,-194062.2,POS,London,GB,9074,user_001,,
f747ca25-43a0-4a7c-9d9a-bbf820e79da3,2032-07-27,2032-07-29,Uber UK,4121,Transport,Ride Hailing,-17.34,GBP,-194079.54,E-Com,London,GB,4488,user_001,,
78eed25e-7d42-46fc-b84d-88e79b3bc45e,2032-07-29,2032-07-30,Sainsbury's,5411,Groceries,Supermarket,-58.5,GBP,-194138.04,POS,London,GB,9074,user_002,,
4ca2e79d-ef79-4c10-9063-080a2c6251d1,2032-07-30,2032-08-02,Amazon UK,5942,Shopping,Online Retail,-103.95,GBP,-194241.99,E-Com,London,GB,4488,user_001,,
63064b72-da3c-4b50-9e8a-57d62758004d,2032-07-31,2032-08-02,Sainsbury's,5411,Groceries,Supermarket,-27.44,GBP,-194269.43,POS,London,GB,2219,user_001,,
6942120a-2485-4f74-83c1-b77a69e1d795,2032-07-31,2032-08-02,Amazon UK,5942,Shopping,Online Retail,-82.48,GBP,-194351.91,E-Com,London,GB,9074,user_001,,
9b9157c0-91b5-42fa-87b5-a2223cc56c3e,2032-07-31,2032-08-02,Waitrose,5411,Groceries,Supermarket,-82.64,GBP,-194434.55,POS,London,GB,9074,user_002,,
ef146b25-661c-4f04-bf35-6a227084093b,2032-07-31,2032-08-02,Sainsbury's,5411,Groceries,Supermarket,-44.48,GBP,-194479.03,POS,London,GB,9074,user_002,,
0dac3f81-a92b-479a-9618-491c4ae42306,2032-08-01,2032-08-02,Local Market,5499,Groceries,Specialty,-9.55,GBP,-194488.58,POS,London,GB,9074,user_001,,
2b3eb4b5-431c-4836-8ce1-332f854a1377,2032-08-01,2032-08-02,Local Market,5499,Groceries,Specialty,-21.74,GBP,-194510.32,POS,London,GB,2219,user_001,,
808b63dc-56ad-4488-b448-c51629cee669,2032-08-01,2032-08-02,Pret A Manger,5814,Food & Drink,Eating Out,-9.25,GBP,-194519.57,POS,London,GB,2219,user_001,,
db071eb4-caad-477c-9222-0a0e6e84b9ff,2032-08-01,2032-08-02,Transport for London,4111,Transport,Transit,-6.94,GBP,-194526.51,POS,London,GB,9074,user_001,,
e1628910-3994-4eab-a148-9fc6a163e00b,2032-08-01,2032-08-02,Uber UK,4121,Transport,Ride Hailing,-31.7,GBP,-194558.21,E-Com,London,GB,4488,user_001,,
e00521cf-fa45-4ef4-a2d3-5ff64fa77899,2032-08-02,2032-08-03,Crown Estates Lettings,6513,Housing,Rent,-1502.76,GBP,-196060.97,POS,London,GB,1045,user_001,rec_19f70fbcce,
09933737-73f6-4290-b8f3-39a62e6ea165,2032-08-03,2032-08-03,Amazon UK,5942,Shopping,Online Retail,-12.88,GBP,-196073.85,E-Com,London,GB,2219,user_001,,
8914cda2-dc73-4806-af14-781577567521,2032-08-03,2032-08-05,Local Market,5499,Groceries,Specialty,-18.12,GBP,-196091.97,POS,London,GB,1045,user_001,,
32ea89ef-36ac-4d2c-a480-74a0e6c690a2,2032-08-04,2032-08-04,Apple.com/bill,5734,Shopping,Electronics,-67.45,GBP,-196159.42,E-Com,Cupertino,US,4488,user_001,,
9f898086-ed30-4008-9cbe-472533602f1a,2032-08-04,2032-08-04,Transport for London,4111,Transport,Transit,-4.49,GBP,-196163.91,POS,London,GB,9074,user_002,,
b94f8f9e-9227-4e94-9d3d-7e53311aa511,2032-08-04,2032-08-05,Sainsbury's,5411,Groceries,Supermarket,-39.83,GBP,-196203.74,POS,London,GB,9074,user_001,,
b8f77ad4-bd29-474f-a070-e09e1bead41a,2032-08-05,2032-08-05,Shell,5541,Transport,Fuel,-48.44,GBP,-196252.18,POS,London,GB,2219,user_001,,
3942e17b-b99f-4fb9-97a5-b279dbf594cb,2032-08-06,2032-08-09,Sainsbury's,5411,Groceries,Supermarket,-25.72,GBP,-196277.9,POS,London,GB,4488,user_001,,
47dc4ed3-0b3f-4ac0-8d46-50925a51771b,2032-08-06,2032-08-06,Amazon UK,5942,Shopping,Online Retail,-116.87,GBP,-196394.77,E-Com,London,GB,2219,user_001,,
ab2f2c70-f659-4366-8ccd-088097e60a5b,2032-08-06,2032-08-09,Amazon UK,5942,Shopping,Online Retail,-31.15,GBP,-196425.92,E-Com,London,GB,1045,user_001,,
bcb6ec85-b568-40b4-932b-7e9b2873b6f7,2032-08-06,2032-08-09,Tesco,5411,Groceries,Supermarket,-79.75,GBP,-196505.67,POS,London,GB,2219,user_001,,
4ea3d06e-729e-49c4-a641-4314d51863d1,2032-08-07,2032-08-09,Waitrose,5411,Groceries,Supermarket,-39.9,GBP,-196545.57,POS,London,GB,1045,user_001,,
7d537d11-59cb-4187-b0a4-b96fc4c989c1,2032-08-07,2032-08-09,Local Market,5499,Groceries,Specialty,-15.92,GBP,-196561.49,POS,London,GB,2219,user_001,,
c6e5f3ad-2906-4940-99e1-946105cb9f28,2032-08-07,2032-08-09,Waitrose,5411,Groceries,Supermarket,-29.98,GBP,-196591.47,POS,London,GB,9074,user_001,,
d95009d6-16fd-4328-adef-79d10b8fd084,2032-08-07,2032-08-09,Uber UK,4121,Transport,Ride Hailing,-27.2,GBP,-196618.67,E-Com,London,GB,4488,user_001,,
36777b29-1000-48a1-8662-2f6f57da403d,2032-08-08,2032-08-10,Local Market,5499,Groceries,Specialty,-20.88,GBP,-196639.55,POS,London,GB,1045,user_001,,
380f41de-d77d-431b-be53-98952e4f3bbc,2032-08-08,2032-08-09,Sainsbury's,5411,Groceries,Supermarket,-50.35,GBP,-196689.9,POS,London,GB,1045,user_001,,
960a2413-d6ca-4233-8ae5-b5c308d78153,2032-08-08,2032-08-09,Uber UK,4121,Transport,Ride Hailing,-22.64,GBP,-196712.54,E-Com,London,GB,4488,user_001,,
ab8b9a65-6cd0-4b94-8295-0a669e37f39a,2032-08-08,2032-08-09,HM Revenue & Customs,9311,Income,Tax Refund,20.43,GBP,-196692.11,Credit,London,GB,4488,user_001,,Refund for Deliveroo
30ec9d6c-910e-43d5-ad47-e03781bf2cb3,2032-08-09,2032-08-09,Uber UK,4121,Transport,Ride Hailing,-13.8,GBP,-196705.91,E-Com,London,GB,9074,user_001,,
54871ad0-64f5-443e-b595-a0c8601d9c3c,2032-08-09,2032-08-10,Waitrose,5411,Groceries,Supermarket,-66.16,GBP,-196772.07,POS,London,GB,9074,user_001,,
82cfb067-f96b-4af9-87ef-2c98508777cb,2032-08-09,2032-08-10,Octopus Energy,4900,Utilities,Electricity,-113.16,GBP,-196885.23,Direct Debit,London,GB,1045,user_001,rec_141a4a0666,
de8b72c2-a5a5-4e85-9d37-3f7e03ee6acf,2032-08-09,2032-08-10,Waitrose,5411,Groceries,Supermarket,-32.49,GBP,-196917.72,POS,London,GB,9074,user_001,,
61402584-7221-487d-b872-b70ab4411cb9,2032-08-10,2032-08-11,Waitrose,5411,Groceries,Supermarket,-72.17,GBP,-196989.89,POS,London,GB,9074,user_001,,
890b78ce-52da-4dd0-908d-0176369fb07f,2032-08-10,2032-08-11,Apple.com/bill,5734,Shopping,Electronics,-187.91,USD,-197177.8,E-Com,Cupertino,US,4488,user_001,,FX purchase 232.12 USD @ rate 1.24
bfd953ed-4b41-4c06-af55-65ddc28cb4e1,2032-08-10,2032-08-10,Deliveroo,5812,Food & Drink,Delivery,-33.98,GBP,-197211.78,E-Com,London,GB,9074,user_001,,
05952235-cf59-41b1-8cca-54bd83e91338,2032-08-11,2032-08-13,Thames Water,4900,Utilities,Water,-32.87,GBP,-197244.65,Direct Debit,Reading,GB,4488,user_001,rec_3a34d62842,
53a2c0ae-466f-40dc-9176-ff3f52a5d81e,2032-08-11,2032-08-11,Uber UK,4121,Transport,Ride Hailing,-8.98,GBP,-197253.63,E-Com,London,GB,2219,user_002,,
13f260e9-0eae-4b6c-a51a-e8745e569a15,2032-08-12,2032-08-13,Waitrose,5411,Groceries,Supermarket,-57.31,GBP,-197310.94,POS,London,GB,4488,user_001,,
399522a8-2a07-4573-b6d1-f2aaa3aa4723,2032-08-12,2032-08-13,Sainsbury's,5411,Groceries,Supermarket,-25.02,GBP,-197335.96,POS,London,GB,2219,user_001,,
c2427335-9d57-49e0-8d03-173cb29b5a54,2032-08-12,2032-08-13,Waitrose,5411,Groceries,Supermarket,-40.22,GBP,-197376.18,POS,London,GB,4488,user_001,,
114972e9-fd1c-4881-ae90-5db53b466f9d,2032-08-13,2032-08-16,Shell,5541,Transport,Fuel,-67.5,GBP,-197443.68,POS,London,GB,2219,user_001,,
33678c8c-cab6-4b1a-aed0-d3c374b1c89e,2032-08-13,2032-08-16,City Council Tax,9399,Utilities,Council Tax,-157.29,GBP,-197600.97,Direct Debit,London,GB,9074,user_001,rec_f531495db5,
4637d49e-1af2-43f9-9728-0262e52bc160,2032-08-13,2032-08-13,Amazon UK,5942,Shopping,Online Retail,-15.05,GBP,-197616.02,E-Com,London,GB,2219,user_002,,
7287fd41-8c62-4038-85ac-55bf9bd233d9,2032-08-14,2032-08-16,Amazon UK,5942,Shopping,Online Retail,-45.78,GBP,-197661.8,E-Com,London,GB,1045,user_001,,
c3263872-7a53-4654-838a-4166efc4b90f,2032-08-14,2032-08-16,Apple.com/bill,5734,Shopping,Electronics,-7.84,GBP,-197669.64,E-Com,Cupertino,US,2219,user_001,,
df294a82-752d-4f6c-af9b-e01c5c226a2d,2032-08-14,2032-08-16,Tesco,5411,Groceries,Supermarket,-76.67,GBP,-197746.31,POS,London,GB,9074,user_001,,
1548ae1b-30cd-4e56-9bc9-5af3db6203af,2032-08-15,2032-08-16,Amazon UK,5942,Shopping,Online Retail,-55.55,GBP,-197801.86,E-Com,London,GB,9074,user_001,,
59d1ebc5-94ef-44c5-9f85-a27d4626f4ce,2032-08-15,2032-08-17,Uber UK,4121,Transport,Ride Hailing,-24.86,GBP,-197826.72,E-Com,London,GB,9074,user_001,,
705f9f36-91cc-40f7-a819-ce28a6c6cdd4,2032-08-15,2032-08-16,Airline Refund,4511,Travel,Refund,15.88,GBP,-197810.84,Credit,London,GB,9074,user_001,,Refund for Uber UK
a852b5b0-ad1d-4a48-b2be-35724765b6a1,2032-08-15,2032-08-16,Apple.com/bill,5734,Shopping,Electronics,-1.73,GBP,-197812.57,E-Com,Cupertino,US,4488,user_002,,
6c6bf95a-e1b0-4977-b29b-7f8a41ff9f2a,2032-08-16,2032-08-16,O2 UK,4814,Bills,Mobile,-35.98,GBP,-197848.55,Direct Debit,Slough,GB,4488,user_001,rec_95042d8101,
c71b4fd3-afdd-43fd-98e6-270cae8ca455,2032-08-16,2032-08-17,Waitrose,5411,Groceries,Supermarket,-84.6,GBP,-197933.15,POS,London,GB,1045,user_002,,
cb26336b-c214-4488-b307-3cb190ad91db,2032-08-16,2032-08-18,Deliveroo,5812,Food & Drink,Delivery,-30.11,GBP,-197963.26,E-Com,London,GB,2219,user_001,,
f445627e-943f-422d-974f-5ed46a842c64,2032-08-16,2032-08-18,Amazon UK,5942,Shopping,Online Retail,-42.96,GBP,-198006.22,E-Com,London,GB,9074,user_001,,
403c8c0b-9c0d-441a-9a71-6e400b75a7b5,2032-08-17,2032-08-18,Local Market,5499,Groceries,Specialty,-9.38,GBP,-198015.6,POS,London,GB,1045,user_001,,
acc2eca2-8849-4afa-a295-626ef3aa84fb,2032-08-17,2032-08-17,Amazon UK,5942,Shopping,Online Retail,-77.51,GBP,-198093.11,E-Com,London,GB,2219,user_002,,
cfb5de45-39e6-42e7-840b-474c734b6701,2032-08-17,2032-08-17,Apple.com/bill,5734,Shopping,Electronics,-146.48,USD,-198239.59,E-Com,Cupertino,US,9074,user_001,,FX purchase 181.86 USD @ rate 1.24
dc9d356d-e33e-4e40-b9eb-66fc3dcc9692,2032-08-17,2032-08-18,GymBox,7997,Wellness,Gym,-54.26,GBP,-198293.85,Direct Debit,London,GB,2219,user_001,rec_3906953fd2,
76d0e1a2-1841-4360-a186-080d99e71eaf,2032-08-18,2032-08-19,Tesco,5411,Groceries,Supermarket,-62.17,GBP,-198356.02,POS,London,GB,1045,user_001,,
20ca775c-aacd-4336-a581-570b74c4aa05,2032-08-19,2032-08-23,Amazon UK,5942,Shopping,Online Retail,-99.94,GBP,-198455.96,E-Com,London,GB,2219,user_001,,
79ca6f2e-167c-4d6d-b054-fae740ac4fc8,2032-08-19,2032-08-19,Spotify,5735,Entertainment,Subscriptions,-9.21,GBP,-198465.17,E-Com,Stockholm,SE,9074,user_001,rec_4c746d2c3b,
dcd0478c-4fcd-45b6-a3b3-091591cc2ec0,2032-08-19,2032-08-19,Local Market,5499,Groceries,Specialty,-10.74,GBP,-198475.91,POS,London,GB,4488,user_001,,
095ea681-a277-4f07-9565-30885247b27d,2032-08-20,2032-08-20,Amazon UK,5942,Shopping,Online Retail,-50.08,GBP,-198525.99,E-Com,London,GB,4488,user_001,,
6f3f3afe-2fd8-4945-8d62-bee0d25601c0,2032-08-21,2032-08-23,Tesco,5411,Groceries,Supermarket,-36.95,GBP,-198562.94,POS,London,GB,4488,user_001,,
73f283aa-172d-42d2-8b1e-50eb854d3f71,2032-08-21,2032-08-23,Waitrose,5411,Groceries,Supermarket,-33.39,GBP,-198596.33,POS,London,GB,1045,user_001,,
a47f9175-1ac1-426a-ad88-430cadaad212,2032-08-21,2032-08-23,Amazon UK,5942,Shopping,Online Retail,-18.46,GBP,-198614.79,E-Com,London,GB,1045,user_001,,
a66427c8-211b-4625-a791-df669c4f09ca,2032-08-21,2032-08-23,Amazon UK,5942,Shopping,Online Retail,-99.76,GBP,-198714.55,E-Com,London,GB,4488,user_001,,
6141e1d9-dd9f-422a-9857-c8d394c7d8b7,2032-08-22,2032-08-24,Pret A Manger,5814,Food & Drink,Eating Out,-11.67,GBP,-198726.22,POS,London,GB,4488,user_001,,
87b44bf5-5fed-47d4-8092-07b6943fe9c8,2032-08-22,2032-08-23,Waitrose,5411,Groceries,Supermarket,-45.0,GBP,-198771.22,POS,London,GB,2219,user_001,,
8ed88777-07a2-4275-91ae-85ba9bb69343,2032-08-22,2032-08-24,Pret A Manger,5814,Food & Drink,Eating Out,-6.04,GBP,-198777.26,POS,London,GB,9074,user_002,,
f3f0fd5f-f0d4-4a99-8b23-3794db871d81,2032-08-22,2032-08-23,Transport for London,4111,Transport,Transit,-11.76,GBP,-198789.02,POS,London,GB,1045,user_001,,
13e438cb-947c-40de-909c-949504021098,2032-08-23,2032-08-23,Uber UK,4121,Transport,Ride Hailing,-14.93,GBP,-198803.95,E-Com,London,GB,9074,user_001,,
9ee04efa-7c75-4ffd-847e-5a7f62480438,2032-08-23,2032-08-24,Netflix,7841,Entertainment,Subscriptions,-15.62,GBP,-198819.57,E-Com,Los Gatos,US,2219,user_001,rec_1bfe33738d,
9bd92259-3dc2-4310-a1df-d99ce74d0e61,2032-08-24,2032-08-24,Amazon UK,5942,Shopping,Online Retail,-82.95,GBP,-198902.52,E-Com,London,GB,4488,user_001,,
0680e800-abd5-47aa-8db3-a949d005c75f,2032-08-25,2032-08-25,T212 Capital,6011,Income,Salary,3296.97,GBP,-195605.55,Credit,London,GB,2219,user_001,rec_2ff8f778d0,
12836070-6ace-415c-b790-57fc01b36c95,2032-08-25,2032-08-25,Pret A Manger,5814,Food & Drink,Eating Out,-8.92,GBP,-195614.47,POS,London,GB,1045,user_001,,
13ff92e3-ca75-470d-9fb7-555a9eb34f2e,2032-08-26,2032-08-30,Deliveroo,5812,Food & Drink,Delivery,-26.42,GBP,-195640.89,E-Com,London,GB,4488,user_001,,
ee8f971b-f2bc-4715-a96d-c6bf4fd66e3a,2032-08-26,2032-08-27,Sainsbury's,5411,Groceries,Supermarket,-25.55,GBP,-195666.44,POS,London,GB,1045,user_001,,
c9c8bd1b-3956-45a3-8239-41a8db544352,2032-08-27,2032-08-30,Shell,5541,Transport,Fuel,-68.29,GBP,-195734.73,POS,London,GB,4488,user_001,,
2d768153-7f1a-4818-9e93-196c90383edf,2032-08-28,2032-08-30,Sainsbury's,5411,Groceries,Supermarket,-17.42,GBP,-195752.15,POS,London,GB,2219,user_001,,
502f8ed8-77a4-4a20-bdb7-9c861867b4c5,2032-08-28,2032-08-30,HM Revenue & Customs,9311,Income,Tax Refund,25.07,GBP,-195727.08,Credit,London,GB,2219,user_001,,Refund for Tesco
5c63614a-e273-43b5-813b-47c3a5d42d67,2032-08-28,2032-08-30,Pret A Manger,5814,Food & Drink,Eating Out,-9.49,GBP,-195736.57,POS,London,GB,2219,user_001,,
d567f24c-9803-4854-a1e5-13e7c8ebada3,2032-08-28,2032-08-30,Amazon UK,5942,Shopping,Online Retail,-16.51,GBP,-195753.08,E-Com,London,GB,4488,user_002,,
f17ce2a2-4931-4769-b25f-5bdf606a1a19,2032-08-28,2032-08-30,Tesco,5411,Groceries,Supermarket,-35.62,GBP,-195788.7,POS,London,GB,2219,user_001,,
25a2b9f2-0a1d-4c56-bbda-395fb05f6db0,2032-08-29,2032-08-30,Local Market,5499,Groceries,Specialty,-11.54,GBP,-195800.24,POS,London,GB,9074,user_001,,
488d70d2-7820-4cf5-9568-30a8333d3122,2032-08-29,2032-08-30,ATM Withdrawal,6011,Cash,ATM,-78.74,GBP,-195878.98,ATM,London,GB,9074,user_001,,
79436e66-592c-49cc-bfed-5085685753c6,2032-08-29,2032-08-31,Apple.com/bill,5734,Shopping,Electronics,-192.39,GBP,-196071.37,E-Com,Cupertino,US,1045,user_001,,
7f0f2d9d-9886-464e-9dcb-5e7c23be20bb,2032-08-29,2032-08-31,Uber UK,4121,Transport,Ride Hailing,-15.99,GBP,-196087.36,E-Com,London,GB,9074,user_001,,
9be05885-2636-491b-ad7f-6d25f08d04b9,2032-08-29,2032-08-30,Tesco,5411,Groceries,Supermarket,-59.2,GBP,-196146.56,POS,London,GB,1045,user_001,,
3e1d2b8a-840e-46ac-9da0-c800c966537d,2032-08-30,2032-08-30,Local Market,5499,Groceries,Specialty,-10.26,GBP,-196156.82,POS,London,GB,9074,user_001,,
42bcefca-f4ee-46a1-9bdc-45685a75d7c4,2032-08-30,2032-08-30,Deliveroo,5812,Food & Drink,Delivery,-22.39,GBP,-196179.21,E-Com,London,GB,1045,user_001,,
675ba6a7-ec4f-4ba9-8ceb-2bede76c53c1,2032-08-30,2032-08-30,Local Market,5499,Groceries,Specialty,-18.08,GBP,-196197.29,POS,London,GB,2219,user_001,,
871f8f6b-9ee5-4c52-b280-cecc6bbe7cd6,2032-08-30,2032-08-30,Pret A Manger,5814,Food & Drink,Eating Out,-10.06,GBP,-196207.35,POS,London,GB,9074,user_001,,
63e55f53-da93-4f02-91d6-4910d4a86763,2032-08-31,2032-09-02,Amazon UK,5942,Shopping,Online Retail,-73.85,GBP,-196281.2,E-Com,London,GB,9074,user_001,,
aa515372-1cb5-4163-a774-78afd2ff5308,2032-08-31,2032-09-02,Apple.com/bill,5734,Shopping,Electronics,-37.55,GBP,-196318.75,E-Com,Cupertino,US,9074,user_001,,
d9458371-e665-44a5-a151-814e9d3a449f,2032-08-31,2032-08-31,Waitrose,5411,Groceries,Supermarket,-47.24,GBP,-196365.99,POS,London,GB,4488,user_001,,
aff50195-7c37-4c3c-9713-7e0e5286b7b3,2032-09-01,2032-09-02,Crown Estates Lettings,6513,Housing,Rent,-1604.15,GBP,-197970.14,POS,London,GB,1045,user_001,rec_19f70fbcce,
bf74cbef-257a-4ee9-aa49-d22c336c365a,2032-09-01,2032-09-01,Local Market,5499,Groceries,Specialty,-14.05,GBP,-197984.19,POS,London,GB,4488,user_001,,
35f7a6c0-eb5e-4ff5-8a67-4bdbaf3bcc93,2032-09-02,2032-09-03,Transport for London,4111,Transport,Transit,-9.53,GBP,-197993.72,POS,London,GB,4488,user_001,,
eda19eed-67bf-4883-8bf3-7d7fd494cd03,2032-09-02,2032-09-02,Apple.com/bill,5734,Shopping,Electronics,-143.95,GBP,-198137.67,E-Com,Cupertino,US,1045,user_002,,
96585d30-dd19-4601-9df5-7f2134c84a5d,2032-09-03,2032-09-06,Pret A Manger,5814,Food & Drink,Eating Out,-9.37,GBP,-198147.04,POS,London,GB,4488,user_001,,
ad36b420-d728-4747-a0a5-cdeefdf380ac,2032-09-03,2032-09-03,Apple.com/bill,5734,Shopping,Electronics,-96.76,GBP,-198243.8,E-Com,Cupertino,US,2219,user_002,,
309fabe6-a3a3-4e24-813c-21554d7b1b57,2032-09-04,2032-09-06,Transport for London,4111,Transport,Transit,-9.0,GBP,-198252.8,POS,London,GB,9074,user_001,,
4221b035-00ef-4ffb-b83d-be7a9ac8ce48,2032-09-04,2032-09-06,Transport for London,4111,Transport,Transit,-6.16,GBP,-198258.96,POS,London,GB,9074,user_001,,
bcc0ed98-8c6b-46cb-8129-d38072b6ee3b,2032-09-04,2032-09-06,Waitrose,5411,Groceries,Supermarket,-64.46,GBP,-198323.42,POS,London,GB,4488,user_001,,
457b0100-dd82-4320-ab75-463b6cbb6fbe,2032-09-05,2032-09-06,Shell,5541,Transport,Fuel,-87.75,GBP,-198411.17,POS,London,GB,1045,user_001,,
ddd45bcd-4c8b-45d3-8343-04fbae5fa604,2032-09-05,2032-09-06,Shell,5541,Transport,Fuel,-36.26,GBP,-198447.43,POS,London,GB,2219,user_001,,
de93c92d-b869-4e27-9725-7a31dbb7b603,2032-09-05,2032-09-06,Shell,5541,Transport,Fuel,-63.36,GBP,-198510.79,POS,London,GB,1045,user_001,,
31dfa4c2-c933-4c10-aa0c-6cc08ea5563e,2032-09-06,2032-09-06,Amazon UK,5942,Shopping,Online Retail,-33.06,GBP,-198543.85,E-Com,London,GB,1045,user_001,,
32253b28-67b0-48cd-bc2e-ca8b1994cc3a,2032-09-06,2032-09-08,Uber UK,4121,Transport,Ride Hailing,-10.46,GBP,-198554.31,E-Com,London,GB,2219,user_001,,
5855aa05-c5b9-4b16-a46e-47f21f48c239,2032-09-06,2032-09-07,Sainsbury's,5411,Groceries,Supermarket,-45.44,GBP,-198599.75,POS,London,GB,9074,user_001,,
5ca2f2e5-46a2-458f-8e35-0fbf943a23dd,2032-09-06,2032-09-06,Uber UK,4121,Transport,Ride Hailing,-13.2,GBP,-198612.95,E-Com,London,GB,1045,user_002,,
aa1e1b6c-01aa-4fde-a347-c80075211440,2032-09-07,2032-09-07,Octopus Energy,4900,Utilities,Electricity,-119.82,GBP,-198732.77,Direct Debit,London,GB,9074,user_002,rec_09c3f12b18,
90039e12-7c2e-4d84-99e0-42cb3052124f,2032-09-08,2032-09-09,Pret A Manger,5814,Food & Drink,Eating Out,-11.41,GBP,-198744.18,POS,London,GB,2219,user_001,,
20e9e9f8-df6f-4bd5-879d-21b528c997d2,2032-09-09,2032-09-13,Sainsbury's,5411,Groceries,Supermarket,-60.2,GBP,-198804.38,POS,London,GB,1045,user_001,,
abcd6599-4a85-497e-b559-ce9f1fc5d3e1,2032-09-09,2032-09-09,Pret A Manger,5814,Food & Drink,Eating Out,-9.92,GBP,-198814.3,POS,London,GB,9074,user_002,,
ff7c9374-1cb5-4409-9f49-75288b95e426,2032-09-09,2032-09-09,Local Market,5499,Groceries,Specialty,-18.41,GBP,-198832.71,POS,London,GB,2219,user_001,,
0bc34ffc-68aa-4865-b9c6-b932f309f385,2032-09-11,2032-09-13,ATM Withdrawal,6011,Cash,ATM,-117.3,GBP,-198950.01,ATM,London,GB,9074,user_001,,
25ca5a00-d326-408e-babb-7c552c1dc6f8,2032-09-11,2032-09-13,Amazon UK,5942,Shopping,Online Retail,-51.89,GBP,-199001.9,E-Com,London,GB,1045,user_001,,
3838307d-37c2-4f5d-aa2f-8413cd657f84,2032-09-11,2032-09-13,Uber UK,4121,Transport,Ride Hailing,-17.55,GBP,-199019.45,E-Com,London,GB,2219,user_001,,
9651c41d-9e1b-4a8c-a776-9a2d3633813b,2032-09-11,2032-09-13,Deliveroo,5812,Food & Drink,Delivery,-15.88,GBP,-199035.33,E-Com,London,GB,2219,user_001,,
ae3bdb16-bf32-47b7-9689-312dcd19aaa0,2032-09-11,2032-09-13,Uber UK,4121,Transport,Ride Hailing,-24.14,GBP,-199059.47,E-Com,London,GB,1045,user_001,,
c15b1dbf-783f-44d7-926e-d9c1006404e9,2032-09-11,2032-09-13,Local Market,5499,Groceries,Specialty,-21.49,GBP,-199080.96,POS,London,GB,4488,user_001,,
d13d66ed-5903-416f-aa82-d4507ba583e4,2032-09-11,2032-09-13,Shell,5541,Transport,Fuel,-57.69,GBP,-199138.65,POS,London,GB,4488,user_001,,
293aa515-00e9-4712-a6d1-6f9e29c765a8,2032-09-12,2032-09-14,Sainsbury's,5411,Groceries,Supermarket,-45.77,GBP,-199184.42,POS,London,GB,2219,user_001,,
31a04b8c-4d85-4486-9a17-79260d495d0b,2032-09-12,2032-09-13,Amazon UK,5942,Shopping,Online Retail,-92.86,GBP,-199277.28,E-Com,London,GB,9074,user_001,,
3fd03449-f92f-419e-bb36-deb82f87f79d,2032-09-12,2032-09-13,Shell,5541,Transport,Fuel,-36.8,GBP,-199314.08,POS,London,GB,9074,user_001,,
f2842e6a-9b0a-4e95-b0e9-aad350da8624,2032-09-12,2032-09-14,Sainsbury's,5411,Groceries,Supermarket,-33.74,GBP,-199347.82,POS,London,GB,4488,user_001,,
3100a18a-465c-41dc-888f-4b3426e3123a,2032-09-13,2032-09-15,Transport for London,4111,Transport,Transit,-11.46,GBP,-199359.28,POS,London,GB,1045,user_001,,
54c41b03-5844-4af2-9825-e5d940a3578c,2032-09-13,2032-09-13,Thames Water,4900,Utilities,Water,-41.53,GBP,-199400.81,Direct Debit,Reading,GB,2219,user_001,rec_3a34d62842,
a3b3af97-778e-425f-a175-58c42740e024,2032-09-13,2032-09-15,City Council Tax,9399,Utilities,Council Tax,-171.33,GBP,-199572.14,Direct Debit,London,GB,1045,user_001,rec_f531495db5,
ce04ebba-09be-4550-ad16-e735e20ed429,2032-09-13,2032-09-13,Sainsbury's,5411,Groceries,Supermarket,-27.36,GBP,-199599.5,POS,London,GB,9074,user_001,,
f81f41a3-363d-44d4-84a6-e224d3755fcf,2032-09-13,2032-09-15,Uber UK,4121,Transport,Ride Hailing,-15.41,GBP,-199614.91,E-Com,London,GB,2219,user_001,,
d2ea6f06-e602-4e55-915c-f1edb37e2783,2032-09-14,2032-09-16,Transport for London,4111,Transport,Transit,-10.2,GBP,-199625.11,POS,London,GB,1045,user_001,,
fe967afc-89e7-4a5f-9b4e-c85942a21b55,2032-09-14,2032-09-14,Local Market,5499,Groceries,Specialty,-10.89,GBP,-199636.0,POS,London,GB,4488,user_001,,
605b75c5-ec85-402f-8e61-1036adf552ee,2032-09-15,2032-09-16,Sainsbury's,5411,Groceries,Supermarket,-52.79,GBP,-199688.79,POS,London,GB,1045,user_001,,
ca6547b0-3c07-4edc-b5e8-88b1f4c1d496,2032-09-15,2032-09-16,O2 UK,4814,Bills,Mobile,-51.03,GBP,-199739.82,Direct Debit,Slough,GB,2219,user_001,rec_95042d8101,
8983363d-b12c-49ff-b173-73c1c2b6bd1d,2032-09-16,2032-09-17,Uber UK,4121,Transport,Ride Hailing,-25.96,GBP,-199765.78,E-Com,London,GB,4488,user_001,,
b0746aa9-a591-4007-a69a-8cd2de5cf785,2032-09-16,2032-09-16,Airline Refund,4511,Travel,Refund,8.66,GBP,-199757.12,Credit,London,GB,4488,user_001,,Refund for Uber UK
f2cdfe3c-5f61-43c9-9ccb-4c9b69b5737c,2032-09-16,2032-09-20,Amazon UK,5942,Shopping,Online Retail,-109.36,GBP,-199866.48,E-Com,London,GB,4488,user_001,,
00c66836-b2f7-4fda-a610-ae0dbcd9c503,2032-09-17,2032-09-20,GymBox,7997,Wellness,Gym,-64.85,GBP,-199931.33,Direct Debit,London,GB,4488,user_001,rec_3906953fd2,
0f03ecd7-f49d-4729-ac75-68209387c998,2032-09-18,2032-09-20,Transport for London,4111,Transport,Transit,-11.85,GBP,-199943.18,POS,London,GB,1045,user_001,,
150e3a45-a107-42f4-8862-b8bf79e5f269,2032-09-18,2032-09-20,Local Market,5499,Groceries,Specialty,-16.89,GBP,-199960.07,POS,London,GB,2219,user_001,,
9ec4daab-6efd-40f3-8f84-907c24ea8002,2032-09-18,2032-09-20,Shell,5541,Transport,Fuel,-62.42,GBP,-200022.49,POS,London,GB,2219,user_001,,
baff6447-60e8-4cf6-ad0e-bf22f01ded77,2032-09-18,2032-09-20,Waitrose,5411,Groceries,Supermarket,-20.88,GBP,-200043.37,POS,London,GB,9074,user_001,,
d39e7ade-a61e-4d54-a461-e54dadb2c19d,2032-09-18,2032-09-20,Tesco,5411,Groceries,Supermarket,-75.94,GBP,-200119.31,POS,London,GB,4488,user_001,,
dbf8b85c-e838-4ab3-95e4-1e1fa25bbec4,2032-09-18,2032-09-20,Amazon UK,5942,Shopping,Online Retail,-110.44,GBP,-200229.75,E-Com,London,GB,4488,user_001,,
2adcf3b3-2fd5-4caf-8ede-76e0e929fdba,2032-09-19,2032-09-21,Transport for London,4111,Transport,Transit,-4.06,GBP,-200233.81,POS,London,GB,9074,user_001,,
a7f827ac-c544-4211-beb4-457c31ad6937,2032-09-19,2032-09-20,Uber UK,4121,Transport,Ride Hailing,-14.03,GBP,-200247.84,E-Com,London,GB,1045,user_001,,
d1aabd1f-9d67-443c-bd50-42d563b1258a,2032-09-19,2032-09-20,Local Market,5499,Groceries,Specialty,-17.45,GBP,-200265.29,POS,London,GB,4488,user_001,,
5bd0c7a3-3218-4053-a29f-bc27b7603cf0,2032-09-20,2032-09-21,Tesco,5411,Groceries,Supermarket,-46.97,GBP,-200312.26,POS,London,GB,2219,user_001,,
63ee3bbd-bdba-489c-81f2-6787396e95c9,2032-09-20,2032-09-20,Pret A Manger,5814,Food & Drink,Eating Out,-11.93,GBP,-200324.19,POS,London,GB,4488,user_001,,
73114f1a-7e4a-47e6-8161-c3460846364c,2032-09-20,2032-09-21,Transport for London,4111,Transport,Transit,-9.7,GBP,-200333.89,POS,London,GB,9074,user_001,,
91b6891d-0b59-43cf-9440-16a10f054e6f,2032-09-20,2032-09-20,Airline Refund,4511,Travel,Refund,82.0,GBP,-200251.89,Credit,London,GB,1045,user_001,,Refund for Amazon UK
c757e9e3-c0c1-4f9f-8d65-5d12df07eef9,2032-09-20,2032-09-21,Spotify,5735,Entertainment,Subscriptions,-8.0,GBP,-200259.89,E-Com,Stockholm,SE,9074,user_002,rec_34b6e9e33f,
06888875-192c-4886-b158-680ff887defb,2032-09-21,2032-09-23,Netflix,7841,Entertainment,Subscriptions,-13.08,GBP,-200272.97,E-Com,Los Gatos,US,1045,user_001,rec_1bfe33738d,
12b10dea-f1f9-4357-8306-fcd82532bb0a,2032-09-21,2032-09-23,Local Market,5499,Groceries,Specialty,-21.48,GBP,-200294.45,POS,London,GB,2219,user_001,,
1e1680de-ac4d-49e5-a037-416a14c6b630,2032-09-21,2032-09-21,Deliveroo,5812,Food & Drink,Delivery,-13.84,GBP,-200308.29,E-Com,London,GB,9074,user_002,,
549b33d3-e17f-4ec0-b3cf-9973030baf73,2032-09-22,2032-09-24,Uber UK,4121,Transport,Ride Hailing,-19.73,GBP,-200328.02,E-Com,London,GB,9074,user_001,,
e574755a-21d1-47d1-9a3b-cac6cfb28799,2032-09-22,2032-09-22,Uber UK,4121,Transport,Ride Hailing,-34.48,GBP,-200362.5,E-Com,London,GB,2219,user_001,,
9923e4f2-9eb2-430d-a148-e5ee537eccbf,2032-09-23,2032-09-24,Uber UK,4121,Transport,Ride Hailing,-23.49,GBP,-200385.99,E-Com,London,GB,9074,user_001,,
c1add9e3-15f2-4838-9ed4-cc548c37ce34,2032-09-23,2032-09-24,Tesco,5411,Groceries,Supermarket,-21.79,GBP,-200407.78,POS,London,GB,1045,user_001,,
1c72b786-7543-4510-a533-2f6ca00444a9,2032-09-24,2032-09-27,Transport for London,4111,Transport,Transit,-6.87,GBP,-200414.65,POS,London,GB,1045,user_001,,
7a2dc925-9361-4d9a-85e5-8b45be61f3f5,2032-09-24,2032-09-24,Uber UK,4121,Transport,Ride Hailing,-11.2,GBP,-200425.85,E-Com,London,GB,1045,user_001,,
db115bd7-62c7-4eef-91e4-01b1fb894d9e,2032-09-24,2032-09-24,T212 Capital,6011,Income,Salary,3388.32,GBP,-197037.53,Credit,London,GB,1045,user_001,rec_2ff8f778d0,
ffdb2730-ca33-4529-80fa-93d22ef26f54,2032-09-24,2032-09-27,Local Market,5499,Groceries,Specialty,-18.63,GBP,-197056.16,POS,London,GB,4488,user_002,,
034bc0b2-d3e7-48d0-8f5f-dea628b4e2ee,2032-09-25,2032-09-27,Pret A Manger,5814,Food & Drink,Eating Out,-6.17,GBP,-197062.33,POS,London,GB,4488,user_002,,
32fe42c7-d098-4e83-b7e6-669d1bc5a176,2032-09-25,2032-09-27,Pret A Manger,5814,Food & Drink,Eating Out,-9.69,GBP,-197072.02,POS,London,GB,4488,user_002,,
72909fda-90d2-44f9-91c8-62f3833c1f8a,2032-09-25,2032-09-27,Sainsbury's,5411,Groceries,Supermarket,-38.37,GBP,-197110.39,POS,London,GB,1045,user_001,,
31356a0e-8636-4d99-ad22-80084fc0ce55,2032-09-26,2032-09-27,Transport for London,4111,Transport,Transit,-3.91,GBP,-197114.3,POS,London,GB,2219,user_002,,
37f5ff77-115e-450e-a77c-42bcf245cb18,2032-09-26,2032-09-27,Uber UK,4121,Transport,Ride Hailing,-24.92,GBP,-197139.22,E-Com,London,GB,2219,user_001,,
a1759ba7-c925-4c0a-b37f-58580944a9b7,2032-09-26,2032-09-27,Waitrose,5411,Groceries,Supermarket,-34.21,GBP,-197173.43,POS,London,GB,4488,user_001,,
a6a82cad-8439-4031-ab1c-3cea8089bcb9,2032-09-26,2032-09-27,Uber UK,4121,Transport,Ride Hailing,-23.76,GBP,-197197.19,E-Com,London,GB,1045,user_002,,
c6d8d440-581e-45c5-bc89-b2b2c67f661f,2032-09-26,2032-09-27,Shell,5541,Transport,Fuel,-56.82,GBP,-197254.01,POS,London,GB,4488,user_001,,
d2ec3263-5cbf-4529-a6f5-022e68749dfa,2032-09-26,2032-09-27,Waitrose,5411,Groceries,Supermarket,-26.13,GBP,-197280.14,POS,London,GB,2219,user_001,,
1d1bfd51-bbcf-4cc3-85fc-57f94bc2b81f,2032-09-27,2032-09-27,Tesco,5411,Groceries,Supermarket,-74.11,GBP,-197354.25,POS,London,GB,1045,user_001,,
5fca33d8-78de-4a2d-b382-abdf0f5377e9,2032-09-27,2032-09-29,Tesco,5411,Groceries,Supermarket,-73.9,GBP,-197428.15,POS,London,GB,2219,user_002,,
6505ed8d-6aee-41a7-b97a-65f57ee786a5,2032-09-28,2032-09-29,Pret A Manger,5814,Food & Drink,Eating Out,-5.7,GBP,-197433.85,POS,London,GB,1045,user_001,,
d3352050-0e8d-4291-9b98-038410fc9a6d,2032-09-29,2032-09-29,Uber UK,4121,Transport,Ride Hailing,-29.4,GBP,-197463.25,E-Com,London,GB,9074,user_001,,
fa7d3a51-ccb9-4f17-b63e-d9e4bdb10362,2032-09-29,2032-10-01,Waitrose,5411,Groceries,Supermarket,-50.17,GBP,-197513.42,POS,London,GB,2219,user_001,,
0510d134-4aeb-4fb7-a229-3dcabab545a2,2032-09-30,2032-10-04,Tesco,5411,Groceries,Supermarket,-83.92,GBP,-197597.34,POS,London,GB,1045,user_001,,
81534f05-ed2e-4e68-b715-c9bd592cadbf,2032-09-30,2032-10-04,Shell,5541,Transport,Fuel,-89.39,GBP,-197686.73,POS,London,GB,4488,user_001,,
a41b178d-fc16-48fe-a547-0beb2341fa6f,2032-09-30,2032-09-30,Tesco,5411,Groceries,Supermarket,-71.49,GBP,-197758.22,POS,London,GB,9074,user_001,,
ddb77141-a75b-4728-940e-8156136446fc,2032-09-30,2032-10-01,Sainsbury's,5411,Groceries,Supermarket,-25.69,GBP,-197783.91,POS,London,GB,9074,user_001,,
098e32cf-424a-4382-b5a6-ba3275083d94,2032-10-01,2032-10-01,Local Market,5499,Groceries,Specialty,-7.75,GBP,-197791.66,POS,London,GB,1045,user_002,,
2c0d546b-3393-401c-8ce3-6e2210a60546,2032-10-01,2032-10-01,Crown Estates Lettings,6513,Housing,Rent,-1546.97,GBP,-199338.63,POS,London,GB,1045,user_002,rec_fc2ae06846,
01b7b962-e5e8-4527-b9e4-782c06d4d258,2032-10-02,2032-10-04,Local Market,5499,Groceries,Specialty,-8.37,GBP,-199347.0,POS,London,GB,4488,user_001,,
4f581306-a88c-490b-aa28-5e27b4884b6a,2032-10-02,2032-10-04,Waitrose,5411,Groceries,Supermarket,-56.38,GBP,-199403.38,POS,London,GB,4488,user_001,,
c7434177-067f-4933-821f-08836b2c6af7,2032-10-02,2032-10-04,Uber UK,4121,Transport,Ride Hailing,-13.9,GBP,-199417.28,E-Com,London,GB,4488,user_002,,
db42dffe-9780-4d25-9ad7-dabcfe0381ad,2032-10-02,2032-10-04,Local Market,5499,Groceries,Specialty,-7.06,GBP,-199424.34,POS,London,GB,1045,user_001,,
05ee9467-8b5e-4478-955d-cedc3327743b,2032-10-03,2032-10-04,Deliveroo,5812,Food & Drink,Delivery,-15.62,GBP,-199439.96,E-Com,London,GB,4488,user_001,,
5028676a-5dbf-4003-9dda-5332d12a9af9,2032-10-03,2032-10-05,Shell,5541,Transport,Fuel,-79.62,GBP,-199519.58,POS,London,GB,9074,user_001,,
c030b953-edba-4333-be16-49aafc3b03df,2032-10-03,2032-10-04,Local Market,5499,Groceries,Specialty,-9.93,GBP,-199529.51,POS,London,GB,1045,user_001,,
dc2f420e-e942-4a8b-a4e2-21d42b71e65f,2032-10-03,2032-10-05,Sainsbury's,5411,Groceries,Supermarket,-61.59,GBP,-199591.1,POS,London,GB,1045,user_001,,
12b4b8d3-bf15-4525-9065-19fc6ded9ef7,2032-10-04,2032-10-06,Sainsbury's,5411,Groceries,Supermarket,-50.4,GBP,-199641.5,POS,London,GB,9074,user_001,,
5e468268-d073-43a4-b8a4-49da15aa2664,2032-10-04,2032-10-05,Deliveroo,5812,Food & Drink,Delivery,-14.2,GBP,-199655.7,E-Com,London,GB,1045,user_001,,
787f82d9-2772-4ce9-8d06-dfa3da39e32a,2032-10-04,2032-10-05,Local Market,5499,Groceries,Specialty,-6.09,GBP,-199661.79,POS,London,GB,4488,user_001,,
89af109d-7cc9-4649-9b27-d343b2e98f95,2032-10-04,2032-10-04,Tesco,5411,Groceries,Supermarket,-48.82,GBP,-199710.61,POS,London,GB,4488,user_001,,
6eac1e41-1ed9-49f3-a9f9-399da928776e,2032-10-05,2032-10-06,Transport for London,4111,Transport,Transit,-10.88,GBP,-199721.49,POS,London,GB,4488,user_001,,
793e56ae-7476-4f9d-8a18-3b59e8ae65f4,2032-10-05,2032-10-05,Amazon UK,5942,Shopping,Online Retail,-31.79,GBP,-199753.28,E-Com,London,GB,2219,user_001,,
881afd27-1b0c-4d20-9060-686829688265,2032-10-07,2032-10-07,Deliveroo,5812,Food & Drink,Delivery,-31.77,GBP,-199785.05,E-Com,London,GB,2219,user_001,,
fcb0b8eb-9fe1-4f3b-aaf3-c9e176399ff1,2032-10-07,2032-10-08,Octopus Energy,4900,Utilities,Electricity,-136.1,GBP,-199921.15,Direct Debit,London,GB,4488,user_001,rec_141a4a0666,
c6a8b6a7-d3db-4b97-9164-7c52a10a03f2,2032-10-08,2032-10-08,Deliveroo,5812,Food & Drink,Delivery,-32.03,GBP,-199953.18,E-Com,London,GB,4488,user_001,,
2f0fc9a8-8c73-4329-985d-cd46f5aa5712,2032-10-09,2032-10-11,Tesco,5411,Groceries,Supermarket,-78.08,GBP,-200031.26,POS,London,GB,1045,user_001,,
7de3218a-94da-4bc0-a5d5-f72ca9a04a19,2032-10-09,2032-10-11,Waitrose,5411,Groceries,Supermarket,-81.87,GBP,-200113.13,POS,London,GB,4488,user_001,,
7f754d05-19af-4b0d-a1cc-db9b8a4fa3fe,2032-10-09,2032-10-11,Pret A Manger,5814,Food & Drink,Eating Out,-9.29,GBP,-200122.42,POS,London,GB,1045,user_001,,
90ed87e9-dbf2-44f6-8d7e-e05d04fe6329,2032-10-09,2032-10-11,Pret A Manger,5814,Food & Drink,Eating Out,-6.3,GBP,-200128.72,POS,London,GB,4488,user_001,,
4baab874-4491-4778-9584-40c8252ebe21,2032-10-10,2032-10-11,Tesco,5411,Groceries,Supermarket,-60.27,GBP,-200188.99,POS,London,GB,4488,user_001,,
a8902a67-3897-4217-a16f-3d28fcb6c84b,2032-10-10,2032-10-12,Deliveroo,5812,Food & Drink,Delivery,-24.86,GBP,-200213.85,E-Com,London,GB,1045,user_001,,
de159019-64ab-46ff-bee0-90099553c54c,2032-10-10,2032-10-12,Local Market,5499,Groceries,Specialty,-6.95,GBP,-200220.8,POS,London,GB,4488,user_001,,
fa0e24a2-5142-4d2f-aabf-8d0532deb147,2032-10-10,2032-10-11,Shell,5541,Transport,Fuel,-70.31,GBP,-200291.11,POS,London,GB,1045,user_001,,
ba55d3c0-f167-48cd-9642-fa871a54b8d8,2032-10-11,2032-10-11,Amazon UK,5942,Shopping,Online Retail,-42.91,GBP,-200334.02,E-Com,London,GB,2219,user_001,,
e117d698-58b5-46be-9d98-f1abadef9ca7,2032-10-11,2032-10-11,Thames Water,4900,Utilities,Water,-40.23,GBP,-200374.25,Direct Debit,Reading,GB,1045,user_001,rec_3a34d62842,
96715dbb-f94a-4275-a8b9-6bbb2258b636,2032-10-12,2032-10-12,Apple.com/bill,5734,Shopping,Electronics,-196.95,GBP,-200571.2,E-Com,Cupertino,US,9074,user_001,,
cf9ff075-6278-47c5-ac59-fe09e40bb435,2032-10-12,2032-10-12,Pret A Manger,5814,Food & Drink,Eating Out,-6.66,GBP,-200577.86,POS,London,GB,2219,user_001,,
80c88e2a-01fe-43c4-8fcd-0033224e27e0,2032-10-13,2032-10-13,Tesco,5411,Groceries,Supermarket,-72.51,GBP,-200650.37,POS,London,GB,1045,user_001,,
99bff998-5b44-4ae3-b794-f8f023c1ea10,2032-10-13,2032-10-15,City Council Tax,9399,Utilities,Council Tax,-157.84,GBP,-200808.21,Direct Debit,London,GB,4488,user_001,rec_f531495db5,
0a940401-86a6-4711-be13-8812380e7290,2032-10-14,2032-10-14,Deliveroo,5812,Food & Drink,Delivery,-17.13,GBP,-200825.34,E-Com,London,GB,4488,user_002,,
1f1096c0-527a-414a-a2df-7766a0897e94,2032-10-14,2032-10-15,Amazon UK,5942,Shopping,Online Retail,-68.19,GBP,-200893.53,E-Com,London,GB,4488,user_001,,
8550bbf4-abcf-4f4b-bf94-1fed253eb202,2032-10-15,2032-10-15,Amazon UK,5942,Shopping,Online Retail,-25.33,GBP,-200918.86,E-Com,London,GB,2219,user_001,,
da1b4160-0197-4f0d-aa72-3fd35c704787,2032-10-15,2032-10-18,O2 UK,4814,Bills,Mobile,-45.65,GBP,-200964.51,Direct Debit,Slough,GB,2219,user_001,rec_95042d8101,
150be638-c1b2-4d2c-beb1-9af972a91a3c,2032-10-16,2032-10-18,Deliveroo,5812,Food & Drink,Delivery,-16.62,GBP,-200981.13,E-Com,London,GB,2219,user_001,,
80c29635-b588-41f6-bc00-ca197541a532,2032-10-16,2032-10-18,Tesco,5411,Groceries,Supermarket,-18.29,GBP,-200999.42,POS,London,GB,9074,user_001,,
fc191def-a799-427a-8556-e01e0ae36360,2032-10-16,2032-10-18,Pret A Manger,5814,Food & Drink,Eating Out,-6.78,GBP,-201006.2,POS,London,GB,4488,user_001,,
201d86fc-fb9a-4f34-9cdf-a5e9cb191113,2032-10-17,2032-10-18,Shell,5541,Transport,Fuel,-61.59,GBP,-201067.79,POS,London,GB,4488,user_002,,
5f2405ea-80cb-41c2-90d2-0c0c2393523e,2032-10-17,2032-10-18,Local Market,5499,Groceries,Specialty,-10.61,GBP,-201078.4,POS,London,GB,2219,user_001,,
b5d3b111-176a-4b3e-bbb9-e61adfb7a823,2032-10-17,2032-10-19,Deliveroo,5812,Food & Drink,Delivery,-20.66,GBP,-201099.06,E-Com,London,GB,2219,user_001,,
02aae5ac-1d9b-4002-a042-c6e95cf1f565,2032-10-18,2032-10-18,Apple.com/bill,5734,Shopping,Electronics,-207.8,USD,-201306.86,E-Com,Cupertino,US,2219,user_001,,FX purchase 257.45 USD @ rate 1.24
2aeea251-2e81-4d90-8d00-e83e5b6d390e,2032-10-18,2032-10-18,Tesco,5411,Groceries,Supermarket,-29.02,GBP,-201335.88,POS,London,GB,1045,user_001,,
4784e43d-7697-4912-a9f0-c01295321d0e,2032-10-18,2032-10-19,Apple.com/bill,5734,Shopping,Electronics,-208.48,USD,-201544.36,E-Com,Cupertino,US,2219,user_001,,FX purchase 251.73 USD @ rate 1.21
7a1136d2-8967-4e85-b7f1-017cac8d02cd,2032-10-18,2032-10-18,Shell,5541,Transport,Fuel,-93.7,GBP,-201638.06,POS,London,GB,4488,user_001,,
97b396bf-afc7-4fbd-96ee-9ff777551ac5,2032-10-18,2032-10-20,GymBox,7997,Wellness,Gym,-51.57,GBP,-201689.63,Direct Debit,London,GB,9074,user_001,rec_3906953fd2,
c77c1a47-6753-451e-8597-b68859625dcd,2032-10-19,2032-10-20,Spotify,5735,Entertainment,Subscriptions,-8.97,GBP,-201698.6,E-Com,Stockholm,SE,1045,user_001,rec_4c746d2c3b,
cc4cfee3-4f90-4b0d-8297-a41118b740e9,2032-10-19,2032-10-19,Pret A Manger,5814,Food & Drink,Eating Out,-7.06,GBP,-201705.66,POS,London,GB,1045,user_001,,
cdd7592e-889a-40d6-9ac1-adc55acc9b27,2032-10-19,2032-10-19,Waitrose,5411,Groceries,Supermarket,-75.66,GBP,-201781.32,POS,London,GB,9074,user_001,,
f2b5a42a-2054-4ee4-b516-4b6df9889d4d,2032-10-19,2032-10-20,Deliveroo,5812,Food & Drink,Delivery,-33.64,GBP,-201814.96,E-Com,London,GB,1045,user_001,,
8a99a6d9-c3c0-49ea-8a92-5cca83c8cfe9,2032-10-20,2032-10-22,Sainsbury's,5411,Groceries,Supermarket,-32.01,GBP,-201846.97,POS,London,GB,4488,user_001,,
a091f596-bb8a-43cb-b105-f56c349670b1,2032-10-20,2032-10-22,Apple.com/bill,5734,Shopping,Electronics,-34.4,GBP,-201881.37,E-Com,Cupertino,US,1045,user_001,,
a5674112-cf52-4e0f-aeae-42cf00ac3ee6,2032-10-20,2032-10-20,HM Revenue & Customs,9311,Income,Tax Refund,66.34,GBP,-201815.03,Credit,London,GB,2219,user_001,,Refund for City Council Tax
34799435-1fac-42d2-a9f1-ed4fad30b427,2032-10-21,2032-10-25,ATM Withdrawal,6011,Cash,ATM,-104.47,GBP,-201919.5,ATM,London,GB,9074,user_001,,
4b96d479-370e-48f2-8a9d-55c4679cfaf0,2032-10-21,2032-10-21,Netflix,7841,Entertainment,Subscriptions,-14.59,GBP,-201934.09,E-Com,Los Gatos,US,2219,user_002,rec_d9322c1382,
4dd6662a-92b3-4a79-b76d-d51510adbcc1,2032-10-22,2032-10-25,Amazon UK,5942,Shopping,Online Retail,-37.12,GBP,-201971.21,E-Com,London,GB,2219,user_001,,
d7329f16-daf6-45a1-9c57-b7a09c3788cc,2032-10-23,2032-10-25,Tesco,5411,Groceries,Supermarket,-65.54,GBP,-202036.75,POS,London,GB,4488,user_002,,
fdbdc81e-3a1a-4e59-ae17-96fcea4da3de,2032-10-23,2032-10-25,Waitrose,5411,Groceries,Supermarket,-43.56,GBP,-202080.31,POS,London,GB,2219,user_002,,
371cefa5-0212-4558-9eb5-927e0987a197,2032-10-24,2032-10-25,Waitrose,5411,Groceries,Supermarket,-75.73,GBP,-202156.04,POS,London,GB,1045,user_001,,
b6c9343d-d5e4-4a16-88c5-c3caacfa5328,2032-10-24,2032-10-26,Deliveroo,5812,Food & Drink,Delivery,-25.41,GBP,-202181.45,E-Com,London,GB,1045,user_001,,
c7c2a068-16d8-47ff-80b4-983443c9743d,2032-10-24,2032-10-25,Sainsbury's,5411,Groceries,Supermarket,-40.25,GBP,-202221.7,POS,London,GB,4488,user_002,,
e7ba0a7c-6f23-4ed6-bf3b-63f58c3c9c6b,2032-10-24,2032-10-25,Shell,5541,Transport,Fuel,-40.23,GBP,-202261.93,POS,London,GB,9074,user_001,,
18a81c2e-101d-412e-8f88-1f9503826545,2032-10-25,2032-10-27,Transport for London,4111,Transport,Transit,-11.49,GBP,-202273.42,POS,London,GB,4488,user_001,,
7e31901d-f049-47fb-ad07-837dcfedecc7,2032-10-25,2032-10-26,Waitrose,5411,Groceries,Supermarket,-30.99,GBP,-202304.41,POS,London,GB,9074,user_001,,
c296e498-d380-4395-8fc6-a66174a45706,2032-10-25,2032-10-25,T212 Capital,6011,Income,Salary,3287.79,GBP,-199016.62,Credit,London,GB,1045,user_001,rec_2ff8f778d0,
828c907e-df02-4482-a9e8-9197c01b89ee,2032-10-27,2032-10-28,Shell,5541,Transport,Fuel,-80.73,GBP,-199097.35,POS,London,GB,1045,user_001,,
3cec1acd-89ce-4b94-ae93-19b25637585e,2032-10-28,2032-10-28,Transport for London,4111,Transport,Transit,-3.85,GBP,-199101.2,POS,London,GB,9074,user_001,,
ba092994-d3c5-4695-b65e-a9f52d7e47d9,2032-10-28,2032-10-29,Deliveroo,5812,Food & Drink,Delivery,-23.0,GBP,-199124.2,E-Com,London,GB,4488,user_001,,
c9520728-329f-4a18-8d9a-e9e4d6af3bcb,2032-10-28,2032-10-29,Amazon UK,5942,Shopping,Online Retail,-55.68,GBP,-199179.88,E-Com,London,GB,4488,user_001,,
d90f4b10-eebb-438a-8825-5fb98ddcc68c,2032-10-28,2032-11-01,Amazon UK,5942,Shopping,Online Retail,-57.84,GBP,-199237.72,E-Com,London,GB,1045,user_001,,
2adb791c-022a-4e3d-94ff-a130cad1fdfd,2032-10-29,2032-10-29,Uber UK,4121,Transport,Ride Hailing,-16.36,GBP,-199254.08,E-Com,London,GB,2219,user_001,,
7fca0647-df51-4ff9-8117-54d9f3d67428,2032-10-29,2032-11-01,Shell,5541,Transport,Fuel,-92.15,GBP,-199346.23,POS,London,GB,9074,user_001,,
a6ab8419-2e3f-450f-a772-91c89d40a43b,2032-10-30,2032-11-01,Apple.com/bill,5734,Shopping,Electronics,-190.83,USD,-199537.06,E-Com,Cupertino,US,4488,user_001,,FX purchase 239.07 USD @ rate 1.25
af9c6b9f-188b-40e7-b04e-631edaa2dd04,2032-10-30,2032-11-01,Deliveroo,5812,Food & Drink,Delivery,-28.82,GBP,-199565.88,E-Com,London,GB,4488,user_001,,
0ea1acac-e1b1-446d-a960-51d32de08672,2032-10-31,2032-11-02,Local Market,5499,Groceries,Specialty,-14.56,GBP,-199580.44,POS,London,GB,9074,user_002,,
3e567e8b-7e2d-478c-86f7-2dca640b25c0,2032-11-01,2032-11-01,Tesco,5411,Groceries,Supermarket,-33.76,GBP,-199614.2,POS,London,GB,4488,user_001,,
9f429f18-d4ac-4fdb-ae59-689192f51cf7,2032-11-01,2032-11-01,Pret A Manger,5814,Food & Drink,Eating Out,-8.2,GBP,-199622.4,POS,London,GB,4488,user_002,,
b9b3ce36-1387-41c2-8b63-4ec0b1db9c28,2032-11-01,2032-11-03,Crown Estates Lettings,6513,Housing,Rent,-1536.95,GBP,-201159.35,POS,London,GB,4488,user_002,rec_fc2ae06846,
3aaacf38-6b5e-4cb4-8f96-f8e2787a1b05,2032-11-02,2032-11-04,Shell,5541,Transport,Fuel,-57.49,GBP,-201216.84,POS,London,GB,1045,user_001,,
53a41154-bf52-462e-b216-5f7dcc1ebdf7,2032-11-02,2032-11-03,Waitrose,5411,Groceries,Supermarket,-39.36,GBP,-201256.2,POS,London,GB,2219,user_001,,
6c78e396-0827-41e3-9665-effda18b0cac,2032-11-02,2032-11-04,Tesco,5411,Groceries,Supermarket,-70.59,GBP,-201326.79,POS,London,GB,4488,user_001,,
0db3520b-f4e7-458d-a4a0-5a9284c44e9e,2032-11-03,2032-11-05,Deliveroo,5812,Food & Drink,Delivery,-21.39,GBP,-201348.18,E-Com,London,GB,1045,user_002,,
35841546-a52c-438e-ad86-b8a3918072da,2032-11-03,2032-11-05,Deliveroo,5812,Food & Drink,Delivery,-28.03,GBP,-201376.21,E-Com,London,GB,4488,user_001,,
a0cf50ea-d87e-4c67-9a27-8dfad9f95244,2032-11-03,2032-11-03,Tesco,5411,Groceries,Supermarket,-66.22,GBP,-201442.43,POS,London,GB,1045,user_001,,
7968de97-8e5b-4d6d-9780-732fd6e29b03,2032-11-04,2032-11-04,Uber UK,4121,Transport,Ride Hailing,-30.27,GBP,-201472.7,E-Com,London,GB,2219,user_002,,
8a85c7f7-efc8-4441-8c76-4ab0db9fa785,2032-11-04,2032-11-05,Tesco,5411,Groceries,Supermarket,-36.12,GBP,-201508.82,POS,London,GB,2219,user_001,,
5925ec1e-f05e-4f28-8012-d3d3daca6194,2032-11-05,2032-11-08,Deliveroo,5812,Food & Drink,Delivery,-13.8,GBP,-201522.62,E-Com,London,GB,1045,user_001,,
758a641a-a4c1-46e1-91b4-2a7814beb497,2032-11-05,2032-11-08,Sainsbury's,5411,Groceries,Supermarket,-34.86,GBP,-201557.48,POS,London,GB,9074,user_001,,
e5aa94cd-06c2-4fbe-bf9a-965e5b7cc597,2032-11-05,2032-11-08,Shell,5541,Transport,Fuel,-94.11,GBP,-201651.59,POS,London,GB,9074,user_001,,
d8e746e0-dcc8-45a4-9128-99a2a8189025,2032-11-06,2032-11-08,Amazon UK,5942,Shopping,Online Retail,-46.19,GBP,-201697.78,E-Com,London,GB,9074,user_001,,
0e81e337-4631-4f34-9e52-0f35c198ef6b,2032-11-07,2032-11-09,Uber UK,4121,Transport,Ride Hailing,-32.14,GBP,-201729.92,E-Com,London,GB,9074,user_002,,
2a5b5758-2f80-41e6-b99b-bda170517b9c,2032-11-07,2032-11-08,Sainsbury's,5411,Groceries,Supermarket,-62.32,GBP,-201792.24,POS,London,GB,2219,user_001,,
73fc07c4-24cd-4c0a-9c61-7af2fd929d20,2032-11-07,2032-11-08,Local Market,5499,Groceries,Specialty,-19.64,GBP,-201811.88,POS,London,GB,9074,user_001,,
818e8109-2831-4777-9f10-41ecc2e5218b,2032-11-07,2032-11-08,Tesco,5411,Groceries,Supermarket,-64.3,GBP,-201876.18,POS,London,GB,2219,user_002,,
ca0d71d9-7ebb-492e-aad3-d58f35f36533,2032-11-07,2032-11-08,Shell,5541,Transport,Fuel,-60.76,GBP,-201936.94,POS,London,GB,9074,user_001,,
d1172b47-3358-4b0e-a74c-1000d884daa8,2032-11-07,2032-11-08,Deliveroo,5812,Food & Drink,Delivery,-25.15,GBP,-201962.09,E-Com,London,GB,4488,user_001,,
dbfdd832-e2dd-4bcd-a586-e32f579b6370,2032-11-07,2032-11-09,Sainsbury's,5411,Groceries,Supermarket,-33.5,GBP,-201995.59,POS,London,GB,2219,user_001,,
3cc4959c-b08a-4b05-9bef-8624fe15e442,2032-11-08,2032-11-08,Shell,5541,Transport,Fuel,-75.85,GBP,-202071.44,POS,London,GB,2219,user_002,,
986dd1b9-1ed7-4a48-932a-a1239c326225,2032-11-08,2032-11-08,Octopus Energy,4900,Utilities,Electricity,-127.01,GBP,-202198.45,Direct Debit,London,GB,2219,user_002,rec_09c3f12b18,
282c7b84-3926-4e1b-839d-43b061480688,2032-11-09,2032-11-11,Sainsbury's,5411,Groceries,Supermarket,-49.43,GBP,-202247.88,POS,London,GB,2219,user_001,,
58c90044-83ce-42cc-9b2d-d60d26038923,2032-11-09,2032-11-11,Amazon UK,5942,Shopping,Online Retail,-22.27,GBP,-202270.15,E-Com,London,GB,2219,user_002,,
98c64ba8-089c-4dca-a46d-2425fe8f0958,2032-11-09,2032-11-11,Apple.com/bill,5734,Shopping,Electronics,-46.58,GBP,-202316.73,E-Com,Cupertino,US,2219,user_002,,
6b43237d-4e16-461c-adcd-0dabbc936e07,2032-11-10,2032-11-11,Sainsbury's,5411,Groceries,Supermarket,-21.11,GBP,-202337.84,POS,London,GB,4488,user_001,,
7b241a30-187a-4a1c-820b-49b8e977870d,2032-11-10,2032-11-10,Pret A Manger,5814,Food & Drink,Eating Out,-6.49,GBP,-202344.33,POS,London,GB,2219,user_001,,
9d4aaae3-34c9-4c22-9bf0-23241792b91a,2032-11-10,2032-11-10,Waitrose,5411,Groceries,Supermarket,-34.77,GBP,-202379.1,POS,London,GB,9074,user_002,,
4eded448-8cfc-4d95-8c9d-29b8da45ee7c,2032-11-11,2032-11-12,Local Market,5499,Groceries,Specialty,-21.82,GBP,-202400.92,POS,London,GB,4488,user_001,,
5ed70242-54a5-4821-92c2-0e74ae00c7fa,2032-11-11,2032-11-15,Thames Water,4900,Utilities,Water,-39.81,GBP,-202440.73,Direct Debit,Reading,GB,1045,user_001,rec_3a34d62842,
86d63ae4-796a-4062-b7a9-524e9841e1f2,2032-11-11,2032-11-12,Pret A Manger,5814,Food & Drink,Eating Out,-11.04,GBP,-202451.77,POS,London,GB,9074,user_001,,
a8fd043d-bdf5-4310-89d2-7de207eb743b,2032-11-12,2032-11-15,Apple.com/bill,5734,Shopping,Electronics,-119.1,GBP,-202570.87,E-Com,Cupertino,US,1045,user_001,,
0d5c370b-27bb-462c-82c0-a2cd2ec8630c,2032-11-13,2032-11-15,Uber UK,4121,Transport,Ride Hailing,-10.26,GBP,-202581.13,E-Com,London,GB,9074,user_001,,
1e484946-3a89-49d6-a725-d672cf9d18bc,2032-11-13,2032-11-15,Deliveroo,5812,Food & Drink,Delivery,-31.95,GBP,-202613.08,E-Com,London,GB,1045,user_001,,
49eacafc-a4b1-4791-a153-815563c1d28b,2032-11-13,2032-11-15,Local Market,5499,Groceries,Specialty,-11.69,GBP,-202624.77,POS,London,GB,1045,user_002,,
bb08101a-27f3-42fa-9e56-e34446ddecaa,2032-11-13,2032-11-15,Apple.com/bill,5734,Shopping,Electronics,-29.49,GBP,-202654.26,E-Com,Cupertino,US,1045,user_001,,
be8bb5e4-829a-42ad-8155-bd94f1019e41,2032-11-13,2032-11-15,Deliveroo,5812,Food & Drink,Delivery,-24.6,GBP,-202678.86,E-Com,London,GB,1045,user_001,,
10c9fb5b-b996-4d39-ac31-d25b2222b391,2032-11-14,2032-11-15,Pret A Manger,5814,Food & Drink,Eating Out,-5.82,GBP,-202684.68,POS,London,GB,2219,user_002,,
820dba73-065c-4391-8b9d-960586057a1c,2032-11-14,2032-11-16,Tesco,5411,Groceries,Supermarket,-81.74,GBP,-202766.42,POS,London,GB,1045,user_001,,
85ce7ab4-1e27-4907-930b-964f13d3c1dc,2032-11-14,2032-11-15,Waitrose,5411,Groceries,Supermarket,-61.15,GBP,-202827.57,POS,London,GB,2219,user_001,,
9b2df3ba-c6dc-4e91-8733-f4e06bc4eb3d,2032-11-14,2032-11-16,Pret A Manger,5814,Food & Drink,Eating Out,-7.15,GBP,-202834.72,POS,London,GB,1045,user_001,,
ad8714d0-abd3-4759-a397-9a488e654f28,2032-11-14,2032-11-15,Local Market,5499,Groceries,Specialty,-7.61,GBP,-202842.33,POS,London,GB,2219,user_002,,
c3a5c0ab-7497-4f91-b08c-bf83bbd97808,2032-11-14,2032-11-15,Waitrose,5411,Groceries,Supermarket,-53.56,GBP,-202895.89,POS,London,GB,4488,user_001,,
071b0e28-c315-4da7-92b2-4d0206fc76da,2032-11-15,2032-11-17,Shell,5541,Transport,Fuel,-38.44,GBP,-202934.33,POS,London,GB,4488,user_001,,
153ea71a-f33c-450d-a5dd-ab1aae899bd5,2032-11-15,2032-11-16,City Council Tax,9399,Utilities,Council Tax,-153.51,GBP,-203087.84,Direct Debit,London,GB,2219,user_002,rec_6feaa5d43f,
7c8926d9-98dc-495d-b83e-5b4d47b93d20,2032-11-15,2032-11-16,Uber UK,4121,Transport,Ride Hailing,-22.61,GBP,-203110.45,E-Com,London,GB,2219,user_001,,
f91d3ef7-aec0-4b01-ae17-c0f280eb6101,2032-11-15,2032-11-16,O2 UK,4814,Bills,Mobile,-35.4,GBP,-203145.85,Direct Debit,Slough,GB,9074,user_001,rec_95042d8101,
1adfae7a-2982-470a-8fb3-6fffac11371e,2032-11-16,2032-11-16,Amazon UK,5942,Shopping,Online Retail,-61.64,GBP,-203207.49,E-Com,London,GB,9074,user_001,,
6d44dc59-8f8a-4c69-9fcd-41c0a9981844,2032-11-16,2032-11-17,Transport for London,4111,Transport,Transit,-5.24,GBP,-203212.73,POS,London,GB,4488,user_002,,
bd1af2b0-2462-472f-85f5-39e6f89ccf8a,2032-11-16,2032-11-17,Deliveroo,5812,Food & Drink,Delivery,-14.68,GBP,-203227.41,E-Com,London,GB,1045,user_001,,
53ed1f4f-4a27-4b10-857a-3577f35be8d1,2032-11-17,2032-11-18,Waitrose,5411,Groceries,Supermarket,-46.53,GBP,-203273.94,POS,London,GB,9074,user_001,,
5a0e5328-5474-487b-b38a-d9f71c774671,2032-11-17,2032-11-17,GymBox,7997,Wellness,Gym,-45.23,GBP,-203319.17,Direct Debit,London,GB,2219,user_001,rec_3906953fd2,
3d1c3f3f-7155-4f35-ab03-9ed34b2a49ef,2032-11-19,2032-11-22,Spotify,5735,Entertainment,Subscriptions,-8.02,GBP,-203327.19,E-Com,Stockholm,SE,4488,user_001,rec_4c746d2c3b,
af5f61cf-9bea-4cf9-b213-5d16398b3f7e,2032-11-19,2032-11-19,HM Revenue & Customs,9311,Income,Tax Refund,1123.12,GBP,-202204.07,Credit,London,GB,4488,user_002,,Refund for Crown Estates Lettings
76e1770d-f74e-4440-b247-264cf69ddfbf,2032-11-20,2032-11-22,Waitrose,5411,Groceries,Supermarket,-55.78,GBP,-202259.85,POS,London,GB,9074,user_002,,
ebb26590-f3f4-4246-8f95-bb381e1bf70f,2032-11-20,2032-11-22,Amazon UK,5942,Shopping,Online Retail,-69.74,GBP,-202329.59,E-Com,London,GB,4488,user_001,,
111ef5a9-3861-43a7-bea6-12e47ae39c11,2032-11-21,2032-11-22,Waitrose,5411,Groceries,Supermarket,-32.74,GBP,-202362.33,POS,London,GB,4488,user_001,,
41ba22ef-3828-4388-a264-02103521c20c,2032-11-21,2032-11-22,Local Market,5499,Groceries,Specialty,-7.93,GBP,-202370.26,POS,London,GB,1045,user_001,,
723a84e2-5ec6-480b-b289-af2ce13ef859,2032-11-21,2032-11-22,Deliveroo,5812,Food & Drink,Delivery,-14.31,GBP,-202384.57,E-Com,London,GB,4488,user_001,,
b85f3648-bcc1-4e49-a954-f65b26f64f20,2032-11-21,2032-11-22,ATM Withdrawal,6011,Cash,ATM,-73.42,GBP,-202457.99,ATM,London,GB,9074,user_001,,
b8cabc2a-ca2e-4bd8-bcde-fe4fcb310f73,2032-11-21,2032-11-22,Waitrose,5411,Groceries,Supermarket,-26.18,GBP,-202484.17,POS,London,GB,1045,user_001,,
da33ba80-6048-4951-9433-757a26984a19,2032-11-21,2032-11-22,Uber UK,4121,Transport,Ride Hailing,-11.83,GBP,-202496.0,E-Com,London,GB,4488,user_001,,
ec38cfbc-ce0b-403d-9dc0-a666d36be325,2032-11-21,2032-11-23,Transport for London,4111,Transport,Transit,-7.41,GBP,-202503.41,POS,London,GB,2219,user_001,,
11eb8cf6-5127-4856-832e-de725c84dfb5,2032-11-22,2032-11-22,Netflix,7841,Entertainment,Subscriptions,-10.62,GBP,-202514.03,E-Com,Los Gatos,US,9074,user_001,rec_1bfe33738d,
de6acd12-5aba-487a-8e35-f0c347837f5b,2032-11-22,2032-11-23,Apple.com/bill,5734,Shopping,Electronics,-103.34,GBP,-202617.37,E-Com,Cupertino,US,1045,user_002,,
32202245-58f9-4708-8145-25e3b6281315,2032-11-23,2032-11-25,Local Market,5499,Groceries,Specialty,-14.46,GBP,-202631.83,POS,London,GB,1045,user_001,,
de618d56-1f3b-4798-a643-7bf46c8bd48c,2032-11-23,2032-11-25,Deliveroo,5812,Food & Drink,Delivery,-16.71,GBP,-202648.54,E-Com,London,GB,4488,user_001,,
2be00466-bca1-44bc-9125-461bd99b2830,2032-11-24,2032-11-26,Local Market,5499,Groceries,Specialty,-9.25,GBP,-202657.79,POS,London,GB,4488,user_001,,
2cfa7a20-62ca-4f31-9d33-ee7b8f1e93a6,2032-11-24,2032-11-25,Shell,5541,Transport,Fuel,-87.85,GBP,-202745.64,POS,London,GB,4488,user_001,,
0a27af74-02e5-4775-8560-79c0114da6e1,2032-11-25,2032-11-25,T212 Capital,6011,Income,Salary,2914.59,GBP,-199831.05,Credit,London,GB,4488,user_001,rec_2ff8f778d0,
260d8104-159b-4e99-9307-145a381cbe5d,2032-11-25,2032-11-26,Waitrose,5411,Groceries,Supermarket,-70.69,GBP,-199901.74,POS,London,GB,4488,user_001,,
36655aff-8f1f-4a14-83e5-bb4b2bb515ef,2032-11-25,2032-11-26,Local Market,5499,Groceries,Specialty,-9.41,GBP,-199911.15,POS,London,GB,2219,user_002,,
a09b403b-fb6d-453b-a8e5-abb2bbbbd9b9,2032-11-25,2032-11-25,Shell,5541,Transport,Fuel,-67.63,GBP,-199978.78,POS,London,GB,1045,user_001,,
d79bafea-9438-4350-8ed6-0dfd58405e3e,2032-11-25,2032-11-29,Local Market,5499,Groceries,Specialty,-15.57,GBP,-199994.35,POS,London,GB,9074,user_001,,
068b6d56-1016-49b3-bda5-62aa23fa62ff,2032-11-26,2032-11-29,Shell,5541,Transport,Fuel,-43.35,GBP,-200037.7,POS,London,GB,9074,user_001,,
f9f0e1dd-bba3-4d8e-b28b-a20885523cf0,2032-11-26,2032-11-29,Apple.com/bill,5734,Shopping,Electronics,-190.65,USD,-200228.35,E-Com,Cupertino,US,2219,user_002,,FX purchase 236.9 USD @ rate 1.24
aa9a9ce5-8b00-45b9-a7ef-4a73ae1e55e1,2032-11-27,2032-11-29,Shell,5541,Transport,Fuel,-63.86,GBP,-200292.21,POS,London,GB,1045,user_001,,
b314418c-fe88-4b6e-8987-56c1cd3fe395,2032-11-27,2032-11-29,Apple.com/bill,5734,Shopping,Electronics,-146.1,USD,-200438.31,E-Com,Cupertino,US,1045,user_001,,FX purchase 180.15 USD @ rate 1.23
e2d83c37-e0f4-4cc5-a6d0-7f97c9a16e8d,2032-11-27,2032-11-29,Sainsbury's,5411,Groceries,Supermarket,-25.71,GBP,-200464.02,POS,London,GB,2219,user_001,,
e48eb5ff-45bd-401f-814a-e3cc741b15ba,2032-11-27,2032-11-29,Uber UK,4121,Transport,Ride Hailing,-11.55,GBP,-200475.57,E-Com,London,GB,1045,user_001,,
2a62b202-74c5-4e99-bc42-2de2dece9c7f,2032-11-28,2032-11-29,Tesco,5411,Groceries,Supermarket,-27.96,GBP,-200503.53,POS,London,GB,2219,user_002,,
5f7df80d-527c-4281-9899-ca8e6fbd2ad0,2032-11-28,2032-11-29,Uber UK,4121,Transport,Ride Hailing,-34.24,GBP,-200537.77,E-Com,London,GB,2219,user_001,,
804e0186-b34e-4208-9d60-298382218ac2,2032-11-28,2032-11-29,Transport for London,4111,Transport,Transit,-6.93,GBP,-200544.7,POS,London,GB,9074,user_002,,
98270ac5-0cbc-4e66-8fcf-0b53d220425d,2032-11-28,2032-11-29,Amazon UK,5942,Shopping,Online Retail,-67.23,GBP,-200611.93,E-Com,London,GB,2219,user_001,,
b3bf765f-7c31-4463-83c2-f336dd5340f2,2032-11-28,2032-11-29,Pret A Manger,5814,Food & Drink,Eating Out,-7.94,GBP,-200619.87,POS,London,GB,2219,user_001,,
5980ee0e-6c8f-409d-a3b1-eb00d3fde734,2032-11-29,2032-12-01,Transport for London,4111,Transport,Transit,-9.2,GBP,-200629.07,POS,London,GB,1045,user_001,,
e2e5fb1e-b9ec-46e7-8413-dbf110089bf8,2032-11-29,2032-11-29,Tesco,5411,Groceries,Supermarket,-71.27,GBP,-200700.34,POS,London,GB,2219,user_001,,
ffb594bb-30a0-4bee-a3df-3e66a2475d80,2032-11-29,2032-12-01,Transport for London,4111,Transport,Transit,-9.6,GBP,-200709.94,POS,London,GB,2219,user_001,,
4aa24a10-23ab-4756-bdf1-2457186b0bf5,2032-11-30,2032-11-30,Tesco,5411,Groceries,Supermarket,-46.4,GBP,-200756.34,POS,London,GB,4488,user_001,,
270e6af8-5cc6-41b2-911b-4a10248ca1e3,2032-12-01,2032-12-02,Crown Estates Lettings,6513,Housing,Rent,-1598.56,GBP,-202354.9,POS,London,GB,9074,user_002,rec_fc2ae06846,
b6a2a1d7-f883-4538-8f43-436f7ee49882,2032-12-02,2032-12-06,Local Market,5499,Groceries,Specialty,-15.13,GBP,-202370.03,POS,London,GB,9074,user_001,,
bbcddc97-4786-40cc-bb97-7f09f99af492,2032-12-02,2032-12-02,Local Market,5499,Groceries,Specialty,-20.88,GBP,-202390.91,POS,London,GB,2219,user_002,,
e7f23f6a-d8ec-439b-a25b-a61786dcb924,2032-12-02,2032-12-02,Deliveroo,5812,Food & Drink,Delivery,-31.88,GBP,-202422.79,E-Com,London,GB,1045,user_001,,
4e3a0f8b-5138-4c01-886f-29e38cc5e11d,2032-12-03,2032-12-03,Amazon UK,5942,Shopping,Online Retail,-62.27,GBP,-202485.06,E-Com,London,GB,4488,user_001,,
c5000203-8f71-48d9-847e-68f9e743aa5d,2032-12-03,2032-12-06,ATM Withdrawal,6011,Cash,ATM,-78.24,GBP,-202563.3,ATM,London,GB,4488,user_002,,
1aefd4a0-ee17-4b88-96db-661fad0ff44b,2032-12-04,2032-12-06,Shell,5541,Transport,Fuel,-91.41,GBP,-202654.71,POS,London,GB,1045,user_001,,
2494d92a-e452-4d0e-9b2e-8d98dcdf268d,2032-12-04,2032-12-06,Uber UK,4121,Transport,Ride Hailing,-9.89,GBP,-202664.6,E-Com,London,GB,4488,user_002,,
71e848cf-a10d-46a5-849b-88a593eb99a3,2032-12-04,2032-12-06,Amazon UK,5942,Shopping,Online Retail,-70.4,GBP,-202735.0,E-Com,London,GB,1045,user_002,,
83c2808d-a89b-4080-b690-f86d2dbcf446,2032-12-05,2032-12-06,Transport for London,4111,Transport,Transit,-9.92,GBP,-202744.92,POS,London,GB,1045,user_001,,
d433dfe7-1db1-4d6c-8e82-527637d88a68,2032-12-06,2032-12-07,Sainsbury's,5411,Groceries,Supermarket,-18.41,GBP,-202763.33,POS,London,GB,9074,user_001,,
63747415-26aa-481a-8a21-b2b1c0bec298,2032-12-07,2032-12-07,Pret A Manger,5814,Food & Drink,Eating Out,-8.62,GBP,-202771.95,POS,London,GB,4488,user_002,,
f055220e-9acd-4c65-9009-4111c7b5c81b,2032-12-07,2032-12-09,Octopus Energy,4900,Utilities,Electricity,-144.33,GBP,-202916.28,Direct Debit,London,GB,2219,user_002,rec_09c3f12b18,
f6072b7b-1c80-4c16-9668-8d7ff66a3634,2032-12-07,2032-12-08,Uber UK,4121,Transport,Ride Hailing,-15.8,GBP,-202932.08,E-Com,London,GB,9074,user_001,,
27c48f8f-43e9-4943-9b59-eabfca52f9e3,2032-12-08,2032-12-08,Shell,5541,Transport,Fuel,-34.28,GBP,-202966.36,POS,London,GB,4488,user_001,,
8d8e7e41-17bd-4aff-b726-c02e7f625773,2032-12-09,2032-12-09,Transport for London,4111,Transport,Transit,-8.37,GBP,-202974.73,POS,London,GB,1045,user_001,,
a1913741-a0c5-4546-ae90-23248968ca9c,2032-12-09,2032-12-13,Waitrose,5411,Groceries,Supermarket,-59.55,GBP,-203034.28,POS,London,GB,9074,user_001,,
07fa0d82-3ecb-4959-9929-86e56716f9ba,2032-12-11,2032-12-13,Shell,5541,Transport,Fuel,-92.49,GBP,-203126.77,POS,London,GB,1045,user_002,,
3d043574-e8e3-4f1a-b8e3-86bb00d87690,2032-12-11,2032-12-13,HM Revenue & Customs,9311,Income,Tax Refund,5.81,GBP,-203120.96,Credit,London,GB,1045,user_002,,Refund for Uber UK
48c2d0a1-796d-4f64-8e87-9af8878e0b5e,2032-12-11,2032-12-13,Uber UK,4121,Transport,Ride Hailing,-22.62,GBP,-203143.58,E-Com,London,GB,1045,user_001,,
c6018198-1ff7-4153-8f23-1a2ebcaa342e,2032-12-11,2032-12-13,Pret A Manger,5814,Food & Drink,Eating Out,-7.84,GBP,-203151.42,POS,London,GB,2219,user_001,,
d5110d4b-6d20-4590-a82c-8c8a3a0d4c89,2032-12-11,2032-12-13,Pret A Manger,5814,Food & Drink,Eating Out,-7.06,GBP,-203158.48,POS,London,GB,1045,user_001,,
89ba8e40-9f65-4af3-a6ab-43ffd0065065,2032-12-12,2032-12-13,Amazon UK,5942,Shopping,Online Retail,-73.81,GBP,-203232.29,E-Com,London,GB,9074,user_001,,
a9427003-e2f8-450c-b3eb-c52e902d4db9,2032-12-12,2032-12-13,Local Market,5499,Groceries,Specialty,-10.55,GBP,-203242.84,POS,London,GB,9074,user_001,,
ec9435a4-f590-433a-a889-b1b6a035cfde,2032-12-12,2032-12-13,Apple.com/bill,5734,Shopping,Electronics,-164.42,GBP,-203407.26,E-Com,Cupertino,US,1045,user_002,,
072b5210-6a24-4cb6-9148-81fdeade3d86,2032-12-13,2032-12-14,Apple.com/bill,5734,Shopping,Electronics,-181.13,GBP,-203588.39,E-Com,Cupertino,US,4488,user_001,,
6d28bb79-0d54-4f38-a9fc-7b6bc12bd3cf,2032-12-13,2032-12-15,Thames Water,4900,Utilities,Water,-40.39,GBP,-203628.78,Direct Debit,Reading,GB,1045,user_001,rec_3a34d62842,
93392ac0-d89f-455e-afe7-cacb4c319642,2032-12-13,2032-12-14,City Council Tax,9399,Utilities,Council Tax,-178.2,GBP,-203806.98,Direct Debit,London,GB,1045,user_001,rec_f531495db5,
af18f14f-ce5e-411b-9432-cabf22e551fe,2032-12-13,2032-12-15,Local Market,5499,Groceries,Specialty,-7.92,GBP,-203814.9,POS,London,GB,4488,user_002,,
4e9af2b5-3b79-4784-80dc-6e805613610b,2032-12-15,2032-12-16,Amazon UK,5942,Shopping,Online Retail,-38.44,GBP,-203853.34,E-Com,London,GB,9074,user_001,,
6650b292-68fd-4c3f-be5a-3333a33862aa,2032-12-15,2032-12-15,O2 UK,4814,Bills,Mobile,-39.15,GBP,-203892.49,Direct Debit,Slough,GB,9074,user_001,rec_95042d8101,
e6e85938-6a73-4c4c-9ff2-fafc258e97b3,2032-12-15,2032-12-16,Local Market,5499,Groceries,Specialty,-11.87,GBP,-203904.36,POS,London,GB,4488,user_001,,
5feae12a-abc8-49df-8fc7-526e499a22f1,2032-12-16,2032-12-20,Local Market,5499,Groceries,Specialty,-16.95,GBP,-203921.31,POS,London,GB,4488,user_001,,
04d4210a-9fad-49b3-828d-49119ac6f704,2032-12-17,2032-12-20,Apple.com/bill,5734,Shopping,Electronics,-161.48,GBP,-204082.79,E-Com,Cupertino,US,2219,user_001,,
84a9da2f-907d-4168-b32f-c6ca6b10fe6f,2032-12-17,2032-12-20,GymBox,7997,Wellness,Gym,-46.05,GBP,-204128.84,Direct Debit,London,GB,9074,user_001,rec_3906953fd2,
f7b93c35-343a-4b98-9111-aac13b4b815f,2032-12-17,2032-12-17,Local Market,5499,Groceries,Specialty,-18.9,GBP,-204147.74,POS,London,GB,2219,user_001,,
0362a2b2-1be3-4c53-aff7-be3d4aed207e,2032-12-18,2032-12-20,Deliveroo,5812,Food & Drink,Delivery,-22.56,GBP,-204170.3,E-Com,London,GB,9074,user_001,,
1324165f-926b-4d97-9e1b-2dd1f1ab4a8c,2032-12-18,2032-12-20,Uber UK,4121,Transport,Ride Hailing,-18.69,GBP,-204188.99,E-Com,London,GB,9074,user_001,,
175ea550-b739-41ad-9e46-9b7b31ec2124,2032-12-18,2032-12-20,Local Market,5499,Groceries,Specialty,-11.42,GBP,-204200.41,POS,London,GB,2219,user_001,,
4da00fa1-2aa9-4079-a80e-21116a80460c,2032-12-18,2032-12-20,Apple.com/bill,5734,Shopping,Electronics,-41.85,USD,-204242.26,E-Com,Cupertino,US,4488,user_001,,FX purchase 49.65 USD @ rate 1.19
645b654c-0024-48e3-8d3c-4b05e373d090,2032-12-18,2032-12-20,Local Market,5499,Groceries,Specialty,-15.1,GBP,-204257.36,POS,London,GB,2219,user_001,,
9d83c7a5-2beb-4778-9908-3c4e509022ee,2032-12-18,2032-12-20,Sainsbury's,5411,Groceries,Supermarket,-68.7,GBP,-204326.06,POS,London,GB,2219,user_001,,
c11726fa-7b6a-455c-8792-4f97bed9198f,2032-12-18,2032-12-20,Sainsbury's,5411,Groceries,Supermarket,-56.12,GBP,-204382.18,POS,London,GB,1045,user_002,,
d01db4db-ac5d-4abf-8813-8a715c563309,2032-12-18,2032-12-20,Waitrose,5411,Groceries,Supermarket,-52.63,GBP,-204434.81,POS,London,GB,9074,user_001,,
d02bed69-9f49-4a93-89ef-b237964d9a46,2032-12-18,2032-12-20,Deliveroo,5812,Food & Drink,Delivery,-17.56,GBP,-204452.37,E-Com,London,GB,2219,user_001,,
d0666fbf-ad98-4095-91b7-b04918964412,2032-12-18,2032-12-20,Waitrose,5411,Groceries,Supermarket,-76.09,GBP,-204528.46,POS,London,GB,4488,user_001,,
fed52bbe-7bbd-48ca-9753-77378ce3708e,2032-12-18,2032-12-20,Tesco,5411,Groceries,Supermarket,-45.89,GBP,-204574.35,POS,London,GB,2219,user_001,,
7c647c37-07f6-4466-984f-9392b135424a,2032-12-19,2032-12-20,Shell,5541,Transport,Fuel,-84.58,GBP,-204658.93,POS,London,GB,9074,user_001,,
9cd10f28-ef51-4c61-aad3-05399004dd60,2032-12-19,2032-12-20,Transport for London,4111,Transport,Transit,-4.09,GBP,-204663.02,POS,London,GB,4488,user_002,,
aad894b5-2216-4e86-823a-66db9113f4af,2032-12-19,2032-12-20,Pret A Manger,5814,Food & Drink,Eating Out,-5.94,GBP,-204668.96,POS,London,GB,1045,user_001,,
db09e076-55a3-4b72-8901-6d7be954cd2e,2032-12-19,2032-12-20,Deliveroo,5812,Food & Drink,Delivery,-15.96,GBP,-204684.92,E-Com,London,GB,1045,user_001,,
4646d157-9d15-460a-8256-b79e6bbd7289,2032-12-20,2032-12-20,Spotify,5735,Entertainment,Subscriptions,-9.8,GBP,-204694.72,E-Com,Stockholm,SE,4488,user_002,rec_34b6e9e33f,
aa5215dc-4ec7-4de1-8c7e-313e8be3135e,2032-12-20,2032-12-21,ATM Withdrawal,6011,Cash,ATM,-60.01,GBP,-204754.73,ATM,London,GB,1045,user_001,,
c4bcac2a-75d5-4596-b53e-25447f341c0c,2032-12-20,2032-12-21,Amazon UK,5942,Shopping,Online Retail,-50.64,GBP,-204805.37,E-Com,London,GB,9074,user_001,,
422d9204-edc2-4983-a025-4365b5cf52ba,2032-12-21,2032-12-22,Waitrose,5411,Groceries,Supermarket,-80.44,GBP,-204885.81,POS,London,GB,1045,user_002,,
6b9d7b61-abf4-4d52-809b-2c501b63f04d,2032-12-21,2032-12-21,Tesco,5411,Groceries,Supermarket,-61.74,GBP,-204947.55,POS,London,GB,4488,user_001,,
825a1643-a3f6-4ffb-95e7-a83dc5f570cf,2032-12-21,2032-12-22,Transport for London,4111,Transport,Transit,-5.19,GBP,-204952.74,POS,London,GB,2219,user_001,,
c660b330-7409-4054-aa77-aa112d446a97,2032-12-21,2032-12-22,Netflix,7841,Entertainment,Subscriptions,-10.68,GBP,-204963.42,E-Com,Los Gatos,US,1045,user_001,rec_1bfe33738d,
e97fa375-153a-4c7f-b932-4b67ab78afac,2032-12-21,2032-12-21,Deliveroo,5812,Food & Drink,Delivery,-12.34,GBP,-204975.76,E-Com,London,GB,4488,user_001,,
f1c9d405-cc6f-4c6e-a04c-80c9d8614f5f,2032-12-21,2032-12-21,Apple.com/bill,5734,Shopping,Electronics,-69.43,USD,-205045.19,E-Com,Cupertino,US,1045,user_001,,FX purchase 89.66 USD @ rate 1.29
75abde6d-62e0-454a-9c8e-10623c1e11a4,2032-12-22,2032-12-23,Tesco,5411,Groceries,Supermarket,-33.88,GBP,-205079.07,POS,London,GB,1045,user_001,,
bec0e0b6-e6f7-4139-92dd-ddff475ec7fa,2032-12-22,2032-12-22,Sainsbury's,5411,Groceries,Supermarket,-32.75,GBP,-205111.82,POS,London,GB,9074,user_001,,
7174c5d9-983b-45a9-9ed2-a0b7466849d6,2032-12-23,2032-12-24,Deliveroo,5812,Food & Drink,Delivery,-19.39,GBP,-205131.21,E-Com,London,GB,4488,user_001,,
e0f61049-eb70-462b-8ade-bbd1533d8edc,2032-12-23,2032-12-23,Deliveroo,5812,Food & Drink,Delivery,-19.75,GBP,-205150.96,E-Com,London,GB,9074,user_001,,
44e46b28-a0c3-4c53-872c-181871e55bcc,2032-12-24,2032-12-27,Pret A Manger,5814,Food & Drink,Eating Out,-6.98,GBP,-205157.94,POS,London,GB,2219,user_001,,
e8b1df26-25b9-471c-bacd-f66a243b4d4f,2032-12-24,2032-12-24,T212 Capital,6011,Income,Salary,2942.05,GBP,-202215.89,Credit,London,GB,4488,user_001,rec_2ff8f778d0,
005581d5-1555-480a-a3bd-39b430b2fefd,2032-12-25,2032-12-27,Deliveroo,5812,Food & Drink,Delivery,-21.83,GBP,-202237.72,E-Com,London,GB,1045,user_001,,
207cde5f-8614-49ba-a9e7-5c3f0fc7bfb7,2032-12-25,2032-12-27,Sainsbury's,5411,Groceries,Supermarket,-48.64,GBP,-202286.36,POS,London,GB,1045,user_001,,
3bd2702e-6025-4de8-a321-8bd6c09c4ace,2032-12-25,2032-12-27,Uber UK,4121,Transport,Ride Hailing,-17.99,GBP,-202304.35,E-Com,London,GB,2219,user_002,,
98e42336-c2d3-4de8-983c-12cee06d0979,2032-12-25,2032-12-27,Waitrose,5411,Groceries,Supermarket,-49.55,GBP,-202353.9,POS,London,GB,1045,user_001,,
238b5066-cea4-458d-9207-aea77179631e,2032-12-26,2032-12-28,Uber UK,4121,Transport,Ride Hailing,-27.81,GBP,-202381.71,E-Com,London,GB,4488,user_001,,
2c9411ce-1527-485b-bfc7-357a8d63c600,2032-12-26,2032-12-27,Deliveroo,5812,Food & Drink,Delivery,-13.41,GBP,-202395.12,E-Com,London,GB,4488,user_002,,
3e608e2b-5f01-4558-8a4d-4cd0d38b57be,2032-12-26,2032-12-28,Transport for London,4111,Transport,Transit,-4.38,GBP,-202399.5,POS,London,GB,2219,user_001,,
7426b669-0c53-4cf3-8380-0cb5c76bcd95,2032-12-26,2032-12-27,Local Market,5499,Groceries,Specialty,-12.87,GBP,-202412.37,POS,London,GB,2219,user_001,,
aea456d0-493a-4ed5-8271-096cc754ada0,2032-12-26,2032-12-27,Sainsbury's,5411,Groceries,Supermarket,-24.26,GBP,-202436.63,POS,London,GB,4488,user_001,,
ea82eb54-e48c-42e7-801c-96e64e4e288d,2032-12-26,2032-12-28,Deliveroo,5812,Food & Drink,Delivery,-14.57,GBP,-202451.2,E-Com,London,GB,2219,user_002,,
f7fe4664-8eef-4c86-80ef-99e7e3963674,2032-12-26,2032-12-27,Uber UK,4121,Transport,Ride Hailing,-14.56,GBP,-202465.76,E-Com,London,GB,1045,user_001,,
2181faec-61dd-4ea0-87ae-80a4f5af9b4d,2032-12-28,2032-12-29,Sainsbury's,5411,Groceries,Supermarket,-57.5,GBP,-202523.26,POS,London,GB,1045,user_001,,
61edd5a5-1bcb-43d0-b436-984b3f9b310a,2032-12-28,2032-12-28,Sainsbury's,5411,Groceries,Supermarket,-36.41,GBP,-202559.67,POS,London,GB,9074,user_001,,
774947b9-ad12-44a8-bdee-35763812ab8e,2032-12-28,2032-12-28,Deliveroo,5812,Food & Drink,Delivery,-18.65,GBP,-202578.32,E-Com,London,GB,4488,user_001,,
c0920a73-0c5e-4a2c-a938-352632011b00,2032-12-29,2032-12-29,Amazon UK,5942,Shopping,Online Retail,-100.71,GBP,-202679.03,E-Com,London,GB,4488,user_001,,
b7c4e462-5bf7-42c7-a516-1148f45feff0,2032-12-30,2032-12-31,Shell,5541,Transport,Fuel,-36.82,GBP,-202715.85,POS,London,GB,2219,user_001,,
8ce481a9-14be-4e80-9fd1-e2575c49182a,2033-01-01,2033-01-03,Airline Refund,4511,Travel,Refund,10.93,GBP,-202704.92,Credit,London,GB,4488,user_001,,Refund for Deliveroo
990da09a-77a7-47d6-810f-d3dcf37c2cab,2033-01-01,2033-01-03,Pret A Manger,5814,Food & Drink,Eating Out,-8.92,GBP,-202713.84,POS,London,GB,9074,user_002,,
b94e2c8f-072c-4a9c-b8d7-d3d3f10d7fc2,2033-01-01,2033-01-03,Amazon UK,5942,Shopping,Online Retail,-55.56,GBP,-202769.4,E-Com,London,GB,1045,user_001,,
115fecc2-0832-4687-a246-c895038f193a,2033-01-02,2033-01-03,Apple.com/bill,5734,Shopping,Electronics,-48.07,GBP,-202817.47,E-Com,Cupertino,US,9074,user_001,,
99b9edf0-9b54-485c-a7a3-37b897d57c5b,2033-01-02,2033-01-04,Amazon UK,5942,Shopping,Online Retail,-86.57,GBP,-202904.04,E-Com,London,GB,1045,user_001,,
e08aed70-84b5-4db7-a089-cdb91b128df9,2033-01-02,2033-01-03,Tesco,5411,Groceries,Supermarket,-29.35,GBP,-202933.39,POS,London,GB,1045,user_001,,
06d40ea2-2f27-4598-a79b-5968cfc4cb61,2033-01-03,2033-01-04,Sainsbury's,5411,Groceries,Supermarket,-66.29,GBP,-202999.68,POS,London,GB,1045,user_001,,
63a43bf7-ad4d-4b03-b1ea-26f2bb000723,2033-01-03,2033-01-04,Crown Estates Lettings,6513,Housing,Rent,-1486.0,GBP,-204485.68,POS,London,GB,9074,user_001,rec_19f70fbcce,
68db5422-04e0-4354-a010-25f5402635a6,2033-01-03,2033-01-05,Transport for London,4111,Transport,Transit,-4.8,GBP,-204490.48,POS,London,GB,1045,user_002,,
c1d023de-e36d-4b13-a0ff-c4de5c8400ba,2033-01-03,2033-01-05,Deliveroo,5812,Food & Drink,Delivery,-19.78,GBP,-204510.26,E-Com,London,GB,1045,user_001,,
e72abdbb-3bf2-452a-ade0-5148458a46e6,2033-01-03,2033-01-04,Sainsbury's,5411,Groceries,Supermarket,-64.77,GBP,-204575.03,POS,London,GB,2219,user_001,,
0b6de357-64f6-44a5-9750-c7b85097d242,2033-01-04,2033-01-04,Tesco,5411,Groceries,Supermarket,-84.35,GBP,-204659.38,POS,London,GB,2219,user_001,,
c325fa65-fb8f-44ca-8f92-05276bc28560,2033-01-04,2033-01-04,Apple.com/bill,5734,Shopping,Electronics,-26.29,GBP,-204685.67,E-Com,Cupertino,US,4488,user_001,,
11fe3199-2a5e-456e-96e5-7981718b42a0,2033-01-05,2033-01-07,Deliveroo,5812,Food & Drink,Delivery,-27.33,GBP,-204713.0,E-Com,London,GB,4488,user_001,,
06e46c51-df46-4461-aa10-45f3a5cdad86,2033-01-06,2033-01-06,Waitrose,5411,Groceries,Supermarket,-60.76,GBP,-204773.76,POS,London,GB,9074,user_001,,
2cc6cbe7-ab88-4df3-9da5-e246438352f0,2033-01-07,2033-01-10,Octopus Energy,4900,Utilities,Electricity,-137.6,GBP,-204911.36,Direct Debit,London,GB,2219,user_001,rec_141a4a0666,
031fde48-62e8-4c6f-9ddc-3614abfd2c19,2033-01-08,2033-01-10,Amazon UK,5942,Shopping,Online Retail,-17.9,GBP,-204929.26,E-Com,London,GB,1045,user_002,,
3a38ffb0-eaf3-4f1e-8971-b1221f901ea0,2033-01-08,2033-01-10,Pret A Manger,5814,Food & Drink,Eating Out,-7.29,GBP,-204936.55,POS,London,GB,2219,user_001,,
573b2d30-f53c-474a-bbc7-c25d7252a134,2033-01-08,2033-01-10,Shell,5541,Transport,Fuel,-61.2,GBP,-204997.75,POS,London,GB,4488,user_001,,
5a0e9a4e-b637-44fb-9841-7d0c500b2ba5,2033-01-08,2033-01-10,Pret A Manger,5814,Food & Drink,Eating Out,-7.46,GBP,-205005.21,POS,London,GB,4488,user_001,,
02b38bc6-bdb7-4804-8b80-e50f5f82b358,2033-01-09,2033-01-10,Waitrose,5411,Groceries,Supermarket,-32.47,GBP,-205037.68,POS,London,GB,9074,user_001,,
5bbb9799-67f0-42e6-8498-cec485a07112,2033-01-09,2033-01-11,Transport for London,4111,Transport,Transit,-11.67,GBP,-205049.35,POS,London,GB,9074,user_002,,
a4dfc002-bf84-45a6-891f-ddfbfda507ec,2033-01-09,2033-01-10,Deliveroo,5812,Food & Drink,Delivery,-13.65,GBP,-205063.0,E-Com,London,GB,9074,user_001,,
4fd0d39b-9689-43bc-87cf-3442b72b9296,2033-01-10,2033-01-10,Waitrose,5411,Groceries,Supermarket,-39.57,GBP,-205102.57,POS,London,GB,2219,user_002,,
1214afbe-9d1a-43b5-abcc-f1ae730e0c7c,2033-01-11,2033-01-13,Deliveroo,5812,Food & Drink,Delivery,-20.65,GBP,-205123.22,E-Com,London,GB,9074,user_001,,
1d4be146-a674-4904-b665-61c1f76f06f7,2033-01-11,2033-01-12,Thames Water,4900,Utilities,Water,-43.24,GBP,-205166.46,Direct Debit,Reading,GB,4488,user_002,rec_954d02400c,
a34469ca-de64-483a-a41b-b89f481bc4e5,2033-01-11,2033-01-12,Apple.com/bill,5734,Shopping,Electronics,-51.31,USD,-205217.77,E-Com,Cupertino,US,2219,user_002,,FX purchase 62.93 USD @ rate 1.23
cd0faa86-a296-46e7-95ec-079ac398b2f0,2033-01-11,2033-01-13,Apple.com/bill,5734,Shopping,Electronics,-179.53,GBP,-205397.3,E-Com,Cupertino,US,2219,user_001,,
44516369-133e-46b0-9a8d-800dda3f2e0f,2033-01-12,2033-01-14,Uber UK,4121,Transport,Ride Hailing,-35.04,GBP,-205432.34,E-Com,London,GB,1045,user_001,,
a4c2b818-ef91-4fda-b4cc-cfcfb8dc0e55,2033-01-12,2033-01-13,Apple.com/bill,5734,Shopping,Electronics,-203.93,GBP,-205636.27,E-Com,Cupertino,US,9074,user_001,,
b869dea3-6295-435e-971b-dbfdfeb24a7c,2033-01-12,2033-01-14,Apple.com/bill,5734,Shopping,Electronics,-130.12,GBP,-205766.39,E-Com,Cupertino,US,1045,user_001,,
1b4e5b07-3167-44b6-b3c3-7f93f01324a3,2033-01-13,2033-01-13,City Council Tax,9399,Utilities,Council Tax,-176.74,GBP,-205943.13,Direct Debit,London,GB,9074,user_001,rec_f531495db5,
40a8c858-76cf-4df8-b6e3-5c025ef9a991,2033-01-13,2033-01-14,Sainsbury's,5411,Groceries,Supermarket,-36.78,GBP,-205979.91,POS,London,GB,4488,user_002,,
7f597700-6a86-4884-af3c-24847a851937,2033-01-13,2033-01-14,Shell,5541,Transport,Fuel,-82.68,GBP,-206062.59,POS,London,GB,9074,user_001,,
9be176fa-0783-4ce4-864a-e076312e8163,2033-01-13,2033-01-13,Amazon UK,5942,Shopping,Online Retail,-62.26,GBP,-206124.85,E-Com,London,GB,9074,user_001,,
65bfd8e9-f99a-49a4-82e6-79406ab75f96,2033-01-14,2033-01-14,Uber UK,4121,Transport,Ride Hailing,-12.12,GBP,-206136.97,E-Com,London,GB,9074,user_001,,
d8194af6-a371-41ea-af9a-77ed9e029d6b,2033-01-14,2033-01-14,Amazon UK,5942,Shopping,Online Retail,-104.32,GBP,-206241.29,E-Com,London,GB,9074,user_002,,
e9e73925-f320-4fa1-ab83-f8bd2c5ea851,2033-01-14,2033-01-17,Amazon UK,5942,Shopping,Online Retail,-13.34,GBP,-206254.63,E-Com,London,GB,1045,user_001,,
050d1bec-19c7-455a-92de-0685a671c774,2033-01-15,2033-01-17,Shell,5541,Transport,Fuel,-94.6,GBP,-206349.23,POS,London,GB,4488,user_001,,
3ce8af62-2b56-4cbd-a6f3-004139529bd7,2033-01-15,2033-01-17,Local Market,5499,Groceries,Specialty,-8.64,GBP,-206357.87,POS,London,GB,9074,user_001,,
61e53d7b-1676-4b5a-bcd4-6f0bd555d2e7,2033-01-15,2033-01-17,Apple.com/bill,5734,Shopping,Electronics,-123.26,USD,-206481.13,E-Com,Cupertino,US,1045,user_001,,FX purchase 152.62 USD @ rate 1.24
99aad04c-1482-48c3-bb59-1153e8352b4e,2033-01-15,2033-01-17,Local Market,5499,Groceries,Specialty,-9.09,GBP,-206490.22,POS,London,GB,4488,user_001,,
e2acde22-313c-4a4c-8432-2f8455560891,2033-01-15,2033-01-17,Transport for London,4111,Transport,Transit,-11.94,GBP,-206502.16,POS,London,GB,2219,user_001,,
e4d05bf4-5894-4e2c-b9f8-0aeeed2cf50d,2033-01-15,2033-01-17,Pret A Manger,5814,Food & Drink,Eating Out,-10.1,GBP,-206512.26,POS,London,GB,2219,user_002,,
2d437b6a-1a1c-47d1-a775-a45d21228e63,2033-01-16,2033-01-17,Shell,5541,Transport,Fuel,-39.61,GBP,-206551.87,POS,London,GB,9074,user_001,,
5494231b-efed-4ab4-a2d9-fe565221633c,2033-01-16,2033-01-17,Waitrose,5411,Groceries,Supermarket,-26.12,GBP,-206577.99,POS,London,GB,4488,user_001,,
5c800061-52b1-4f8d-a0b6-26414fa4072b,2033-01-16,2033-01-18,Amazon UK,5942,Shopping,Online Retail,-81.57,GBP,-206659.56,E-Com,London,GB,9074,user_001,,
a958b072-e751-47fa-9752-fe9173a05158,2033-01-16,2033-01-17,Local Market,5499,Groceries,Specialty,-16.68,GBP,-206676.24,POS,London,GB,1045,user_001,,
db9134a8-41cd-478d-9944-38b63c0d0306,2033-01-16,2033-01-17,Apple.com/bill,5734,Shopping,Electronics,-134.18,GBP,-206810.42,E-Com,Cupertino,US,4488,user_002,,
16615be4-fa65-4f6d-b5f3-a55a178a89fc,2033-01-17,2033-01-19,Apple.com/bill,5734,Shopping,Electronics,-126.16,USD,-206936.58,E-Com,Cupertino,US,2219,user_001,,FX purchase 157.68 USD @ rate 1.25
3e818f6d-7a5c-42f3-82dc-42e8f83c5180,2033-01-17,2033-01-19,O2 UK,4814,Bills,Mobile,-52.7,GBP,-206989.28,Direct Debit,Slough,GB,9074,user_001,rec_95042d8101,
b7330cbb-10f7-4f9d-b540-cfda56cb18f0,2033-01-17,2033-01-19,GymBox,7997,Wellness,Gym,-48.03,GBP,-207037.31,Direct Debit,London,GB,1045,user_001,rec_3906953fd2,
46d79a69-5246-464e-ba8c-5e577bbb811a,2033-01-18,2033-01-20,Waitrose,5411,Groceries,Supermarket,-74.98,GBP,-207112.29,POS,London,GB,9074,user_001,,
39d6da5f-853d-4d17-95d3-5a2f680ae9d6,2033-01-19,2033-01-21,Shell,5541,Transport,Fuel,-92.65,GBP,-207204.94,POS,London,GB,1045,user_001,,
46ae6d6a-1b0e-4631-954a-5515d9e0e340,2033-01-19,2033-01-19,Sainsbury's,5411,Groceries,Supermarket,-66.8,GBP,-207271.74,POS,London,GB,1045,user_001,,
ad3e82ee-5435-4862-bd03-3604f6c6096f,2033-01-19,2033-01-21,Deliveroo,5812,Food & Drink,Delivery,-13.09,GBP,-207284.83,E-Com,London,GB,4488,user_001,,
d22ad5fc-4cbf-40af-9187-52fe169d41a7,2033-01-19,2033-01-20,Spotify,5735,Entertainment,Subscriptions,-9.63,EUR,-207294.46,E-Com,Stockholm,SE,4488,user_001,rec_4c746d2c3b,FX purchase 11.1 EUR @ rate 1.15
d62f5fc6-10d0-464e-a5ae-1053c48f1107,2033-01-19,2033-01-21,Apple.com/bill,5734,Shopping,Electronics,-198.53,USD,-207492.99,E-Com,Cupertino,US,4488,user_001,,FX purchase 240.16 USD @ rate 1.21
eed329db-8271-4c4a-b69b-bc6029bb5ba6,2033-01-20,2033-01-24,Shell,5541,Transport,Fuel,-45.21,GBP,-207538.2,POS,London,GB,9074,user_001,,
1c9b0df6-9288-4126-b489-a4fb3a59e3d3,2033-01-21,2033-01-21,Apple.com/bill,5734,Shopping,Electronics,-141.07,GBP,-207679.27,E-Com,Cupertino,US,4488,user_001,,
ae42b63a-ebc0-4e3d-a95a-67187fe72be7,2033-01-21,2033-01-24,Uber UK,4121,Transport,Ride Hailing,-13.9,GBP,-207693.17,E-Com,London,GB,4488,user_001,,
bc6512e3-8795-495c-be59-f3173da3e0e0,2033-01-21,2033-01-24,Netflix,7841,Entertainment,Subscriptions,-11.73,GBP,-207704.9,E-Com,Los Gatos,US,9074,user_002,rec_d9322c1382,
b03262ea-349e-4b3b-b719-da30926372f7,2033-01-22,2033-01-24,Local Market,5499,Groceries,Specialty,-20.44,GBP,-207725.34,POS,London,GB,9074,user_001,,
b845b260-743c-4fb8-8b5f-a3f08f65696c,2033-01-22,2033-01-24,Sainsbury's,5411,Groceries,Supermarket,-47.33,GBP,-207772.67,POS,London,GB,4488,user_002,,
28591355-c3e1-459e-b89c-5af6b6c77d24,2033-01-23,2033-01-24,Sainsbury's,5411,Groceries,Supermarket,-28.43,GBP,-207801.1,POS,London,GB,2219,user_001,,
ddb2e956-ee96-4947-835e-ee91cd35d485,2033-01-23,2033-01-25,Tesco,5411,Groceries,Supermarket,-62.52,GBP,-207863.62,POS,London,GB,4488,user_001,,
0ca890b1-2948-4e65-8a28-d6a48202714f,2033-01-25,2033-01-27,Local Market,5499,Groceries,Specialty,-14.38,GBP,-207878.0,POS,London,GB,4488,user_002,,
28c908fb-f825-4e3b-90e0-2bf76cd73aa4,2033-01-25,2033-01-25,Airbnb,7011,Travel,Accommodation,-390.84,GBP,-208268.84,E-Com,Dublin,IE,9074,user_001,,Business travel
37394279-75e9-4f8a-96d2-34219536fdc0,2033-01-25,2033-01-26,Transport for London,4111,Transport,Transit,-9.3,GBP,-208278.14,POS,London,GB,1045,user_002,,
b58ed750-67a3-494c-8773-2f6e6b215a9e,2033-01-25,2033-01-25,T212 Capital,6011,Income,Salary,3232.54,GBP,-205045.6,Credit,London,GB,4488,user_001,rec_2ff8f778d0,
a1e058d9-9911-427c-8b2c-626aec72c454,2033-01-26,2033-01-27,Waitrose,5411,Groceries,Supermarket,-84.58,GBP,-205130.18,POS,London,GB,4488,user_001,,
c0d8992a-e968-4afb-ba78-bde3f51210ce,2033-01-26,2033-01-27,Local Market,5499,Groceries,Specialty,-17.76,GBP,-205147.94,POS,London,GB,9074,user_001,,
c26c8ec6-76e0-47a5-a523-0f6581f25c33,2033-01-26,2033-01-27,Deliveroo,5812,Food & Drink,Delivery,-24.63,GBP,-205172.57,E-Com,London,GB,9074,user_001,,
2b280297-ebf0-4704-bce7-c4e5cb59bab4,2033-01-28,2033-01-28,Apple.com/bill,5734,Shopping,Electronics,-51.04,USD,-205223.61,E-Com,Cupertino,US,9074,user_001,,FX purchase 61.47 USD @ rate 1.20
2e49f1b7-5ced-49a2-92b4-5361d39613a8,2033-01-28,2033-01-31,Shell,5541,Transport,Fuel,-86.88,GBP,-205310.49,POS,London,GB,2219,user_001,,
f1728a34-90f9-446a-bc57-3ee6317f79da,2033-01-28,2033-01-31,Waitrose,5411,Groceries,Supermarket,-34.41,GBP,-205344.9,POS,London,GB,9074,user_002,,
a75ac8b9-c480-44eb-8539-3bf196abaa3a,2033-01-29,2033-01-31,Tesco,5411,Groceries,Supermarket,-36.44,GBP,-205381.34,POS,London,GB,9074,user_001,,
2f11d409-3314-49f5-a8a1-67ba363aa84b,2033-01-30,2033-02-01,Transport for London,4111,Transport,Transit,-4.35,GBP,-205385.69,POS,London,GB,4488,user_001,,
b972a3e7-666a-48dd-bca9-b52aab44fc6d,2033-01-30,2033-01-31,Waitrose,5411,Groceries,Supermarket,-67.6,GBP,-205453.29,POS,London,GB,1045,user_001,,
00bd411e-d5d7-455d-bd11-0d47a0a5de7f,2033-01-31,2033-02-01,Transport for London,4111,Transport,Transit,-9.53,GBP,-205462.82,POS,London,GB,1045,user_001,,
96387126-9d62-4e36-8331-0a42ae45ef94,2033-01-31,2033-02-01,Amazon UK,5942,Shopping,Online Retail,-73.26,GBP,-205536.08,E-Com,London,GB,1045,user_001,,
1a8af570-fad5-43db-8c1f-b9b63d608aac,2033-02-01,2033-02-03,Crown Estates Lettings,6513,Housing,Rent,-1503.83,GBP,-207039.91,POS,London,GB,2219,user_002,rec_fc2ae06846,
e99251ef-5199-4c35-b145-719cdceea97c,2033-02-01,2033-02-01,Sainsbury's,5411,Groceries,Supermarket,-16.23,GBP,-207056.14,POS,London,GB,4488,user_001,,
6fb4b76d-d920-4958-b577-3a5dedf7bce1,2033-02-02,2033-02-02,Tesco,5411,Groceries,Supermarket,-29.19,GBP,-207085.33,POS,London,GB,1045,user_001,,
18d25634-86ea-4934-b5b3-b4e13e388b25,2033-02-03,2033-02-04,Local Market,5499,Groceries,Specialty,-15.46,GBP,-207100.79,POS,London,GB,1045,user_001,,
ceca2a09-f2fd-49fd-b0d7-49c5abc93146,2033-02-03,2033-02-07,Amazon UK,5942,Shopping,Online Retail,-20.52,GBP,-207121.31,E-Com,London,GB,1045,user_001,,
5a2ae78e-d847-489a-bb19-daa492641ba6,2033-02-05,2033-02-07,Tesco,5411,Groceries,Supermarket,-25.9,GBP,-207147.21,POS,London,GB,1045,user_001,,
2dbe10dc-6a12-4290-b389-ec17e8835b87,2033-02-06,2033-02-07,Amazon UK,5942,Shopping,Online Retail,-9.73,GBP,-207156.94,E-Com,London,GB,4488,user_001,,
30713942-5e01-4ea9-bc0c-750062762e34,2033-02-06,2033-02-08,Pret A Manger,5814,Food & Drink,Eating Out,-9.69,GBP,-207166.63,POS,London,GB,2219,user_001,,
b304de33-bb3d-4f5a-b4fc-b8088a244795,2033-02-06,2033-02-08,Deliveroo,5812,Food & Drink,Delivery,-29.71,GBP,-207196.34,E-Com,London,GB,9074,user_001,,
e6108cf2-9679-4191-8924-7106e59600df,2033-02-07,2033-02-09,Octopus Energy,4900,Utilities,Electricity,-134.41,GBP,-207330.75,Direct Debit,London,GB,9074,user_002,rec_09c3f12b18,
1c849064-4c02-44aa-a0db-b35e99c2a770,2033-02-08,2033-02-08,HM Revenue & Customs,9311,Income,Tax Refund,26.93,GBP,-207303.82,Credit,London,GB,1045,user_001,,Refund for Tesco
47374d50-45db-406c-bb63-642622225966,2033-02-08,2033-02-10,Apple.com/bill,5734,Shopping,Electronics,-208.08,GBP,-207511.9,E-Com,Cupertino,US,4488,user_001,,
64a3a87a-6476-42f9-91fc-0caa64575c97,2033-02-08,2033-02-10,Shell,5541,Transport,Fuel,-83.35,GBP,-207595.25,POS,London,GB,4488,user_001,,
1688a0af-5b96-4cf6-8074-1a0768850b6d,2033-02-09,2033-02-09,Sainsbury's,5411,Groceries,Supermarket,-36.87,GBP,-207632.12,POS,London,GB,2219,user_001,,
3ae3cfee-e29a-45e4-aaf2-3e4436101abf,2033-02-11,2033-02-11,Thames Water,4900,Utilities,Water,-35.83,GBP,-207667.95,Direct Debit,Reading,GB,1045,user_001,rec_3a34d62842,
77c60cf4-8d4b-498f-868a-62f91f9d22cb,2033-02-11,2033-02-14,Waitrose,5411,Groceries,Supermarket,-83.27,GBP,-207751.22,POS,London,GB,2219,user_001,,
ab7ae4a9-3964-4340-8db2-65ce4b83c483,2033-02-11,2033-02-14,Amazon UK,5942,Shopping,Online Retail,-85.91,GBP,-207837.13,E-Com,London,GB,1045,user_001,,
c5a8bf0d-9c64-4233-873b-174f3a19e75a,2033-02-11,2033-02-14,Transport for London,4111,Transport,Transit,-9.7,GBP,-207846.83,POS,London,GB,4488,user_001,,
c7ed0baa-5146-4f35-8a61-c5f24215ad86,2033-02-11,2033-02-14,Apple.com/bill,5734,Shopping,Electronics,-163.32,USD,-208010.15,E-Com,Cupertino,US,2219,user_001,,FX purchase 203.87 USD @ rate 1.25
cde9be1a-e3a9-46b5-888d-d63dc5ed7f0c,2033-02-11,2033-02-14,Waitrose,5411,Groceries,Supermarket,-42.27,GBP,-208052.42,POS,London,GB,4488,user_001,,
31c02e4f-7e55-49e8-815e-8ee86735224f,2033-02-12,2033-02-14,Shell,5541,Transport,Fuel,-58.34,GBP,-208110.76,POS,London,GB,4488,user_001,,
b6fc9b3d-f899-4017-8956-b33285b3f923,2033-02-12,2033-02-14,Transport for London,4111,Transport,Transit,-5.9,GBP,-208116.66,POS,London,GB,9074,user_001,,
0a13c001-af75-4069-bfb2-2cba7df3a177,2033-02-13,2033-02-14,Pret A Manger,5814,Food & Drink,Eating Out,-7.99,GBP,-208124.65,POS,London,GB,1045,user_002,,
717e00b5-9214-4a1f-b2a3-09b2d52d930e,2033-02-13,2033-02-15,Waitrose,5411,Groceries,Supermarket,-73.43,GBP,-208198.08,POS,London,GB,1045,user_001,,
333b28f0-1629-44a1-becd-4a65da0a336e,2033-02-14,2033-02-15,City Council Tax,9399,Utilities,Council Tax,-184.25,GBP,-208382.33,Direct Debit,London,GB,2219,user_001,rec_f531495db5,
42b0f526-9d85-46d1-ae50-85a148d3fd32,2033-02-14,2033-02-14,ATM Withdrawal,6011,Cash,ATM,-97.31,GBP,-208479.64,ATM,London,GB,9074,user_002,,
6fa9dbc9-92b9-46ca-9285-434242218174,2033-02-14,2033-02-16,Amazon UK,5942,Shopping,Online Retail,-62.33,GBP,-208541.97,E-Com,London,GB,4488,user_001,,
f878bdfb-82cc-40ae-a590-4d9cedd18f38,2033-02-14,2033-02-16,Airbnb,7011,Travel,Accommodation,-252.08,USD,-208794.05,E-Com,Dublin,IE,9074,user_001,,Holiday booking
08e397e5-c536-4fc4-8b0b-b88f5a8813b0,2033-02-15,2033-02-15,Transport for London,4111,Transport,Transit,-11.24,GBP,-208805.29,POS,London,GB,1045,user_001,,
3bbea42c-20c2-43fd-9e26-de4198c78444,2033-02-15,2033-02-17,Amazon UK,5942,Shopping,Online Retail,-113.44,GBP,-208918.73,E-Com,London,GB,9074,user_001,,
4abac570-a37f-43ac-9685-a79f9546eb82,2033-02-15,2033-02-15,Deliveroo,5812,Food & Drink,Delivery,-32.25,GBP,-208950.98,E-Com,London,GB,2219,user_001,,
bc3dbe28-cfd8-46a2-8d28-998beef04e98,2033-02-15,2033-02-16,O2 UK,4814,Bills,Mobile,-43.79,GBP,-208994.77,Direct Debit,Slough,GB,1045,user_001,rec_95042d8101,
04f53f0e-0ce2-45ff-ba3c-d4d79747c79d,2033-02-16,2033-02-18,Transport for London,4111,Transport,Transit,-4.63,GBP,-208999.4,POS,London,GB,4488,user_001,,
2049b19e-1c7f-4d27-9577-5ca4363e755c,2033-02-16,2033-02-18,Sainsbury's,5411,Groceries,Supermarket,-37.12,GBP,-209036.52,POS,London,GB,4488,user_001,,
31353c27-d8dc-4a53-bb20-2d7639081a94,2033-02-16,2033-02-18,Amazon UK,5942,Shopping,Online Retail,-47.63,GBP,-209084.15,E-Com,London,GB,2219,user_001,,
4ec5870e-0dca-4d93-9b3f-b21ada3a543a,2033-02-16,2033-02-17,Uber UK,4121,Transport,Ride Hailing,-23.68,GBP,-209107.83,E-Com,London,GB,9074,user_001,,
6e09f978-3316-4a5d-935a-322d522938d3,2033-02-16,2033-02-16,Sainsbury's,5411,Groceries,Supermarket,-24.88,GBP,-209132.71,POS,London,GB,4488,user_002,,
ce88caa8-c97b-4f9e-9d6b-3d1365ce096f,2033-02-16,2033-02-17,Apple.com/bill,5734,Shopping,Electronics,-152.65,USD,-209285.36,E-Com,Cupertino,US,9074,user_001,,FX purchase 187.08 USD @ rate 1.23
259fa550-6df6-4d53-b73e-6bb074f12af2,2033-02-17,2033-02-21,Uber UK,4121,Transport,Ride Hailing,-11.65,GBP,-209297.01,E-Com,London,GB,2219,user_001,,
480f1e43-7c21-41ed-a8f3-a0344d9adcf6,2033-02-17,2033-02-18,Shell,5541,Transport,Fuel,-63.32,GBP,-209360.33,POS,London,GB,2219,user_001,,
6d8595d4-098e-40d8-92c8-b60345fa1e6e,2033-02-17,2033-02-17,GymBox,7997,Wellness,Gym,-53.36,GBP,-209413.69,Direct Debit,London,GB,2219,user_001,rec_3906953fd2,
2a534b50-f480-4697-8259-188e36d95dfd,2033-02-18,2033-02-21,Deliveroo,5812,Food & Drink,Delivery,-28.58,GBP,-209442.27,E-Com,London,GB,2219,user_001,,
bdb2e80d-6b03-4ae3-ad61-c975add2181f,2033-02-18,2033-02-21,Local Market,5499,Groceries,Specialty,-19.95,GBP,-209462.22,POS,London,GB,4488,user_001,,
3e7afb29-1362-4dec-a689-72b355214c5c,2033-02-19,2033-02-21,Transport for London,4111,Transport,Transit,-5.44,GBP,-209467.66,POS,London,GB,4488,user_001,,
994f9a1c-9350-45b2-9772-9e2ca7dcfc7d,2033-02-19,2033-02-21,Uber UK,4121,Transport,Ride Hailing,-17.55,GBP,-209485.21,E-Com,London,GB,9074,user_001,,
b5f23ae3-776e-49e5-8d2a-1bb0b0275105,2033-02-19,2033-02-21,Local Market,5499,Groceries,Specialty,-20.57,GBP,-209505.78,POS,London,GB,1045,user_001,,
2ab64686-abef-4072-b0e9-58a26cb0a088,2033-02-20,2033-02-21,Tesco,5411,Groceries,Supermarket,-50.69,GBP,-209556.47,POS,London,GB,9074,user_001,,
7a537e4d-ed5a-4157-8e71-1c4b9d43911c,2033-02-20,2033-02-21,Uber UK,4121,Transport,Ride Hailing,-22.05,GBP,-209578.52,E-Com,London,GB,9074,user_001,,
7ccb1e0e-c8fb-43d9-99f5-86c2588542a5,2033-02-20,2033-02-21,Sainsbury's,5411,Groceries,Supermarket,-46.72,GBP,-209625.24,POS,London,GB,2219,user_001,,
c0a2e5d6-e857-4739-a64c-0d7a295a4a74,2033-02-20,2033-02-21,Shell,5541,Transport,Fuel,-44.97,GBP,-209670.21,POS,London,GB,4488,user_001,,
9803bdd5-cbfd-4c06-981c-e65f2a1a2cbe,2033-02-21,2033-02-23,Waitrose,5411,Groceries,Supermarket,-27.26,GBP,-209697.47,POS,London,GB,9074,user_002,,
c354809c-a6e6-4420-b081-60707821e854,2033-02-21,2033-02-23,Spotify,5735,Entertainment,Subscriptions,-8.17,GBP,-209705.64,E-Com,Stockholm,SE,1045,user_002,rec_34b6e9e33f,
d642cc1b-1ea0-4a23-8725-8a66518a9537,2033-02-21,2033-02-21,Netflix,7841,Entertainment,Subscriptions,-12.27,GBP,-209717.91,E-Com,Los Gatos,US,1045,user_001,rec_1bfe33738d,
64e1a67d-2477-4aef-a9b9-65fce3b753fe,2033-02-22,2033-02-24,Apple.com/bill,5734,Shopping,Electronics,-78.66,GBP,-209796.57,E-Com,Cupertino,US,2219,user_001,,
67ca6eb7-b0a8-478b-a7ea-eaae5bf3e608,2033-02-22,2033-02-22,Local Market,5499,Groceries,Specialty,-7.77,GBP,-209804.34,POS,London,GB,9074,user_001,,
cb071332-88ef-412c-9525-71c4c13cf954,2033-02-22,2033-02-24,Apple.com/bill,5734,Shopping,Electronics,-63.01,GBP,-209867.35,E-Com,Cupertino,US,2219,user_001,,
507ab258-a554-4f6b-8e7c-d55a2a6d72b7,2033-02-23,2033-02-25,Deliveroo,5812,Food & Drink,Delivery,-28.87,GBP,-209896.22,E-Com,London,GB,1045,user_001,,
9bd1633a-1789-4b65-b84f-f5b5df89253b,2033-02-24,2033-02-25,Local Market,5499,Groceries,Specialty,-9.01,GBP,-209905.23,POS,London,GB,2219,user_001,,
234e1560-5f94-48fd-aebc-98ee68bd1b6f,2033-02-25,2033-02-25,Amazon UK,5942,Shopping,Online Retail,-32.37,GBP,-209937.6,E-Com,London,GB,1045,user_001,,
5565d43f-d61f-4f67-b4d9-0bede2055d54,2033-02-25,2033-02-28,Waitrose,5411,Groceries,Supermarket,-31.72,GBP,-209969.32,POS,London,GB,1045,user_002,,
56ce97d5-84b8-457b-bb41-28b6e400892d,2033-02-25,2033-02-28,Local Market,5499,Groceries,Specialty,-20.85,GBP,-209990.17,POS,London,GB,9074,user_001,,
af2f4160-ac79-460a-b73d-d78b5f64d7eb,2033-02-25,2033-02-25,T212 Capital,6011,Income,Salary,2892.64,GBP,-207097.53,Credit,London,GB,4488,user_001,rec_2ff8f778d0,
68bf6e04-66ae-47d0-8ce9-1cf5b018f716,2033-02-26,2033-02-28,Pret A Manger,5814,Food & Drink,Eating Out,-10.36,GBP,-207107.89,POS,London,GB,1045,user_001,,
875837f1-9dd5-4201-81f6-d68e10f7925d,2033-02-26,2033-02-28,Amazon UK,5942,Shopping,Online Retail,-52.6,GBP,-207160.49,E-Com,London,GB,4488,user_001,,
0b4298c7-1e8d-4bba-a478-44a82a8549a6,2033-02-27,2033-03-01,Uber UK,4121,Transport,Ride Hailing,-28.43,GBP,-207188.92,E-Com,London,GB,4488,user_002,,
45414c0c-4e31-4974-9ead-3dd743b83f06,2033-02-27,2033-03-01,Deliveroo,5812,Food & Drink,Delivery,-12.96,GBP,-207201.88,E-Com,London,GB,2219,user_002,,
7a78e430-cdd2-4d1a-8692-0d8e345b4c52,2033-02-27,2033-02-28,Tesco,5411,Groceries,Supermarket,-72.44,GBP,-207274.32,POS,London,GB,2219,user_001,,
72380788-a992-41cb-bbcf-ea7fc1827a9d,2033-02-28,2033-02-28,Sainsbury's,5411,Groceries,Supermarket,-50.56,GBP,-207324.88,POS,London,GB,1045,user_001,,
08b6e1e4-65c3-495d-9929-72136388d1db,2033-03-01,2033-03-02,Crown Estates Lettings,6513,Housing,Rent,-1504.15,GBP,-208829.03,POS,London,GB,1045,user_001,rec_19f70fbcce,
64e74788-6c86-44d8-82a4-dd09ddc8b689,2033-03-01,2033-03-03,Shell,5541,Transport,Fuel,-48.46,GBP,-208877.49,POS,London,GB,9074,user_001,,
813b702b-b652-48a5-a629-899862a3a307,2033-03-01,2033-03-02,Tesco,5411,Groceries,Supermarket,-41.09,GBP,-208918.58,POS,London,GB,4488,user_001,,
afcba098-4d9b-4c33-8f08-fba7a0685f55,2033-03-01,2033-03-02,Uber UK,4121,Transport,Ride Hailing,-29.51,GBP,-208948.09,E-Com,London,GB,4488,user_002,,
bee3754b-9860-45cd-b71a-ad85296d960b,2033-03-02,2033-03-02,Local Market,5499,Groceries,Specialty,-7.23,GBP,-208955.32,POS,London,GB,2219,user_001,,
bf9a18fa-6ee2-4249-b289-86897a1feedc,2033-03-02,2033-03-02,Local Market,5499,Groceries,Specialty,-6.35,GBP,-208961.67,POS,London,GB,4488,user_002,,
0d54e5c7-b84a-47d1-aa6b-964b3c0a49ce,2033-03-03,2033-03-04,Shell,5541,Transport,Fuel,-88.08,GBP,-209049.75,POS,London,GB,9074,user_001,,
5565e117-edfa-446c-ba17-04256c452fe8,2033-03-03,2033-03-07,Pret A Manger,5814,Food & Drink,Eating Out,-5.81,GBP,-209055.56,POS,London,GB,1045,user_001,,
ac2052e1-fe9d-4fe7-bfa1-43ce7c1dc007,2033-03-04,2033-03-07,Waitrose,5411,Groceries,Supermarket,-86.32,GBP,-209141.88,POS,London,GB,2219,user_001,,
fb7522e0-9902-4066-98bb-5731b3abf66d,2033-03-04,2033-03-07,Transport for London,4111,Transport,Transit,-11.16,GBP,-209153.04,POS,London,GB,9074,user_002,,
17bac4e5-6db1-4965-b08f-a2296d5bc1db,2033-03-05,2033-03-07,Deliveroo,5812,Food & Drink,Delivery,-29.83,GBP,-209182.87,E-Com,London,GB,9074,user_001,,
ea86c1f1-4260-4b0b-84b8-c6dcc72f2e4f,2033-03-05,2033-03-07,Apple.com/bill,5734,Shopping,Electronics,-44.97,GBP,-209227.84,E-Com,Cupertino,US,1045,user_001,,
f080e51b-aaaf-4aa0-b7fe-4534f6274a1f,2033-03-05,2033-03-07,Apple.com/bill,5734,Shopping,Electronics,-131.76,GBP,-209359.6,E-Com,Cupertino,US,2219,user_001,,
521d7be3-07ce-4e87-acb0-5a4d37bf5051,2033-03-06,2033-03-07,Tesco,5411,Groceries,Supermarket,-29.41,GBP,-209389.01,POS,London,GB,1045,user_001,,
9ce4339e-6ffe-4c74-9112-b159b71fe319,2033-03-06,2033-03-07,Shell,5541,Transport,Fuel,-68.35,GBP,-209457.36,POS,London,GB,1045,user_001,,
c86a66f0-aafd-43fb-a7ce-6c08e45128e2,2033-03-06,2033-03-08,Transport for London,4111,Transport,Transit,-7.33,GBP,-209464.69,POS,London,GB,1045,user_001,,
de7b14be-f1d0-4020-92a0-4f253513c69a,2033-03-06,2033-03-08,Pret A Manger,5814,Food & Drink,Eating Out,-10.09,GBP,-209474.78,POS,London,GB,4488,user_001,,
097017d1-1783-4e6d-a355-e414d2cc0f36,2033-03-07,2033-03-09,Pret A Manger,5814,Food & Drink,Eating Out,-8.25,GBP,-209483.03,POS,London,GB,2219,user_001,,
39b61d3a-c8c5-49a1-ac92-06d4af372efe,2033-03-07,2033-03-08,Pret A Manger,5814,Food & Drink,Eating Out,-10.42,GBP,-209493.45,POS,London,GB,2219,user_001,,
654155fd-48a1-42a5-bebe-78dddb8637d5,2033-03-07,2033-03-09,Transport for London,4111,Transport,Transit,-10.19,GBP,-209503.64,POS,London,GB,9074,user_001,,
cbbdf9ab-4750-4133-a049-722e6008c88d,2033-03-07,2033-03-08,Octopus Energy,4900,Utilities,Electricity,-121.59,GBP,-209625.23,Direct Debit,London,GB,4488,user_001,rec_141a4a0666,
fc564e1c-7f08-4ea6-9e53-5ec6f9bf93d9,2033-03-07,2033-03-08,Uber UK,4121,Transport,Ride Hailing,-15.59,GBP,-209640.82,E-Com,London,GB,4488,user_001,,
d3da6111-5284-44c2-9c2b-4511569eb8cb,2033-03-08,2033-03-08,Deliveroo,5812,Food & Drink,Delivery,-20.84,GBP,-209661.66,E-Com,London,GB,9074,user_001,,
2d41de1e-4fcf-47da-a708-acbedc0332fa,2033-03-09,2033-03-11,Pret A Manger,5814,Food & Drink,Eating Out,-6.29,GBP,-209667.95,POS,London,GB,1045,user_001,,
de1dbd49-ae33-4e45-92da-971af1062791,2033-03-09,2033-03-10,Tesco,5411,Groceries,Supermarket,-47.37,GBP,-209715.32,POS,London,GB,4488,user_001,,
f8742561-b36e-4445-8dcf-70ae4ffd6da7,2033-03-09,2033-03-10,Deliveroo,5812,Food & Drink,Delivery,-30.02,GBP,-209745.34,E-Com,London,GB,2219,user_001,,
168a9477-5bc8-4fcd-a11d-f41928a38f9d,2033-03-10,2033-03-14,Pret A Manger,5814,Food & Drink,Eating Out,-7.1,GBP,-209752.44,POS,London,GB,1045,user_001,,
4ebde735-9b8e-4693-9032-1128671490c8,2033-03-11,2033-03-14,Thames Water,4900,Utilities,Water,-32.81,GBP,-209785.25,Direct Debit,Reading,GB,9074,user_001,rec_3a34d62842,
52a10aa9-1c39-46ea-b25b-8edecfc30607,2033-03-11,2033-03-14,Waitrose,5411,Groceries,Supermarket,-79.75,GBP,-209865.0,POS,London,GB,9074,user_002,,
93486fed-c728-42fc-83be-4d38375d5dff,2033-03-11,2033-03-11,Apple.com/bill,5734,Shopping,Electronics,-138.27,GBP,-210003.27,E-Com,Cupertino,US,4488,user_001,,
ad555b41-647e-455b-8574-812e4fc085bf,2033-03-12,2033-03-14,Shell,5541,Transport,Fuel,-73.21,GBP,-210076.48,POS,London,GB,9074,user_001,,
5b728187-5b5e-463a-ba71-7c8b71541e3f,2033-03-13,2033-03-15,Amazon UK,5942,Shopping,Online Retail,-29.94,GBP,-210106.42,E-Com,London,GB,2219,user_001,,
9f22fbf0-bc3c-4b6c-a4f6-9ed02611bfd0,2033-03-13,2033-03-15,Deliveroo,5812,Food & Drink,Delivery,-16.9,GBP,-210123.32,E-Com,London,GB,1045,user_001,,
ecf5d146-3553-48ca-adbe-8c5483fefc04,2033-03-14,2033-03-15,City Council Tax,9399,Utilities,Council Tax,-159.75,GBP,-210283.07,Direct Debit,London,GB,4488,user_001,rec_f531495db5,
06415724-de9b-46bd-a49e-56965062a662,2033-03-15,2033-03-15,O2 UK,4814,Bills,Mobile,-51.73,GBP,-210334.8,Direct Debit,Slough,GB,9074,user_001,rec_95042d8101,
0fd599e4-2faf-491a-995f-930b3af3a449,2033-03-16,2033-03-16,Uber UK,4121,Transport,Ride Hailing,-13.25,GBP,-210348.05,E-Com,London,GB,1045,user_001,,
44dd45ea-8984-4edf-8183-de7b905aeb4b,2033-03-16,2033-03-17,Tesco,5411,Groceries,Supermarket,-81.21,GBP,-210429.26,POS,London,GB,2219,user_001,,
0438b180-81e0-4507-aadd-b7d987e5fa67,2033-03-17,2033-03-18,Apple.com/bill,5734,Shopping,Electronics,-133.49,GBP,-210562.75,E-Com,Cupertino,US,4488,user_001,,
0e563f96-d608-4b3d-808d-f34882d21b3e,2033-03-17,2033-03-21,GymBox,7997,Wellness,Gym,-55.75,GBP,-210618.5,Direct Debit,London,GB,1045,user_001,rec_3906953fd2,
23642f47-f18b-4c20-9ce0-7528d5f1423e,2033-03-17,2033-03-18,ATM Withdrawal,6011,Cash,ATM,-72.46,GBP,-210690.96,ATM,London,GB,9074,user_001,,
e8bd04e7-c5d6-4a00-aaac-045fe199215f,2033-03-17,2033-03-17,Sainsbury's,5411,Groceries,Supermarket,-48.91,GBP,-210739.87,POS,London,GB,9074,user_001,,
232b670b-fcb7-4b1f-8aa0-2382376f1b83,2033-03-19,2033-03-21,Amazon UK,5942,Shopping,Online Retail,-99.12,GBP,-210838.99,E-Com,London,GB,2219,user_001,,
71c0b945-a673-4c6c-8bc1-7f68df3377b0,2033-03-19,2033-03-21,Amazon UK,5942,Shopping,Online Retail,-78.6,GBP,-210917.59,E-Com,London,GB,1045,user_001,,
de791148-9735-43d1-9e25-7239a0020e7a,2033-03-19,2033-03-21,Sainsbury's,5411,Groceries,Supermarket,-31.99,GBP,-210949.58,POS,London,GB,2219,user_001,,
0946418f-4968-4130-871c-5b0c0698840c,2033-03-20,2033-03-21,Local Market,5499,Groceries,Specialty,-18.3,GBP,-210967.88,POS,London,GB,2219,user_002,,
3d643ec4-9ef4-4d73-8640-b54f50f6e459,2033-03-20,2033-03-21,Deliveroo,5812,Food & Drink,Delivery,-24.02,GBP,-210991.9,E-Com,London,GB,4488,user_001,,
8ba51082-380f-47df-bad6-832a8da4b655,2033-03-20,2033-03-22,Apple.com/bill,5734,Shopping,Electronics,-133.94,GBP,-211125.84,E-Com,Cupertino,US,9074,user_001,,
fe562525-6740-4aa6-968c-10d6b83af7a9,2033-03-20,2033-03-22,Deliveroo,5812,Food & Drink,Delivery,-31.29,GBP,-211157.13,E-Com,London,GB,2219,user_001,,
88fa85ef-5267-4a84-82fb-cffd40447101,2033-03-21,2033-03-22,Spotify,5735,Entertainment,Subscriptions,-9.4,EUR,-211166.53,E-Com,Stockholm,SE,4488,user_001,rec_4c746d2c3b,FX purchase 10.92 EUR @ rate 1.16
e80c6e58-1524-4c53-b9a9-13dfa419668c,2033-03-21,2033-03-22,Netflix,7841,Entertainment,Subscriptions,-14.04,GBP,-211180.57,E-Com,Los Gatos,US,2219,user_001,rec_1bfe33738d,
3dcc961f-2907-41b9-9dc2-95a90b04e29f,2033-03-22,2033-03-22,Shell,5541,Transport,Fuel,-45.5,GBP,-211226.07,POS,London,GB,9074,user_001,,
13dfe729-5476-47b3-9950-acceca3ac714,2033-03-23,2033-03-23,Apple.com/bill,5734,Shopping,Electronics,-188.98,GBP,-211415.05,E-Com,Cupertino,US,2219,user_001,,
a91c48fc-20a9-46b4-a82c-728d59838755,2033-03-24,2033-03-24,Sainsbury's,5411,Groceries,Supermarket,-51.04,GBP,-211466.09,POS,London,GB,2219,user_001,,
d48f33a0-b89c-4f48-97cb-d8775e92360f,2033-03-24,2033-03-25,Uber UK,4121,Transport,Ride Hailing,-10.26,GBP,-211476.35,E-Com,London,GB,4488,user_002,,
e51975d0-062c-429d-b79c-b7a1e6d5e744,2033-03-24,2033-03-28,Amazon UK,5942,Shopping,Online Retail,-54.4,GBP,-211530.75,E-Com,London,GB,2219,user_001,,
ea538f08-5c97-41a9-8b3d-0e2249ada06b,2033-03-24,2033-03-25,Sainsbury's,5411,Groceries,Supermarket,-42.71,GBP,-211573.46,POS,London,GB,2219,user_001,,
3b384627-0fdd-4900-be80-e063ef767845,2033-03-25,2033-03-25,Local Market,5499,Groceries,Specialty,-21.48,GBP,-211594.94,POS,London,GB,9074,user_002,,
93c2db6e-78ed-4afb-8afa-2c54c57fca42,2033-03-25,2033-03-25,T212 Capital,6011,Income,Salary,3139.17,GBP,-208455.77,Credit,London,GB,4488,user_001,rec_2ff8f778d0,
58c6971a-4451-4c0f-93b6-30290704a755,2033-03-26,2033-03-28,Uber UK,4121,Transport,Ride Hailing,-29.0,GBP,-208484.77,E-Com,London,GB,4488,user_001,,
8ab8c020-6fcb-46f4-ba0d-d4e1240d15bf,2033-03-26,2033-03-28,Sainsbury's,5411,Groceries,Supermarket,-19.87,GBP,-208504.64,POS,London,GB,4488,user_001,,
b2e79eb5-b089-47ba-b70a-8dcd747da936,2033-03-26,2033-03-28,Waitrose,5411,Groceries,Supermarket,-74.76,GBP,-208579.4,POS,London,GB,1045,user_001,,
80495e98-01f8-4cd7-8aab-2acbb31c1278,2033-03-27,2033-03-28,Shell,5541,Transport,Fuel,-91.5,GBP,-208670.9,POS,London,GB,9074,user_001,,
8bb951b3-9d7d-4e70-937a-1ec89a4d0be7,2033-03-27,2033-03-28,Waitrose,5411,Groceries,Supermarket,-22.69,GBP,-208693.59,POS,London,GB,2219,user_001,,
1db26e97-9f9f-4528-a648-cfee22309b4c,2033-03-29,2033-03-31,Amazon UK,5942,Shopping,Online Retail,-117.68,GBP,-208811.27,E-Com,London,GB,2219,user_001,,
5d5e9d4f-c2e9-4bd8-a312-a98eeda77f65,2033-03-29,2033-03-29,Waitrose,5411,Groceries,Supermarket,-79.14,GBP,-208890.41,POS,London,GB,9074,user_001,,
d4d31392-bffc-4691-929a-4aa4597bba65,2033-03-29,2033-03-29,Deliveroo,5812,Food & Drink,Delivery,-33.82,GBP,-208924.23,E-Com,London,GB,2219,user_001,,
2d53327e-76d8-4eae-b28c-51a45b45fbfa,2033-03-30,2033-04-01,Waitrose,5411,Groceries,Supermarket,-56.5,GBP,-208980.73,POS,London,GB,1045,user_001,,
47b568ed-477e-495c-a419-224419aeaf2e,2033-03-30,2033-04-01,Waitrose,5411,Groceries,Supermarket,-21.01,GBP,-209001.74,POS,London,GB,1045,user_001,,
7bfb7574-0213-4c4d-b742-013a365d0365,2033-03-30,2033-03-31,Transport for London,4111,Transport,Transit,-7.9,GBP,-209009.64,POS,London,GB,1045,user_001,,
a2062e01-467c-4090-82e7-25cc9bf404d2,2033-03-30,2033-04-01,Shell,5541,Transport,Fuel,-62.52,GBP,-209072.16,POS,London,GB,9074,user_001,,
0c6e1b6e-6ba2-44b3-8cee-6d986dfd6b14,2033-03-31,2033-03-31,Apple.com/bill,5734,Shopping,Electronics,-202.72,GBP,-209274.88,E-Com,Cupertino,US,9074,user_001,,
c8dcfda0-8bfd-420d-8769-4b7878afad5b,2033-03-31,2033-04-04,Amazon UK,5942,Shopping,Online Retail,-73.28,GBP,-209348.16,E-Com,London,GB,9074,user_001,,
a110a5e0-5e8a-4f51-88bc-d0fbf0122220,2033-04-01,2033-04-01,Crown Estates Lettings,6513,Housing,Rent,-1532.39,GBP,-210880.55,POS,London,GB,2219,user_001,rec_19f70fbcce,
072994b2-078d-4f4a-9529-e2313bcb736c,2033-04-02,2033-04-04,Sainsbury's,5411,Groceries,Supermarket,-41.81,GBP,-210922.36,POS,London,GB,2219,user_001,,
c301f8bb-7682-4ebd-8d4e-860c1eef81d3,2033-04-02,2033-04-04,Waitrose,5411,Groceries,Supermarket,-65.27,GBP,-210987.63,POS,London,GB,4488,user_002,,
d2cac941-8d22-460b-8bb0-1424104b4948,2033-04-02,2033-04-04,Deliveroo,5812,Food & Drink,Delivery,-18.91,GBP,-211006.54,E-Com,London,GB,4488,user_001,,
1f6b0bf5-cc93-4b45-a443-997e68621126,2033-04-03,2033-04-04,Apple.com/bill,5734,Shopping,Electronics,-49.54,GBP,-211056.08,E-Com,Cupertino,US,9074,user_002,,
349ca2e8-e099-4924-9734-e43aeba2060f,2033-04-03,2033-04-04,Local Market,5499,Groceries,Specialty,-18.76,GBP,-211074.84,POS,London,GB,4488,user_001,,
94db5bc3-e723-491a-8328-b4b9e5579569,2033-04-03,2033-04-04,Apple.com/bill,5734,Shopping,Electronics,-46.12,GBP,-211120.96,E-Com,Cupertino,US,1045,user_001,,
9e5f53dc-67b9-42d0-8daa-bdd13567149c,2033-04-03,2033-04-04,Sainsbury's,5411,Groceries,Supermarket,-19.42,GBP,-211140.38,POS,London,GB,9074,user_001,,
b129fb17-8016-4294-a9df-aba2b152d960,2033-04-03,2033-04-04,Transport for London,4111,Transport,Transit,-8.99,GBP,-211149.37,POS,London,GB,4488,user_001,,
369564f1-5104-4e91-b9f8-05e5b8c7a40b,2033-04-04,2033-04-05,Waitrose,5411,Groceries,Supermarket,-56.73,GBP,-211206.1,POS,London,GB,4488,user_001,,
6039e2e1-b893-439e-afb5-167ce3496477,2033-04-05,2033-04-05,Tesco,5411,Groceries,Supermarket,-19.2,GBP,-211225.3,POS,London,GB,2219,user_001,,
445b5da1-5f2d-4040-a69d-f7e9e1d89650,2033-04-06,2033-04-07,Pret A Manger,5814,Food & Drink,Eating Out,-5.64,GBP,-211230.94,POS,London,GB,9074,user_002,,
1fb67fbb-95e5-4835-a3b0-0b65485b7698,2033-04-07,2033-04-11,Octopus Energy,4900,Utilities,Electricity,-131.24,GBP,-211362.18,Direct Debit,London,GB,4488,user_001,rec_141a4a0666,
86dafd7c-78e3-4b6a-9af9-6df8ccb4f545,2033-04-07,2033-04-07,Tesco,5411,Groceries,Supermarket,-64.09,GBP,-211426.27,POS,London,GB,2219,user_001,,
cec785cd-72aa-4a22-9ba3-f68297c356b8,2033-04-07,2033-04-07,Tesco,5411,Groceries,Supermarket,-29.46,GBP,-211455.73,POS,London,GB,2219,user_002,,
3061fedd-662c-4500-84eb-b9086debb61c,2033-04-08,2033-04-11,Waitrose,5411,Groceries,Supermarket,-73.83,GBP,-211529.56,POS,London,GB,9074,user_001,,
b8916cec-47b8-4df9-b5ce-9bc60c1652f0,2033-04-08,2033-04-11,Shell,5541,Transport,Fuel,-33.01,GBP,-211562.57,POS,London,GB,9074,user_001,,
c150180b-a9f7-4e7b-ab8f-8c2fe71b196b,2033-04-08,2033-04-11,Deliveroo,5812,Food & Drink,Delivery,-25.87,GBP,-211588.44,E-Com,London,GB,9074,user_001,,
2d2768d9-f21b-41e8-a03d-40d17c7abfe6,2033-04-09,2033-04-11,Uber UK,4121,Transport,Ride Hailing,-9.2,GBP,-211597.64,E-Com,London,GB,9074,user_001,,
67f73495-656d-402b-883a-2899a0928175,2033-04-09,2033-04-11,Waitrose,5411,Groceries,Supermarket,-57.98,GBP,-211655.62,POS,London,GB,9074,user_001,,
ab028302-a9c6-49fe-9069-603ca630cd41,2033-04-09,2033-04-11,Sainsbury's,5411,Groceries,Supermarket,-26.47,GBP,-211682.09,POS,London,GB,1045,user_001,,
c7a6e777-e755-49ac-9379-02cbf301b304,2033-04-09,2033-04-11,Local Market,5499,Groceries,Specialty,-11.46,GBP,-211693.55,POS,London,GB,1045,user_001,,
6df31a74-f22c-4b89-8161-a3befd62063b,2033-04-10,2033-04-11,Amazon UK,5942,Shopping,Online Retail,-119.44,GBP,-211812.99,E-Com,London,GB,4488,user_001,,
6e0b9c25-b170-44c0-be96-8a5531efeab7,2033-04-10,2033-04-11,Deliveroo,5812,Food & Drink,Delivery,-14.57,GBP,-211827.56,E-Com,London,GB,1045,user_001,,
9233f112-713c-488d-a7cd-fed5ff32c4b1,2033-04-10,2033-04-11,HM Revenue & Customs,9311,Income,Tax Refund,1253.75,GBP,-210573.81,Credit,London,GB,9074,user_001,,Refund for Crown Estates Lettings
ea281d43-cb2f-449f-a64d-7ad8d6fafacf,2033-04-10,2033-04-12,Sainsbury's,5411,Groceries,Supermarket,-18.14,GBP,-210591.95,POS,London,GB,2219,user_001,,
f35333a5-c339-40cf-a73b-e784ba90fef4,2033-04-10,2033-04-12,Shell,5541,Transport,Fuel,-76.8,GBP,-210668.75,POS,London,GB,1045,user_001,,
343fd829-4e55-4601-9dfb-a6bbeaf89370,2033-04-11,2033-04-11,Apple.com/bill,5734,Shopping,Electronics,-164.66,USD,-210833.41,E-Com,Cupertino,US,9074,user_001,,FX purchase 204.88 USD @ rate 1.24
5cb39dc9-a110-435a-95a4-3eb4d3028ab9,2033-04-11,2033-04-11,Pret A Manger,5814,Food & Drink,Eating Out,-7.51,GBP,-210840.92,POS,London,GB,9074,user_001,,
68391a0b-7bb9-424b-b323-3f7a559e2a10,2033-04-11,2033-04-11,Thames Water,4900,Utilities,Water,-41.92,GBP,-210882.84,Direct Debit,Reading,GB,4488,user_001,rec_3a34d62842,
7759feb2-7016-475e-8b65-818fd335607e,2033-04-11,2033-04-11,Sainsbury's,5411,Groceries,Supermarket,-23.09,GBP,-210905.93,POS,London,GB,9074,user_001,,
9ddc1797-6289-496a-9782-27746a4a87b8,2033-04-11,2033-04-13,Amazon UK,5942,Shopping,Online Retail,-58.35,GBP,-210964.28,E-Com,London,GB,9074,user_002,,
18bf9897-f91c-4cb9-94d2-bcee72bb31fb,2033-04-13,2033-04-13,Waitrose,5411,Groceries,Supermarket,-36.56,GBP,-211000.84,POS,London,GB,4488,user_001,,
3af6c1fb-bed5-4d16-a69c-3e439b286ebf,2033-04-13,2033-04-14,Shell,5541,Transport,Fuel,-44.57,GBP,-211045.41,POS,London,GB,1045,user_001,,
73ce18f4-e708-40af-9ef2-e02281f33577,2033-04-13,2033-04-15,City Council Tax,9399,Utilities,Council Tax,-189.63,GBP,-211235.04,Direct Debit,London,GB,2219,user_001,rec_f531495db5,
0aa10172-f96f-4bae-9ef7-4ec66f0ac5a2,2033-04-15,2033-04-18,O2 UK,4814,Bills,Mobile,-53.63,GBP,-211288.67,Direct Debit,Slough,GB,1045,user_001,rec_95042d8101,
bbfe6529-018f-48e4-862d-05305383a856,2033-04-15,2033-04-18,Local Market,5499,Groceries,Specialty,-15.92,GBP,-211304.59,POS,London,GB,4488,user_001,,
0f91198b-59c5-4c89-800d-3c016c686da0,2033-04-16,2033-04-18,Shell,5541,Transport,Fuel,-66.66,GBP,-211371.25,POS,London,GB,4488,user_001,,
21cbfae8-2e7f-41ed-abc2-c6aba389e992,2033-04-16,2033-04-18,Pret A Manger,5814,Food & Drink,Eating Out,-10.95,GBP,-211382.2,POS,London,GB,9074,user_001,,
2f2b0c37-6086-4c19-81d2-72632a30bea3,2033-04-16,2033-04-18,Deliveroo,5812,Food & Drink,Delivery,-20.61,GBP,-211402.81,E-Com,London,GB,4488,user_002,,
fbf66cee-3e66-4f7c-a507-6193cc926d6d,2033-04-16,2033-04-18,Sainsbury's,5411,Groceries,Supermarket,-49.29,GBP,-211452.1,POS,London,GB,4488,user_001,,
c0d35207-2812-44a5-9ab4-0f338f81bf9c,2033-04-17,2033-04-18,Deliveroo,5812,Food & Drink,Delivery,-20.62,GBP,-211472.72,E-Com,London,GB,1045,user_001,,
e1288e4d-0c4e-4da4-9c77-dff1917a4846,2033-04-17,2033-04-18,Local Market,5499,Groceries,Specialty,-6.27,GBP,-211478.99,POS,London,GB,1045,user_001,,
0b847e47-da4b-458b-85a7-9c2f7e7f517c,2033-04-18,2033-04-19,GymBox,7997,Wellness,Gym,-46.19,GBP,-211525.18,Direct Debit,London,GB,2219,user_001,rec_3906953fd2,
16a0b035-ede7-41a6-88f8-99e88fe63b12,2033-04-18,2033-04-19,Tesco,5411,Groceries,Supermarket,-37.47,GBP,-211562.65,POS,London,GB,1045,user_002,,
e35a537e-eb1a-4118-bfac-187fa3f50b8c,2033-04-18,2033-04-20,Amazon UK,5942,Shopping,Online Retail,-38.97,GBP,-211601.62,E-Com,London,GB,4488,user_001,,
41d6b54e-bcf9-476f-b69d-b3a3fa8f45cc,2033-04-19,2033-04-19,Transport for London,4111,Transport,Transit,-9.87,GBP,-211611.49,POS,London,GB,1045,user_001,,
6aa56f9f-259e-4108-b86f-18e4e8606837,2033-04-19,2033-04-20,Spotify,5735,Entertainment,Subscriptions,-8.79,GBP,-211620.28,E-Com,Stockholm,SE,2219,user_001,rec_4c746d2c3b,
cb1a4788-d09f-412b-a555-ba11233bf695,2033-04-19,2033-04-20,Sainsbury's,5411,Groceries,Supermarket,-45.0,GBP,-211665.28,POS,London,GB,1045,user_002,,
3caf7ecf-05a1-4c76-b88c-e9b1b23ac459,2033-04-20,2033-04-20,HM Revenue & Customs,9311,Income,Tax Refund,85.83,GBP,-211579.45,Credit,London,GB,4488,user_001,,Refund for Amazon UK
dddf1927-bd97-492b-9f82-7377482a002e,2033-04-20,2033-04-22,Waitrose,5411,Groceries,Supermarket,-32.61,GBP,-211612.06,POS,London,GB,4488,user_001,,
0b655862-6e5f-4d0c-a3fd-f87bc675c8d0,2033-04-21,2033-04-21,Uber UK,4121,Transport,Ride Hailing,-28.16,GBP,-211640.22,E-Com,London,GB,2219,user_002,,
0ef92670-6b90-4000-9633-a3dd01b9ac09,2033-04-21,2033-04-25,Netflix,7841,Entertainment,Subscriptions,-15.92,USD,-211656.14,E-Com,Los Gatos,US,4488,user_002,rec_d9322c1382,FX purchase 19.15 USD @ rate 1.20
f27e7fd4-5e06-4845-963f-e4d799167a41,2033-04-21,2033-04-21,Uber UK,4121,Transport,Ride Hailing,-13.25,GBP,-211669.39,E-Com,London,GB,1045,user_001,,
0108c095-67c2-4b67-b5f4-621b5d83a720,2033-04-23,2033-04-25,Waitrose,5411,Groceries,Supermarket,-21.37,GBP,-211690.76,POS,London,GB,4488,user_001,,
224f6c2c-e220-4adf-9fd2-1c297bc006aa,2033-04-23,2033-04-25,Apple.com/bill,5734,Shopping,Electronics,-113.76,GBP,-211804.52,E-Com,Cupertino,US,1045,user_001,,
8747d8ae-b709-47d4-a8fb-c87a1de3f822,2033-04-23,2033-04-25,Sainsbury's,5411,Groceries,Supermarket,-44.11,GBP,-211848.63,POS,London,GB,4488,user_001,,
c9d7c180-bacb-4968-8081-6d0944ab231d,2033-04-23,2033-04-25,Shell,5541,Transport,Fuel,-88.75,GBP,-211937.38,POS,London,GB,4488,user_001,,
2e7b284e-bc62-4a38-9638-f67705c2194a,2033-04-24,2033-04-26,Shell,5541,Transport,Fuel,-57.09,GBP,-211994.47,POS,London,GB,1045,user_001,,
c0a71254-5a0f-4ece-82de-fb64e3f3a5bb,2033-04-24,2033-04-25,Deliveroo,5812,Food & Drink,Delivery,-15.55,GBP,-212010.02,E-Com,London,GB,9074,user_001,,
ed3f1a6c-a56c-4aa9-b8ec-ea262f807d84,2033-04-24,2033-04-26,Pret A Manger,5814,Food & Drink,Eating Out,-9.46,GBP,-212019.48,POS,London,GB,1045,user_002,,
fa0e4a3c-0574-4531-910a-c2b812f3f50a,2033-04-24,2033-04-26,Apple.com/bill,5734,Shopping,Electronics,-13.6,GBP,-212033.08,E-Com,Cupertino,US,4488,user_001,,
ab8f4fdc-b004-48a8-8574-e563e8d6cab8,2033-04-25,2033-04-25,T212 Capital,6011,Income,Salary,3399.56,GBP,-208633.52,Credit,London,GB,4488,user_001,rec_2ff8f778d0,
7bf9aa94-88e3-4e77-86e0-13dca242e913,2033-04-26,2033-04-26,HM Revenue & Customs,9311,Income,Tax Refund,69.3,GBP,-208564.22,Credit,London,GB,4488,user_001,,Refund for Waitrose
71f16b8f-4948-462a-a77b-381c8f639333,2033-04-27,2033-04-27,Transport for London,4111,Transport,Transit,-4.31,GBP,-208568.53,POS,London,GB,2219,user_002,,
9f996bf9-3f58-4868-a257-089812282a3d,2033-04-27,2033-04-29,Tesco,5411,Groceries,Supermarket,-62.28,GBP,-208630.81,POS,London,GB,4488,user_001,,
a960f4c2-ef82-4b3e-9628-438b2e7891c8,2033-04-27,2033-04-27,Shell,5541,Transport,Fuel,-79.86,GBP,-208710.67,POS,London,GB,9074,user_001,,
b903f2fb-f23e-4ae6-b75f-ba607e297b3f,2033-04-28,2033-04-29,Waitrose,5411,Groceries,Supermarket,-60.34,GBP,-208771.01,POS,London,GB,9074,user_001,,
ba7feb8c-0a3d-4ff4-bb4c-616cd7ab320b,2033-04-30,2033-05-02,Sainsbury's,5411,Groceries,Supermarket,-15.73,GBP,-208786.74,POS,London,GB,9074,user_001,,
dff6e0e5-0601-4860-a881-61dfe7d9e96e,2033-04-30,2033-05-02,Airline Refund,4511,Travel,Refund,37.42,GBP,-208749.32,Credit,London,GB,1045,user_001,,Refund for O2 UK
f8a91e24-4119-4809-a41e-1318b3ba611a,2033-04-30,2033-05-02,Apple.com/bill,5734,Shopping,Electronics,-163.7,GBP,-208913.02,E-Com,Cupertino,US,4488,user_002,,
35e9c973-1567-4fe4-80f5-a5d3931c339a,2033-05-01,2033-05-02,Uber UK,4121,Transport,Ride Hailing,-22.94,GBP,-208935.96,E-Com,London,GB,4488,user_002,,
5826b010-dc45-4f60-b940-de6856194d84,2033-05-01,2033-05-02,Pret A Manger,5814,Food & Drink,Eating Out,-11.57,GBP,-208947.53,POS,London,GB,4488,user_002,,
64ee3917-fcd8-4ed8-834e-e4644087adb3,2033-05-01,2033-05-02,Waitrose,5411,Groceries,Supermarket,-35.16,GBP,-208982.69,POS,London,GB,9074,user_002,,
c073ac70-9ea9-434d-8ff5-54b2deab1133,2033-05-01,2033-05-03,Apple.com/bill,5734,Shopping,Electronics,-98.39,GBP,-209081.08,E-Com,Cupertino,US,2219,user_001,,
06ac72b9-297d-4d2e-9994-1a41783b888d,2033-05-02,2033-05-03,Uber UK,4121,Transport,Ride Hailing,-20.32,GBP,-209101.4,E-Com,London,GB,4488,user_001,,
30834159-5ed6-49b6-8c05-477f6ec8cedc,2033-05-02,2033-05-03,Sainsbury's,5411,Groceries,Supermarket,-52.46,GBP,-209153.86,POS,London,GB,2219,user_001,,
3e38ff67-746f-494f-a464-efb97c9297e7,2033-05-02,2033-05-03,Pret A Manger,5814,Food & Drink,Eating Out,-7.09,GBP,-209160.95,POS,London,GB,1045,user_001,,
56748dab-7039-4790-ae6e-354964b49697,2033-05-02,2033-05-02,Crown Estates Lettings,6513,Housing,Rent,-1613.28,GBP,-210774.23,POS,London,GB,1045,user_001,rec_19f70fbcce,
56c14c23-080f-48bd-8f0d-a81954111f45,2033-05-02,2033-05-03,Amazon UK,5942,Shopping,Online Retail,-95.25,GBP,-210869.48,E-Com,London,GB,4488,user_001,,
3f042792-8f96-4065-afd2-7281a56671f5,2033-05-03,2033-05-05,Tesco,5411,Groceries,Supermarket,-77.33,GBP,-210946.81,POS,London,GB,2219,user_001,,
4dd610d0-71ad-4921-b454-a6d73b61aacc,2033-05-03,2033-05-05,Tesco,5411,Groceries,Supermarket,-30.05,GBP,-210976.86,POS,London,GB,2219,user_001,,
e4ae3668-282a-4395-ad57-a9a1156a7138,2033-05-04,2033-05-04,Apple.com/bill,5734,Shopping,Electronics,-89.1,GBP,-211065.96,E-Com,Cupertino,US,9074,user_001,,
c0adf17f-d989-45a9-918b-2fc08e38571f,2033-05-05,2033-05-09,Local Market,5499,Groceries,Specialty,-16.54,GBP,-211082.5,POS,London,GB,2219,user_001,,
57ce841e-e367-4ee7-8412-ec5a98d8e9ee,2033-05-06,2033-05-06,Local Market,5499,Groceries,Specialty,-14.14,GBP,-211096.64,POS,London,GB,9074,user_001,,
6d954741-1db0-4f70-ab61-f1915cf2b7ae,2033-05-06,2033-05-06,Tesco,5411,Groceries,Supermarket,-30.61,GBP,-211127.25,POS,London,GB,2219,user_001,,
88b725e7-820c-4ad8-a319-fa8e18060bb4,2033-05-06,2033-05-09,Uber UK,4121,Transport,Ride Hailing,-20.57,GBP,-211147.82,E-Com,London,GB,9074,user_001,,
02d4676a-cffd-4c7d-85f6-59858fb09d41,2033-05-07,2033-05-09,Sainsbury's,5411,Groceries,Supermarket,-20.27,GBP,-211168.09,POS,London,GB,2219,user_001,,
1fcc56fb-979c-480a-a0ae-1794977ffaf5,2033-05-07,2033-05-09,ATM Withdrawal,6011,Cash,ATM,-84.26,GBP,-211252.35,ATM,London,GB,2219,user_001,,
8b828364-b57a-4de1-8c08-f13b6695184d,2033-05-07,2033-05-09,Shell,5541,Transport,Fuel,-71.18,GBP,-211323.53,POS,London,GB,9074,user_001,,
c113b8d2-461e-43b6-9a09-b0a897059d96,2033-05-07,2033-05-09,Shell,5541,Transport,Fuel,-82.18,GBP,-211405.71,POS,London,GB,1045,user_001,,
d0bb7605-135f-4a1f-96fb-e62e3ccd8c70,2033-05-07,2033-05-09,Local Market,5499,Groceries,Specialty,-17.02,GBP,-211422.73,POS,London,GB,4488,user_001,,
d411fdb3-56e3-490c-9856-13353b093c1f,2033-05-07,2033-05-09,Airline Refund,4511,Travel,Refund,13.86,GBP,-211408.87,Credit,London,GB,9074,user_002,,Refund for Uber UK
286e0605-ed43-4103-807c-ab9a77fd5a58,2033-05-08,2033-05-09,Sainsbury's,5411,Groceries,Supermarket,-54.34,GBP,-211463.21,POS,London,GB,9074,user_001,,
e577e1d2-d975-4e9f-9d72-d84a7761d849,2033-05-08,2033-05-10,Deliveroo,5812,Food & Drink,Delivery,-22.53,GBP,-211485.74,E-Com,London,GB,4488,user_001,,
5f8169c4-0295-4f5a-8e69-609b57ce6714,2033-05-09,2033-05-11,Octopus Energy,4900,Utilities,Electricity,-129.3,GBP,-211615.04,Direct Debit,London,GB,9074,user_002,rec_09c3f12b18,
f1e8ef58-3d43-4445-816f-1559f4cb0852,2033-05-09,2033-05-09,Waitrose,5411,Groceries,Supermarket,-27.81,GBP,-211642.85,POS,London,GB,9074,user_001,,
8ae883a9-f444-4fd7-898a-cdae9e558788,2033-05-11,2033-05-12,Thames Water,4900,Utilities,Water,-35.23,GBP,-211678.08,Direct Debit,Reading,GB,2219,user_001,rec_3a34d62842,
f8e92a77-4cd8-4435-a273-551ff2e44ac3,2033-05-11,2033-05-13,Amazon UK,5942,Shopping,Online Retail,-93.21,GBP,-211771.29,E-Com,London,GB,4488,user_001,,
6d3c5c9d-cc7d-4f7e-8b8f-c4646c969b38,2033-05-12,2033-05-12,Waitrose,5411,Groceries,Supermarket,-68.38,GBP,-211839.67,POS,London,GB,4488,user_001,,
f84c1ccd-b496-47f7-aea9-25b71856c508,2033-05-12,2033-05-16,Pret A Manger,5814,Food & Drink,Eating Out,-9.68,GBP,-211849.35,POS,London,GB,2219,user_001,,
0a422201-147e-4ef2-9a8a-3b306a6544bc,2033-05-13,2033-05-16,City Council Tax,9399,Utilities,Council Tax,-150.24,GBP,-211999.59,Direct Debit,London,GB,1045,user_002,rec_6feaa5d43f,
21578469-625a-45f7-b77e-7d6fcea87c5c,2033-05-13,2033-05-16,Deliveroo,5812,Food & Drink,Delivery,-17.51,GBP,-212017.1,E-Com,London,GB,4488,user_002,,
bdc270fc-a80a-4525-92c1-7e647843c2f1,2033-05-13,2033-05-13,Transport for London,4111,Transport,Transit,-11.57,GBP,-212028.67,POS,London,GB,1045,user_001,,
0ff68a30-cec6-4beb-8d68-3bfc606cf219,2033-05-14,2033-05-16,Sainsbury's,5411,Groceries,Supermarket,-34.74,GBP,-212063.41,POS,London,GB,4488,user_001,,
1b304b3f-965e-45d2-83da-c7caa25f8502,2033-05-14,2033-05-16,Sainsbury's,5411,Groceries,Supermarket,-66.38,GBP,-212129.79,POS,London,GB,1045,user_001,,
a14be421-3240-4d80-9862-aa8629d59494,2033-05-14,2033-05-16,Deliveroo,5812,Food & Drink,Delivery,-26.19,GBP,-212155.98,E-Com,London,GB,1045,user_001,,
df5fd0d4-166c-4971-a76a-81de1a80f93e,2033-05-14,2033-05-16,Uber UK,4121,Transport,Ride Hailing,-11.99,GBP,-212167.97,E-Com,London,GB,9074,user_001,,
1366853f-24c8-4f6d-85ac-33b49f3f21d3,2033-05-15,2033-05-17,Deliveroo,5812,Food & Drink,Delivery,-22.07,GBP,-212190.04,E-Com,London,GB,9074,user_001,,
2c3a4cc1-1205-4e6a-a351-cd04f54a7f1b,2033-05-15,2033-05-16,Pret A Manger,5814,Food & Drink,Eating Out,-9.62,GBP,-212199.66,POS,London,GB,9074,user_001,,
4d042eea-e42b-44f9-851b-3229e2621c7f,2033-05-15,2033-05-16,Tesco,5411,Groceries,Supermarket,-40.15,GBP,-212239.81,POS,London,GB,4488,user_002,,
d30cf3cb-ba8f-4eaa-bb8d-ca6ff8586d94,2033-05-15,2033-05-17,Amazon UK,5942,Shopping,Online Retail,-49.24,GBP,-212289.05,E-Com,London,GB,1045,user_001,,
d5f4e97c-b131-45a4-8c0f-1757e21feff6,2033-05-15,2033-05-16,Transport for London,4111,Transport,Transit,-6.44,GBP,-212295.49,POS,London,GB,1045,user_001,,
0edcb947-3e13-4826-8a76-ab3df2b2fe14,2033-05-16,2033-05-17,Pret A Manger,5814,Food & Drink,Eating Out,-11.17,GBP,-212306.66,POS,London,GB,9074,user_001,,
1c6e6471-7265-45f1-8f21-5277059f199e,2033-05-16,2033-05-16,Transport for London,4111,Transport,Transit,-9.33,GBP,-212315.99,POS,London,GB,2219,user_001,,
49857d3f-b7ed-4feb-b2cf-c237a5912c5a,2033-05-16,2033-05-16,O2 UK,4814,Bills,Mobile,-41.54,GBP,-212357.53,Direct Debit,Slough,GB,9074,user_001,rec_95042d8101,
526cc423-5e7a-48dd-adb9-cadb41b26134,2033-05-16,2033-05-16,Shell,5541,Transport,Fuel,-48.82,GBP,-212406.35,POS,London,GB,4488,user_001,,
39b061c8-4662-4ecd-94ef-7ee9db38fc47,2033-05-17,2033-05-19,GymBox,7997,Wellness,Gym,-53.02,GBP,-212459.37,Direct Debit,London,GB,4488,user_001,rec_3906953fd2,
3b36319c-625f-4d9e-a981-9d03c78e2753,2033-05-17,2033-05-18,Amazon UK,5942,Shopping,Online Retail,-32.38,GBP,-212491.75,E-Com,London,GB,2219,user_001,,
52eefd8d-db43-48fa-b6c3-ddf9f1f448bb,2033-05-17,2033-05-18,Shell,5541,Transport,Fuel,-57.81,GBP,-212549.56,POS,London,GB,1045,user_002,,
2cba9368-58e3-4bff-b436-15f6e24b4d5d,2033-05-18,2033-05-19,Local Market,5499,Groceries,Specialty,-7.45,GBP,-212557.01,POS,London,GB,1045,user_001,,
91854872-1f50-4cd3-adfe-1c0dfd11a26c,2033-05-19,2033-05-19,Spotify,5735,Entertainment,Subscriptions,-8.38,GBP,-212565.39,E-Com,Stockholm,SE,1045,user_001,rec_4c746d2c3b,
1571b1d6-4db1-46b3-aa14-8987d6a89cd8,2033-05-20,2033-05-20,Shell,5541,Transport,Fuel,-76.69,GBP,-212642.08,POS,London,GB,4488,user_001,,
3d72e6e2-5a13-4f80-b79a-a0d3e99825f0,2033-05-20,2033-05-20,Amazon UK,5942,Shopping,Online Retail,-119.38,GBP,-212761.46,E-Com,London,GB,9074,user_001,,
008c8502-2b4c-4d5a-8b71-e5ac5c556787,2033-05-21,2033-05-23,Deliveroo,5812,Food & Drink,Delivery,-20.21,GBP,-212781.67,E-Com,London,GB,9074,user_002,,
3a79ad58-239b-4a7f-97c6-bfd31e92da81,2033-05-21,2033-05-23,Pret A Manger,5814,Food & Drink,Eating Out,-6.04,GBP,-212787.71,POS,London,GB,4488,user_001,,
3d8cfd2e-86b4-42e3-ad80-674286851088,2033-05-21,2033-05-23,Uber UK,4121,Transport,Ride Hailing,-30.85,GBP,-212818.56,E-Com,London,GB,1045,user_001,,
7839e2ab-2546-42fe-8e07-8f71d3ff2bfe,2033-05-22,2033-05-23,Sainsbury's,5411,Groceries,Supermarket,-65.83,GBP,-212884.39,POS,London,GB,1045,user_001,,
a5bcd85b-6a3a-40be-b0b2-666a301f3a9f,2033-05-22,2033-05-23,Apple.com/bill,5734,Shopping,Electronics,-121.78,USD,-213006.17,E-Com,Cupertino,US,4488,user_001,,FX purchase 154.39 USD @ rate 1.27
e1fed65d-cc81-4e4e-a0f0-41963c19daf1,2033-05-22,2033-05-23,Waitrose,5411,Groceries,Supermarket,-21.06,GBP,-213027.23,POS,London,GB,1045,user_001,,
1b36acd9-1a83-4a20-b610-206576bce35a,2033-05-23,2033-05-24,Tesco,5411,Groceries,Supermarket,-20.68,GBP,-213047.91,POS,London,GB,4488,user_001,,
4f6dec89-e6e6-4e44-acb5-b031fecae1ca,2033-05-23,2033-05-25,Tesco,5411,Groceries,Supermarket,-81.95,GBP,-213129.86,POS,London,GB,1045,user_002,,
dc49d065-fbf0-4229-a0a4-b36dc5ce4081,2033-05-23,2033-05-24,Netflix,7841,Entertainment,Subscriptions,-11.64,GBP,-213141.5,E-Com,Los Gatos,US,4488,user_001,rec_1bfe33738d,
68fb23cd-f969-41ce-9653-d4231139cf69,2033-05-24,2033-05-24,Pret A Manger,5814,Food & Drink,Eating Out,-8.42,GBP,-213149.92,POS,London,GB,9074,user_001,,
18ca69dc-7366-42b5-8379-2919a3a37e8d,2033-05-25,2033-05-26,Pret A Manger,5814,Food & Drink,Eating Out,-7.65,GBP,-213157.57,POS,London,GB,9074,user_001,,
4f4a241b-a4b0-4d11-abff-0ec7395cce67,2033-05-25,2033-05-25,T212 Capital,6011,Income,Salary,2879.63,GBP,-210277.94,Credit,London,GB,2219,user_001,rec_2ff8f778d0,
9a301b1f-850c-48b5-a54b-db6e43c9c108,2033-05-25,2033-05-26,Sainsbury's,5411,Groceries,Supermarket,-36.47,GBP,-210314.41,POS,London,GB,4488,user_001,,
264b30c9-ad94-44cb-a78a-3015782b1ec4,2033-05-26,2033-05-26,Uber UK,4121,Transport,Ride Hailing,-11.08,GBP,-210325.49,E-Com,London,GB,1045,user_001,,
57c605a6-ccf9-483f-a3aa-69711a511526,2033-05-27,2033-05-27,Airline Refund,4511,Travel,Refund,38.97,GBP,-210286.52,Credit,London,GB,1045,user_001,,Refund for Sainsbury's
5ddae4d2-421a-498f-9719-389fd92c7464,2033-05-27,2033-05-30,Pret A Manger,5814,Food & Drink,Eating Out,-7.83,GBP,-210294.35,POS,London,GB,4488,user_001,,
d4cb0e6c-969e-4e3d-8829-1905808c8f97,2033-05-27,2033-05-27,Amazon UK,5942,Shopping,Online Retail,-102.62,GBP,-210396.97,E-Com,London,GB,9074,user_001,,
d67e3cc2-3c6f-41ba-9117-f9c05719fe2b,2033-05-27,2033-05-27,Tesco,5411,Groceries,Supermarket,-24.52,GBP,-210421.49,POS,London,GB,4488,user_001,,
7c73777b-d990-4c9c-afc0-0c99e061965a,2033-05-28,2033-05-30,Uber UK,4121,Transport,Ride Hailing,-10.14,GBP,-210431.63,E-Com,London,GB,1045,user_001,,
f980449d-84b0-469f-9dbc-5554d1ba8ab3,2033-05-28,2033-05-30,Amazon UK,5942,Shopping,Online Retail,-34.76,GBP,-210466.39,E-Com,London,GB,4488,user_001,,
00e23d8b-c0d1-41e4-83e1-45cfd98093e8,2033-05-29,2033-05-30,Shell,5541,Transport,Fuel,-88.41,GBP,-210554.8,POS,London,GB,9074,user_001,,
9f4e4668-017a-44de-b343-601a25f0dd29,2033-05-29,2033-05-30,Local Market,5499,Groceries,Specialty,-21.58,GBP,-210576.38,POS,London,GB,1045,user_001,,
1edc180f-4862-4aed-a64e-b8414c148628,2033-05-30,2033-05-30,Sainsbury's,5411,Groceries,Supermarket,-53.78,GBP,-210630.16,POS,London,GB,4488,user_002,,
d454e047-3e12-4f7f-bfca-3144b7b4fb5d,2033-05-30,2033-05-30,Airline Refund,4511,Travel,Refund,5.47,GBP,-210624.69,Credit,London,GB,4488,user_001,,Refund for Transport for London
fd363a3b-7aa8-4ee1-9898-af79b3b4f2e2,2033-05-30,2033-05-30,Transport for London,4111,Transport,Transit,-5.1,GBP,-210629.79,POS,London,GB,2219,user_001,,
15381406-4376-4221-a3ac-1f182bc31dc5,2033-05-31,2033-05-31,Airline Refund,4511,Travel,Refund,5.11,GBP,-210624.68,Credit,London,GB,2219,user_001,,Refund for Pret A Manger
81d4cc6f-3a29-4bc9-841d-fc3dadcfbc9a,2033-05-31,2033-06-02,Pret A Manger,5814,Food & Drink,Eating Out,-11.01,GBP,-210635.69,POS,London,GB,1045,user_002,,
bcb34989-b8ee-4bf8-9578-8310f4a396d2,2033-05-31,2033-05-31,Uber UK,4121,Transport,Ride Hailing,-10.41,GBP,-210646.1,E-Com,London,GB,4488,user_001,,
c224241f-d200-4027-8009-ceb568a72cf3,2033-05-31,2033-05-31,Amazon UK,5942,Shopping,Online Retail,-70.85,GBP,-210716.95,E-Com,London,GB,4488,user_001,,
3e7ce06b-c665-4e9b-9042-9d065f867e15,2033-06-01,2033-06-03,Shell,5541,Transport,Fuel,-50.28,GBP,-210767.23,POS,London,GB,1045,user_001,,
cb162db9-fbf1-4138-8d0d-9b8f984cba28,2033-06-01,2033-06-03,Shell,5541,Transport,Fuel,-77.6,GBP,-210844.83,POS,London,GB,9074,user_001,,
d2faf4d0-27f2-41d6-8ec5-4c1742836c28,2033-06-01,2033-06-03,Crown Estates Lettings,6513,Housing,Rent,-1454.74,GBP,-212299.57,POS,London,GB,9074,user_001,rec_19f70fbcce,
e0666623-3218-4403-b51b-cc697ea8e79e,2033-06-01,2033-06-03,ATM Withdrawal,6011,Cash,ATM,-107.69,GBP,-212407.26,ATM,London,GB,2219,user_001,,
fd60b3f4-c465-484e-90cd-0faf13079dab,2033-06-01,2033-06-02,Sainsbury's,5411,Groceries,Supermarket,-30.95,GBP,-212438.21,POS,London,GB,2219,user_001,,
c120e8fb-f730-465b-80d4-e4fb944b1553,2033-06-03,2033-06-06,Transport for London,4111,Transport,Transit,-8.74,GBP,-212446.95,POS,London,GB,1045,user_001,,
5a4566c9-abde-41a3-953d-501c6fe0b1c5,2033-06-04,2033-06-06,Apple.com/bill,5734,Shopping,Electronics,-55.76,GBP,-212502.71,E-Com,Cupertino,US,4488,user_001,,
9682964e-98a1-40a2-9746-a1e1e30d80e7,2033-06-04,2033-06-06,Shell,5541,Transport,Fuel,-66.78,GBP,-212569.49,POS,London,GB,9074,user_001,,
0ff84d8b-9ca6-4140-bbd5-da63c422327e,2033-06-05,2033-06-06,Deliveroo,5812,Food & Drink,Delivery,-15.3,GBP,-212584.79,E-Com,London,GB,9074,user_001,,
2ec467e2-2fc7-423e-8738-c8bd73c79dfc,2033-06-05,2033-06-06,Apple.com/bill,5734,Shopping,Electronics,-106.45,GBP,-212691.24,E-Com,Cupertino,US,1045,user_001,,
315e12b6-7c6f-4307-977f-be0daca001ba,2033-06-05,2033-06-06,Deliveroo,5812,Food & Drink,Delivery,-20.61,GBP,-212711.85,E-Com,London,GB,2219,user_002,,
707b93c2-6790-4f18-879f-85f5b23d95cc,2033-06-05,2033-06-06,Pret A Manger,5814,Food & Drink,Eating Out,-8.06,GBP,-212719.91,POS,London,GB,9074,user_002,,
6c0eaaa3-ccb7-461a-a86a-02afa2f80361,2033-06-06,2033-06-07,Uber UK,4121,Transport,Ride Hailing,-8.63,GBP,-212728.54,E-Com,London,GB,9074,user_002,,
8ba8fa97-cd98-4d47-9165-b887793a42b2,2033-06-07,2033-06-07,Amazon UK,5942,Shopping,Online Retail,-23.74,GBP,-212752.28,E-Com,London,GB,9074,user_002,,
c73392c6-b2a5-4769-b223-1bfa93e92939,2033-06-07,2033-06-09,Amazon UK,5942,Shopping,Online Retail,-99.03,GBP,-212851.31,E-Com,London,GB,4488,user_001,,
dee48669-21ad-4aa2-b28d-939a97644ceb,2033-06-07,2033-06-08,Octopus Energy,4900,Utilities,Electricity,-141.15,GBP,-212992.46,Direct Debit,London,GB,2219,user_001,rec_141a4a0666,
b3752320-093c-4eff-b5b2-4e8e320d250c,2033-06-09,2033-06-10,Sainsbury's,5411,Groceries,Supermarket,-59.74,GBP,-213052.2,POS,London,GB,9074,user_002,,
5dfd55cd-2067-4e8f-be6a-3a7da3a66ed1,2033-06-10,2033-06-13,Uber UK,4121,Transport,Ride Hailing,-33.95,GBP,-213086.15,E-Com,London,GB,1045,user_001,,
0625ff6b-08d8-4ccc-8909-fbf8395e0f18,2033-06-11,2033-06-13,Sainsbury's,5411,Groceries,Supermarket,-37.94,GBP,-213124.09,POS,London,GB,1045,user_001,,
5073d828-2eae-4227-8551-8e7edc768dac,2033-06-11,2033-06-13,Local Market,5499,Groceries,Specialty,-17.0,GBP,-213141.09,POS,London,GB,1045,user_002,,
c7b70219-4e64-4eeb-b43e-41ef30aaaa24,2033-06-11,2033-06-13,Apple.com/bill,5734,Shopping,Electronics,-45.4,GBP,-213186.49,E-Com,Cupertino,US,2219,user_001,,
3f6051c0-626e-4d5e-866c-47bc513b2929,2033-06-12,2033-06-14,Uber UK,4121,Transport,Ride Hailing,-35.19,GBP,-213221.68,E-Com,London,GB,4488,user_001,,
44659d30-73ab-4be9-9f98-2ff457a78cba,2033-06-12,2033-06-13,Local Market,5499,Groceries,Specialty,-21.54,GBP,-213243.22,POS,London,GB,1045,user_001,,
a33f692f-fb09-4c33-a0a7-8716a177c3ad,2033-06-12,2033-06-13,Local Market,5499,Groceries,Specialty,-17.53,GBP,-213260.75,POS,London,GB,9074,user_001,,
ae4df860-e488-4dd4-b673-ac14c5af312b,2033-06-12,2033-06-13,Local Market,5499,Groceries,Specialty,-13.25,GBP,-213274.0,POS,London,GB,2219,user_001,,
bb7051e5-0eae-42b3-b203-6899025044d9,2033-06-12,2033-06-14,Sainsbury's,5411,Groceries,Supermarket,-23.88,GBP,-213297.88,POS,London,GB,4488,user_001,,
c9124e6b-c78b-4504-8377-3715997435fb,2033-06-12,2033-06-13,Shell,5541,Transport,Fuel,-88.07,GBP,-213385.95,POS,London,GB,9074,user_001,,
06721dda-cb24-4ff7-84d8-2a5a36e57d89,2033-06-13,2033-06-15,Sainsbury's,5411,Groceries,Supermarket,-40.68,GBP,-213426.63,POS,London,GB,1045,user_002,,
82c4bd1f-3b6a-490b-bb4b-0b353e18993d,2033-06-13,2033-06-14,Transport for London,4111,Transport,Transit,-5.32,GBP,-213431.95,POS,London,GB,2219,user_002,,
ca18ed3d-7cc3-4e0a-9c8c-8872c725ab07,2033-06-13,2033-06-14,Thames Water,4900,Utilities,Water,-32.45,GBP,-213464.4,Direct Debit,Reading,GB,4488,user_002,rec_954d02400c,
e7b8c4d2-766e-4444-86e7-6f88eec2385a,2033-06-13,2033-06-15,City Council Tax,9399,Utilities,Council Tax,-168.52,GBP,-213632.92,Direct Debit,London,GB,1045,user_002,rec_6feaa5d43f,
35bea8bc-0310-4797-b86f-0461500f75e4,2033-06-15,2033-06-17,Transport for London,4111,Transport,Transit,-4.27,GBP,-213637.19,POS,London,GB,2219,user_002,,
45a96504-2597-47eb-b857-97c91ae75aee,2033-06-15,2033-06-16,O2 UK,4814,Bills,Mobile,-37.19,GBP,-213674.38,Direct Debit,Slough,GB,4488,user_002,rec_d2dce4c42f,
894b5e74-07c2-4e0c-af11-416781f63100,2033-06-15,2033-06-15,Waitrose,5411,Groceries,Supermarket,-53.19,GBP,-213727.57,POS,London,GB,4488,user_001,,
f1be2d7e-8d12-432f-830b-93fbb86aa41d,2033-06-15,2033-06-15,Pret A Manger,5814,Food & Drink,Eating Out,-6.44,GBP,-213734.01,POS,London,GB,4488,user_001,,
feb2ba67-9bf6-40db-ab64-dd742576ce79,2033-06-15,2033-06-17,Deliveroo,5812,Food & Drink,Delivery,-15.37,GBP,-213749.38,E-Com,London,GB,4488,user_002,,
eebd5f06-cef7-491f-9309-56b1e3fc275c,2033-06-16,2033-06-16,Airline Refund,4511,Travel,Refund,16.31,GBP,-213733.07,Credit,London,GB,2219,user_002,,Refund for Deliveroo
1fc5363a-f025-4ac1-9050-8a0074e42498,2033-06-17,2033-06-20,GymBox,7997,Wellness,Gym,-60.07,GBP,-213793.14,Direct Debit,London,GB,4488,user_001,rec_3906953fd2,
3b258cd9-da7a-4fb2-9cbf-b2139e7542e5,2033-06-17,2033-06-17,HM Revenue & Customs,9311,Income,Tax Refund,6.35,GBP,-213786.79,Credit,London,GB,1045,user_001,,Refund for Deliveroo
7348b3ab-e803-4261-8ea2-4c145aa0e5d7,2033-06-17,2033-06-17,Local Market,5499,Groceries,Specialty,-21.69,GBP,-213808.48,POS,London,GB,9074,user_001,,
01180b5c-9f80-4245-a3ba-e722bf87be46,2033-06-18,2033-06-20,Pret A Manger,5814,Food & Drink,Eating Out,-7.72,GBP,-213816.2,POS,London,GB,4488,user_001,,
34595fb2-e851-41a8-9fc8-716b07757ce7,2033-06-18,2033-06-20,Pret A Manger,5814,Food & Drink,Eating Out,-7.86,GBP,-213824.06,POS,London,GB,1045,user_001,,
ae476da9-cec4-4510-bffc-1e6749c0a440,2033-06-18,2033-06-20,Waitrose,5411,Groceries,Supermarket,-53.0,GBP,-213877.06,POS,London,GB,1045,user_001,,
e7b611ba-f3e0-4596-8c0d-59687c9cbd2a,2033-06-18,2033-06-20,Airline Refund,4511,Travel,Refund,43.48,GBP,-213833.58,Credit,London,GB,4488,user_001,,Refund for ATM Withdrawal
48c390e4-1139-411f-b6dd-1472d01b228d,2033-06-19,2033-06-20,Waitrose,5411,Groceries,Supermarket,-85.71,GBP,-213919.29,POS,London,GB,4488,user_001,,
7d1c705f-9901-485a-8929-bdb273116bb6,2033-06-19,2033-06-20,Apple.com/bill,5734,Shopping,Electronics,-77.69,GBP,-213996.98,E-Com,Cupertino,US,4488,user_001,,
61509d3a-7295-4a9c-9355-07114eb3285d,2033-06-20,2033-06-21,Spotify,5735,Entertainment,Subscriptions,-8.89,GBP,-214005.87,E-Com,Stockholm,SE,2219,user_001,rec_4c746d2c3b,
d4dcf5d4-95b8-4a88-8527-20fbdc9b7e23,2033-06-20,2033-06-20,Apple.com/bill,5734,Shopping,Electronics,-153.58,USD,-214159.45,E-Com,Cupertino,US,2219,user_002,,FX purchase 197.6 USD @ rate 1.29
2adfc806-65c7-4b4f-90a3-ccf2fa483a87,2033-06-21,2033-06-22,Amazon UK,5942,Shopping,Online Retail,-11.88,GBP,-214171.33,E-Com,London,GB,4488,user_001,,
bea6198e-ec3f-4392-b644-e908327358df,2033-06-21,2033-06-22,Netflix,7841,Entertainment,Subscriptions,-15.55,GBP,-214186.88,E-Com,Los Gatos,US,4488,user_001,rec_1bfe33738d,
1650e42b-a20a-4386-b68d-d97c079a81aa,2033-06-22,2033-06-24,Tesco,5411,Groceries,Supermarket,-52.95,GBP,-214239.83,POS,London,GB,1045,user_001,,
417c7524-7387-4138-90ca-5ad154a9b769,2033-06-22,2033-06-23,Uber UK,4121,Transport,Ride Hailing,-27.72,GBP,-214267.55,E-Com,London,GB,1045,user_001,,
7f16be9c-2fcc-4995-826a-fe3c68708bd3,2033-06-22,2033-06-23,Local Market,5499,Groceries,Specialty,-11.34,GBP,-214278.89,POS,London,GB,1045,user_001,,
94ceaac1-a925-45a5-ac03-aff0c8592296,2033-06-22,2033-06-22,Pret A Manger,5814,Food & Drink,Eating Out,-11.15,GBP,-214290.04,POS,London,GB,2219,user_001,,
66cf075f-b2b9-496c-89d6-e5f976b74e6d,2033-06-23,2033-06-24,Deliveroo,5812,Food & Drink,Delivery,-18.42,GBP,-214308.46,E-Com,London,GB,2219,user_001,,
72495fc8-d507-407b-b1a0-306220bd8471,2033-06-24,2033-06-24,Shell,5541,Transport,Fuel,-46.06,GBP,-214354.52,POS,London,GB,4488,user_001,,
adfb0499-b36d-4fe5-9152-27ddd5a9edb1,2033-06-24,2033-06-24,T212 Capital,6011,Income,Salary,3367.75,GBP,-210986.77,Credit,London,GB,9074,user_001,rec_2ff8f778d0,
ca0bd1cb-fa28-4100-8da0-947b70686055,2033-06-24,2033-06-27,Pret A Manger,5814,Food & Drink,Eating Out,-11.06,GBP,-210997.83,POS,London,GB,4488,user_002,,
ecb90a25-3327-4bbc-b44a-46066389f3fa,2033-06-24,2033-06-27,Pret A Manger,5814,Food & Drink,Eating Out,-6.22,GBP,-211004.05,POS,London,GB,2219,user_001,,
9d154510-1e18-4c67-8f5a-4d867b59f9fd,2033-06-25,2033-06-27,Uber UK,4121,Transport,Ride Hailing,-27.15,GBP,-211031.2,E-Com,London,GB,9074,user_001,,
ac439875-45a5-4dc1-ba5c-5c141ce5f8a5,2033-06-25,2033-06-27,Apple.com/bill,5734,Shopping,Electronics,-150.71,GBP,-211181.91,E-Com,Cupertino,US,4488,user_002,,
d2e50ace-8b95-44cc-8a62-2b20bddb25f6,2033-06-25,2033-06-27,Apple.com/bill,5734,Shopping,Electronics,-169.66,GBP,-211351.57,E-Com,Cupertino,US,4488,user_001,,
fff086c5-fb0c-4c06-9c60-239d4b76f310,2033-06-25,2033-06-27,Waitrose,5411,Groceries,Supermarket,-49.62,GBP,-211401.19,POS,London,GB,1045,user_001,,
084751ca-331d-4f4a-958d-134c5bea4cf2,2033-06-26,2033-06-27,Sainsbury's,5411,Groceries,Supermarket,-15.28,GBP,-211416.47,POS,London,GB,4488,user_001,,
0fa8adbf-edea-44ab-9d29-650d8f047f77,2033-06-26,2033-06-27,Uber UK,4121,Transport,Ride Hailing,-10.27,GBP,-211426.74,E-Com,London,GB,1045,user_001,,
5b663c9d-e78b-4e20-b460-592ba8025df2,2033-06-26,2033-06-27,Tesco,5411,Groceries,Supermarket,-74.04,GBP,-211500.78,POS,London,GB,1045,user_001,,
92703987-89c5-46f4-9b36-82f4d36bb4f1,2033-06-26,2033-06-27,Apple.com/bill,5734,Shopping,Electronics,-14.9,GBP,-211515.68,E-Com,Cupertino,US,4488,user_002,,
0bc07bbe-fb38-49a5-8aa2-46b812a7c1d6,2033-06-27,2033-06-28,Transport for London,4111,Transport,Transit,-4.71,GBP,-211520.39,POS,London,GB,2219,user_001,,
3321f9d9-5f12-4037-b6bb-fb925a20854e,2033-06-27,2033-06-29,Transport for London,4111,Transport,Transit,-6.93,GBP,-211527.32,POS,London,GB,1045,user_001,,
45c255df-88d4-4269-a07a-81967f147941,2033-06-27,2033-06-28,Deliveroo,5812,Food & Drink,Delivery,-22.11,GBP,-211549.43,E-Com,London,GB,1045,user_001,,
89da18d1-96e4-46fb-94ba-35c01dfb89ae,2033-06-27,2033-06-28,Local Market,5499,Groceries,Specialty,-10.23,GBP,-211559.66,POS,London,GB,1045,user_001,,
e0532acc-b451-44c3-aa14-dfa224a0e29d,2033-06-27,2033-06-27,Pret A Manger,5814,Food & Drink,Eating Out,-8.89,GBP,-211568.55,POS,London,GB,1045,user_001,,
70aafcfd-ed10-486d-b9e8-7f1b15bacc8b,2033-06-28,2033-06-29,Amazon UK,5942,Shopping,Online Retail,-80.8,GBP,-211649.35,E-Com,London,GB,1045,user_002,,
a210c44b-a8c7-42a4-8159-a79b3f9e870b,2033-06-29,2033-07-01,Shell,5541,Transport,Fuel,-62.72,GBP,-211712.07,POS,London,GB,9074,user_001,,
e5fb31a1-dc29-43bd-acfb-3e0874d5d252,2033-06-29,2033-06-30,Apple.com/bill,5734,Shopping,Electronics,-188.89,GBP,-211900.96,E-Com,Cupertino,US,1045,user_001,,
544e4956-785e-4270-b1bf-19105d6528cb,2033-06-30,2033-07-04,Deliveroo,5812,Food & Drink,Delivery,-23.52,GBP,-211924.48,E-Com,London,GB,1045,user_001,,
807b5f21-3364-44b2-9fa5-44fc5a29e7ac,2033-06-30,2033-06-30,Local Market,5499,Groceries,Specialty,-9.66,GBP,-211934.14,POS,London,GB,1045,user_001,,
972426e3-c97c-4af0-ba9b-52f10daf2e84,2033-06-30,2033-06-30,Shell,5541,Transport,Fuel,-49.42,GBP,-211983.56,POS,London,GB,2219,user_001,,
e2100640-57a8-435b-b9fb-050b39ea2822,2033-06-30,2033-06-30,Transport for London,4111,Transport,Transit,-6.12,GBP,-211989.68,POS,London,GB,1045,user_001,,
5a97d443-c8f2-4380-8ea5-ad0ca1c51e7f,2033-07-01,2033-07-04,Sainsbury's,5411,Groceries,Supermarket,-55.91,GBP,-212045.59,POS,London,GB,1045,user_001,,
b7a24d62-e6f3-4f90-9336-739160cd370a,2033-07-01,2033-07-04,Crown Estates Lettings,6513,Housing,Rent,-1568.41,GBP,-213614.0,POS,London,GB,4488,user_001,rec_19f70fbcce,
11746226-f851-474f-ac31-19eab7b4098b,2033-07-02,2033-07-04,Waitrose,5411,Groceries,Supermarket,-58.93,GBP,-213672.93,POS,London,GB,1045,user_001,,
50ed2f3a-9467-4d85-856b-b04c9caed55f,2033-07-02,2033-07-04,Pret A Manger,5814,Food & Drink,Eating Out,-10.37,GBP,-213683.3,POS,London,GB,9074,user_002,,
861183da-d76f-420f-8619-94248ba8bfb1,2033-07-02,2033-07-04,Uber UK,4121,Transport,Ride Hailing,-28.09,GBP,-213711.39,E-Com,London,GB,1045,user_001,,
9192830e-0714-458e-949c-58f466200e39,2033-07-02,2033-07-04,Apple.com/bill,5734,Shopping,Electronics,-57.95,USD,-213769.34,E-Com,Cupertino,US,4488,user_001,,FX purchase 69.7 USD @ rate 1.20
28be11c7-b564-471f-89ff-6c6e5377352d,2033-07-03,2033-07-04,Sainsbury's,5411,Groceries,Supermarket,-50.24,GBP,-213819.58,POS,London,GB,4488,user_001,,
86ccac35-5320-4b81-a16f-ea062b911d30,2033-07-03,2033-07-05,Pret A Manger,5814,Food & Drink,Eating Out,-10.55,GBP,-213830.13,POS,London,GB,1045,user_001,,
a8df7ac1-9976-4e11-b8c0-8c7e58a0bf68,2033-07-03,2033-07-04,Sainsbury's,5411,Groceries,Supermarket,-46.97,GBP,-213877.1,POS,London,GB,9074,user_001,,
ab1ff390-3ca5-4f24-8046-350fe0ae0915,2033-07-03,2033-07-05,Local Market,5499,Groceries,Specialty,-15.38,GBP,-213892.48,POS,London,GB,9074,user_001,,
ad35f454-4670-4173-8fa3-88063348649d,2033-07-03,2033-07-04,Tesco,5411,Groceries,Supermarket,-18.72,GBP,-213911.2,POS,London,GB,9074,user_001,,
b87a7db8-b412-4666-845a-37607d97ffef,2033-07-03,2033-07-04,Waitrose,5411,Groceries,Supermarket,-32.42,GBP,-213943.62,POS,London,GB,9074,user_001,,
c288d756-ff4c-4048-82ec-5640b6c5139d,2033-07-03,2033-07-04,Pret A Manger,5814,Food & Drink,Eating Out,-6.15,GBP,-213949.77,POS,London,GB,9074,user_002,,
01aafd62-8314-4372-a1d9-2dceac42e9c1,2033-07-04,2033-07-05,Local Market,5499,Groceries,Specialty,-20.21,GBP,-213969.98,POS,London,GB,1045,user_001,,
c2985472-06e8-40fe-bb1a-f6d1b06b1bef,2033-07-04,2033-07-05,Tesco,5411,Groceries,Supermarket,-75.07,GBP,-214045.05,POS,London,GB,2219,user_001,,
fa87e35c-c009-406b-b059-c0a4b7196101,2033-07-06,2033-07-06,Airline Refund,4511,Travel,Refund,3.36,GBP,-214041.69,Credit,London,GB,2219,user_001,,Refund for Pret A Manger
305a86d9-72f4-4d0c-bc51-49bef18427cc,2033-07-07,2033-07-08,Local Market,5499,Groceries,Specialty,-6.28,GBP,-214047.97,POS,London,GB,1045,user_001,,
52f4d683-2865-40e1-9102-3a653ae575ee,2033-07-07,2033-07-07,Octopus Energy,4900,Utilities,Electricity,-119.03,GBP,-214167.0,Direct Debit,London,GB,1045,user_001,rec_141a4a0666,
bc1b3983-0ff7-4847-8ed6-95a93c779045,2033-07-07,2033-07-08,Amazon UK,5942,Shopping,Online Retail,-87.39,GBP,-214254.39,E-Com,London,GB,1045,user_001,,
022b6e9c-4461-4c0b-8365-e73a2d9efefc,2033-07-08,2033-07-11,Apple.com/bill,5734,Shopping,Electronics,-203.53,GBP,-214457.92,E-Com,Cupertino,US,9074,user_002,,
ae8b797f-523b-4791-b648-8e2082a043aa,2033-07-08,2033-07-11,Waitrose,5411,Groceries,Supermarket,-49.79,GBP,-214507.71,POS,London,GB,9074,user_002,,
2ba0e457-f944-4d1e-bd47-27aa6e46558c,2033-07-09,2033-07-11,Uber UK,4121,Transport,Ride Hailing,-26.75,GBP,-214534.46,E-Com,London,GB,2219,user_001,,
c65cd496-5b89-40bf-89bd-5fb610dea3e4,2033-07-09,2033-07-11,Uber UK,4121,Transport,Ride Hailing,-32.0,GBP,-214566.46,E-Com,London,GB,9074,user_001,,
172e6dcf-b593-4642-b60c-dfbb01b820e0,2033-07-10,2033-07-12,Transport for London,4111,Transport,Transit,-8.17,GBP,-214574.63,POS,London,GB,9074,user_001,,
51fd3736-e0b9-4e5d-9fb9-bdcab2faee86,2033-07-10,2033-07-11,Uber UK,4121,Transport,Ride Hailing,-24.81,GBP,-214599.44,E-Com,London,GB,9074,user_001,,
3f5288d4-e8a8-4cfd-b227-5e579008f1c2,2033-07-11,2033-07-12,Waitrose,5411,Groceries,Supermarket,-84.53,GBP,-214683.97,POS,London,GB,4488,user_001,,
99b8b251-9f5d-473f-82fb-a710d22a8f4e,2033-07-11,2033-07-11,Apple.com/bill,5734,Shopping,Electronics,-160.04,GBP,-214844.01,E-Com,Cupertino,US,9074,user_001,,
b9b4a6bf-7ee6-4bc4-949c-f42ea590003a,2033-07-11,2033-07-12,Thames Water,4900,Utilities,Water,-44.97,GBP,-214888.98,Direct Debit,Reading,GB,1045,user_001,rec_3a34d62842,
ea22a05e-de06-4dc4-ad2b-6b2f10eae5fa,2033-07-11,2033-07-11,Local Market,5499,Groceries,Specialty,-11.78,GBP,-214900.76,POS,London,GB,2219,user_001,,
86ac215b-3139-40fa-967e-ab1aa6cb33b2,2033-07-12,2033-07-13,Tesco,5411,Groceries,Supermarket,-78.88,GBP,-214979.64,POS,London,GB,2219,user_001,,
a79c5e5b-5021-4b84-8a0e-933b3ce272e2,2033-07-12,2033-07-12,Waitrose,5411,Groceries,Supermarket,-86.97,GBP,-215066.61,POS,London,GB,2219,user_001,,
91d847cc-3c90-42cf-a27c-2f3c73aac678,2033-07-13,2033-07-15,City Council Tax,9399,Utilities,Council Tax,-177.95,GBP,-215244.56,Direct Debit,London,GB,2219,user_001,rec_f531495db5,
18e8f825-f861-44cb-a285-c6cb26864467,2033-07-14,2033-07-14,Tesco,5411,Groceries,Supermarket,-39.29,GBP,-215283.85,POS,London,GB,2219,user_001,,
154ea04a-2b84-4fb0-808b-95048115a3f7,2033-07-15,2033-07-18,ATM Withdrawal,6011,Cash,ATM,-106.12,GBP,-215389.97,ATM,London,GB,4488,user_001,,
15f04c6a-a3c2-4eec-8a8a-090c3f50754d,2033-07-15,2033-07-18,Pret A Manger,5814,Food & Drink,Eating Out,-7.83,GBP,-215397.8,POS,London,GB,1045,user_001,,
e1b8ed1d-74bc-447d-be27-25d046dc0fee,2033-07-15,2033-07-18,O2 UK,4814,Bills,Mobile,-36.55,GBP,-215434.35,Direct Debit,Slough,GB,1045,user_001,rec_95042d8101,
29e05230-beb6-40ca-9032-217309558bd0,2033-07-16,2033-07-18,Pret A Manger,5814,Food & Drink,Eating Out,-11.11,GBP,-215445.46,POS,London,GB,4488,user_001,,
bd2d7eef-d7df-4445-9a26-3596f2aa1d5b,2033-07-16,2033-07-18,Amazon UK,5942,Shopping,Online Retail,-89.53,GBP,-215534.99,E-Com,London,GB,2219,user_001,,
c0cedf11-25e3-44c1-9d15-198b230cc8b1,2033-07-16,2033-07-18,Amazon UK,5942,Shopping,Online Retail,-107.1,GBP,-215642.09,E-Com,London,GB,9074,user_001,,
ca232eac-51e1-4a82-b7b1-e0eeaab3525f,2033-07-16,2033-07-18,Local Market,5499,Groceries,Specialty,-17.29,GBP,-215659.38,POS,London,GB,9074,user_001,,
031c3577-5e60-4cae-93e9-dec1d596d94a,2033-07-17,2033-07-19,Waitrose,5411,Groceries,Supermarket,-47.29,GBP,-215706.67,POS,London,GB,2219,user_001,,
3fe43196-6626-47cf-8826-007c1052c438,2033-07-17,2033-07-19,Pret A Manger,5814,Food & Drink,Eating Out,-11.62,GBP,-215718.29,POS,London,GB,1045,user_001,,
7723783a-7e83-47bc-b9ba-310ec316c0c7,2033-07-17,2033-07-19,Waitrose,5411,Groceries,Supermarket,-30.93,GBP,-215749.22,POS,London,GB,9074,user_002,,
9a480cc8-5f24-4c35-b3df-c8dc98dc64e9,2033-07-17,2033-07-19,Local Market,5499,Groceries,Specialty,-21.16,GBP,-215770.38,POS,London,GB,9074,user_001,,
050df912-4978-49f4-90c7-12f40e24917d,2033-07-18,2033-07-20,GymBox,7997,Wellness,Gym,-46.66,GBP,-215817.04,Direct Debit,London,GB,4488,user_001,rec_3906953fd2,
1b60c8ad-b76f-4394-8309-df7b6b70e2ee,2033-07-18,2033-07-18,Transport for London,4111,Transport,Transit,-9.89,GBP,-215826.93,POS,London,GB,4488,user_002,,
1df88925-f1fa-4a68-baa3-d001a16b4e9b,2033-07-19,2033-07-21,Spotify,5735,Entertainment,Subscriptions,-8.61,GBP,-215835.54,E-Com,Stockholm,SE,1045,user_001,rec_4c746d2c3b,
46c5ac9d-0437-455d-b52d-a1ba2c211566,2033-07-20,2033-07-20,Transport for London,4111,Transport,Transit,-10.52,GBP,-215846.06,POS,London,GB,4488,user_001,,
6ad59297-029f-45c6-ac32-7168dad256b3,2033-07-20,2033-07-21,Uber UK,4121,Transport,Ride Hailing,-24.98,GBP,-215871.04,E-Com,London,GB,4488,user_001,,
6b803373-a30e-45c4-8ac1-6b7625729d83,2033-07-20,2033-07-22,Pret A Manger,5814,Food & Drink,Eating Out,-11.19,GBP,-215882.23,POS,London,GB,2219,user_001,,
71ab7502-3aa4-4604-a6b4-a6e427a6e634,2033-07-20,2033-07-21,Amazon UK,5942,Shopping,Online Retail,-26.67,GBP,-215908.9,E-Com,London,GB,9074,user_001,,
320442fb-5a4e-4703-a8ea-d3f7c6de6e42,2033-07-21,2033-07-25,Amazon UK,5942,Shopping,Online Retail,-52.58,GBP,-215961.48,E-Com,London,GB,1045,user_001,,
4f90ece1-1486-4684-8942-286032c32cc1,2033-07-21,2033-07-21,Sainsbury's,5411,Groceries,Supermarket,-34.13,GBP,-215995.61,POS,London,GB,9074,user_002,,
995d470b-49d4-458f-8334-ed3c63c1490a,2033-07-21,2033-07-22,Tesco,5411,Groceries,Supermarket,-28.78,GBP,-216024.39,POS,London,GB,9074,user_001,,
ae0e5449-18e1-45b3-a34d-d682bff73e56,2033-07-21,2033-07-21,Netflix,7841,Entertainment,Subscriptions,-15.12,GBP,-216039.51,E-Com,Los Gatos,US,2219,user_001,rec_1bfe33738d,
94e0a776-6b74-48cb-a16d-1d695183c4de,2033-07-22,2033-07-25,Local Market,5499,Groceries,Specialty,-13.35,GBP,-216052.86,POS,London,GB,4488,user_002,,
abf28c96-bab2-4aec-ad7e-3c3d3baa45a9,2033-07-22,2033-07-25,Transport for London,4111,Transport,Transit,-5.49,GBP,-216058.35,POS,London,GB,2219,user_001,,
a221cfcc-cd2f-4a3b-9f18-e23f83b9304e,2033-07-23,2033-07-25,Amazon UK,5942,Shopping,Online Retail,-15.14,GBP,-216073.49,E-Com,London,GB,9074,user_001,,
b15ac5cf-93bc-4ed9-a384-b63f50caba30,2033-07-23,2033-07-25,Transport for London,4111,Transport,Transit,-9.0,GBP,-216082.49,POS,London,GB,1045,user_001,,
c05be795-4393-4205-b3d3-a38cb27b99e9,2033-07-23,2033-07-25,Pret A Manger,5814,Food & Drink,Eating Out,-5.67,GBP,-216088.16,POS,London,GB,4488,user_001,,
fd7945e6-b3f8-4035-9d62-ce8aabcfe148,2033-07-23,2033-07-25,Shell,5541,Transport,Fuel,-85.51,GBP,-216173.67,POS,London,GB,9074,user_001,,
0264148b-ff15-4e89-8c0a-feb3d15a5ad8,2033-07-24,2033-07-26,Waitrose,5411,Groceries,Supermarket,-27.51,GBP,-216201.18,POS,London,GB,9074,user_001,,
6a4bc0e3-b72b-4212-bbdc-15e882ca7ddf,2033-07-24,2033-07-25,Apple.com/bill,5734,Shopping,Electronics,-170.65,USD,-216371.83,E-Com,Cupertino,US,9074,user_001,,FX purchase 224.9 USD @ rate 1.32
8fd67e4c-08d8-4f00-a122-22ba39353a40,2033-07-24,2033-07-26,Uber UK,4121,Transport,Ride Hailing,-17.48,GBP,-216389.31,E-Com,London,GB,2219,user_001,,
e86f0e32-ad4e-4724-b27b-721e094057ff,2033-07-24,2033-07-25,Transport for London,4111,Transport,Transit,-10.45,GBP,-216399.76,POS,London,GB,9074,user_001,,
f2d13317-1041-4ce1-b2c1-49526f11105d,2033-07-24,2033-07-26,Pret A Manger,5814,Food & Drink,Eating Out,-8.96,GBP,-216408.72,POS,London,GB,1045,user_002,,
3708ebc3-8abb-45c1-92e5-67ec8afec41c,2033-07-25,2033-07-25,T212 Capital,6011,Income,Salary,3406.81,GBP,-213001.91,Credit,London,GB,4488,user_002,rec_c649d24d0f,
056f62cd-78bf-4a9c-94f2-e6d16acb6519,2033-07-26,2033-07-28,Transport for London,4111,Transport,Transit,-8.8,GBP,-213010.71,POS,London,GB,4488,user_002,,
569a8dd5-37d5-4f6e-a878-e7ece61211a9,2033-07-26,2033-07-26,Pret A Manger,5814,Food & Drink,Eating Out,-8.22,GBP,-213018.93,POS,London,GB,2219,user_001,,
dea06667-b5bb-4dbb-bb24-2096ed0388c4,2033-07-26,2033-07-28,Amazon UK,5942,Shopping,Online Retail,-80.06,GBP,-213098.99,E-Com,London,GB,9074,user_001,,
b001174b-969b-46a4-af71-13f260ed5755,2033-07-27,2033-07-27,Deliveroo,5812,Food & Drink,Delivery,-28.54,GBP,-213127.53,E-Com,London,GB,9074,user_002,,
c501f535-459e-41dd-a5b4-9edd9c9f936d,2033-07-27,2033-07-27,Deliveroo,5812,Food & Drink,Delivery,-16.96,GBP,-213144.49,E-Com,London,GB,2219,user_001,,
56652a7b-5ee7-4f91-8253-3f0be1959a39,2033-07-28,2033-08-01,Uber UK,4121,Transport,Ride Hailing,-28.1,GBP,-213172.59,E-Com,London,GB,1045,user_001,,
94803925-8c63-4ddb-84f8-e8d6bc3aa941,2033-07-29,2033-08-01,Uber UK,4121,Transport,Ride Hailing,-30.22,GBP,-213202.81,E-Com,London,GB,9074,user_001,,
974a2274-ce8f-4e65-96db-fca6391ba7ae,2033-07-29,2033-07-29,Pret A Manger,5814,Food & Drink,Eating Out,-10.6,GBP,-213213.41,POS,London,GB,4488,user_002,,
868146dc-9c2c-42a9-a722-030bb17aaa29,2033-07-30,2033-08-01,Shell,5541,Transport,Fuel,-90.1,GBP,-213303.51,POS,London,GB,4488,user_001,,
dc79c20c-0cbc-44bd-b86a-171adc4e5fb8,2033-07-30,2033-08-01,Local Market,5499,Groceries,Specialty,-11.38,GBP,-213314.89,POS,London,GB,1045,user_001,,
ec6009e9-6842-433d-b823-f2d7dbf991be,2033-07-30,2033-08-01,Deliveroo,5812,Food & Drink,Delivery,-26.3,GBP,-213341.19,E-Com,London,GB,2219,user_001,,
0c80b1bd-b0ee-4acc-856d-8c8d4c445617,2033-07-31,2033-08-01,Apple.com/bill,5734,Shopping,Electronics,-38.13,GBP,-213379.32,E-Com,Cupertino,US,9074,user_001,,
608bfe34-d211-4024-a21e-2ed8d601ed5a,2033-07-31,2033-08-01,Airline Refund,4511,Travel,Refund,13.08,GBP,-213366.24,Credit,London,GB,1045,user_001,,Refund for Netflix
e6459ad6-0e4c-497c-be4f-2e969d010ac4,2033-07-31,2033-08-01,Local Market,5499,Groceries,Specialty,-12.78,GBP,-213379.02,POS,London,GB,1045,user_002,,
8499bbda-082f-4536-93f6-3e47f98efcfb,2033-08-01,2033-08-03,Transport for London,4111,Transport,Transit,-7.36,GBP,-213386.38,POS,London,GB,2219,user_001,,
8fdb99b5-58fb-4278-9555-d11d9ea2ae02,2033-08-01,2033-08-01,Crown Estates Lettings,6513,Housing,Rent,-1517.49,GBP,-214903.87,POS,London,GB,4488,user_001,rec_19f70fbcce,
cd2d75e2-93f7-470f-a898-cc5b396e73cb,2033-08-01,2033-08-01,Amazon UK,5942,Shopping,Online Retail,-90.91,GBP,-214994.78,E-Com,London,GB,4488,user_001,,
1b6ff822-054e-401f-8c30-859b80b3e959,2033-08-02,2033-08-02,Deliveroo,5812,Food & Drink,Delivery,-32.75,GBP,-215027.53,E-Com,London,GB,2219,user_001,,
24b87da6-463e-463b-a1aa-ba92f46f5edc,2033-08-02,2033-08-02,Waitrose,5411,Groceries,Supermarket,-45.81,GBP,-215073.34,POS,London,GB,2219,user_002,,
d935bbdd-8c8d-468a-8046-2134088b0801,2033-08-02,2033-08-03,Amazon UK,5942,Shopping,Online Retail,-41.43,GBP,-215114.77,E-Com,London,GB,1045,user_001,,
09f5e5ca-d78b-410b-979d-9ba0b86eacb0,2033-08-03,2033-08-04,Local Market,5499,Groceries,Specialty,-13.81,GBP,-215128.58,POS,London,GB,9074,user_001,,
5754b9c0-6242-48b0-88fc-15b4200c2278,2033-08-03,2033-08-05,Local Market,5499,Groceries,Specialty,-15.99,GBP,-215144.57,POS,London,GB,4488,user_001,,
807a284e-d489-47ed-aaa0-35f0b2d6f3f1,2033-08-03,2033-08-05,Apple.com/bill,5734,Shopping,Electronics,-87.79,GBP,-215232.36,E-Com,Cupertino,US,2219,user_001,,
1f66a91e-1e31-48b2-a08d-d128343337c2,2033-08-04,2033-08-08,Uber UK,4121,Transport,Ride Hailing,-32.17,GBP,-215264.53,E-Com,London,GB,9074,user_001,,
613102fa-0474-4544-94f6-ae1553baeb50,2033-08-04,2033-08-08,Deliveroo,5812,Food & Drink,Delivery,-16.83,GBP,-215281.36,E-Com,London,GB,1045,user_002,,
a3bf0da5-dfd5-40db-83d3-5f14e47178fa,2033-08-06,2033-08-08,Pret A Manger,5814,Food & Drink,Eating Out,-11.73,GBP,-215293.09,POS,London,GB,1045,user_001,,
831f5d2e-27e2-4bb5-be06-db0fdd39ace6,2033-08-07,2033-08-09,Pret A Manger,5814,Food & Drink,Eating Out,-9.13,GBP,-215302.22,POS,London,GB,1045,user_001,,
8afec4eb-053d-4450-ae3a-6c853c6b7e02,2033-08-07,2033-08-09,Tesco,5411,Groceries,Supermarket,-69.02,GBP,-215371.24,POS,London,GB,2219,user_001,,
dad5e7bf-6b92-48b8-98dd-99b8026a1f76,2033-08-07,2033-08-08,Pret A Manger,5814,Food & Drink,Eating Out,-9.87,GBP,-215381.11,POS,London,GB,4488,user_002,,
8e4e4038-63bc-43d2-bbc5-cc132cf6f685,2033-08-08,2033-08-08,Tesco,5411,Groceries,Supermarket,-28.11,GBP,-215409.22,POS,London,GB,9074,user_001,,
c943ced9-b2ec-483d-a2ff-cb409dc683ce,2033-08-08,2033-08-09,Apple.com/bill,5734,Shopping,Electronics,-129.42,GBP,-215538.64,E-Com,Cupertino,US,4488,user_001,,
c9dee07a-d5bb-40e7-851c-3080b01a5f7c,2033-08-08,2033-08-10,Octopus Energy,4900,Utilities,Electricity,-125.24,GBP,-215663.88,Direct Debit,London,GB,2219,user_001,rec_141a4a0666,
0f1bf7fa-50ee-45f9-bf7f-bb5e90999bd5,2033-08-09,2033-08-11,Local Market,5499,Groceries,Specialty,-21.7,GBP,-215685.58,POS,London,GB,1045,user_001,,
25a59091-0118-436c-a9b8-2c01701ea18d,2033-08-09,2033-08-11,Shell,5541,Transport,Fuel,-46.45,GBP,-215732.03,POS,London,GB,2219,user_001,,
1efa80e1-0bbc-4c73-bb50-6f97451f1ccf,2033-08-10,2033-08-11,Shell,5541,Transport,Fuel,-47.24,GBP,-215779.27,POS,London,GB,9074,user_001,,
79bb9e79-6154-4f40-87f4-1f2ebbe6b503,2033-08-10,2033-08-11,Shell,5541,Transport,Fuel,-45.02,GBP,-215824.29,POS,London,GB,4488,user_001,,
c64239a2-872f-4a48-8f26-3dca556785f8,2033-08-10,2033-08-10,Amazon UK,5942,Shopping,Online Retail,-45.39,GBP,-215869.68,E-Com,London,GB,9074,user_001,,
0b95183c-e06e-4154-b842-84470490f702,2033-08-11,2033-08-11,Shell,5541,Transport,Fuel,-36.88,GBP,-215906.56,POS,London,GB,2219,user_001,,
9207b729-74c7-40a6-b98f-c28ef30fd22b,2033-08-11,2033-08-12,Thames Water,4900,Utilities,Water,-43.09,GBP,-215949.65,Direct Debit,Reading,GB,9074,user_001,rec_3a34d62842,
b713de58-af05-4785-ab23-a5ed24b9c4b6,2033-08-11,2033-08-12,ATM Withdrawal,6011,Cash,ATM,-112.34,GBP,-216061.99,ATM,London,GB,4488,user_001,,
25a96434-df35-415f-a949-d30ba48a12ec,2033-08-12,2033-08-15,Apple.com/bill,5734,Shopping,Electronics,-168.21,USD,-216230.2,E-Com,Cupertino,US,1045,user_001,,FX purchase 211.79 USD @ rate 1.26
06165e1f-f729-42a8-ba90-9bcde2229234,2033-08-13,2033-08-15,Local Market,5499,Groceries,Specialty,-15.82,GBP,-216246.02,POS,London,GB,1045,user_001,,
5b08594b-aa6c-4c3c-8744-8d3c5a16a08e,2033-08-13,2033-08-15,Deliveroo,5812,Food & Drink,Delivery,-27.89,GBP,-216273.91,E-Com,London,GB,9074,user_001,,
839ae1ce-23e8-4e25-bf12-6159f74a39b0,2033-08-13,2033-08-15,Transport for London,4111,Transport,Transit,-8.29,GBP,-216282.2,POS,London,GB,2219,user_001,,
cd3e1d23-feea-462c-81fc-870ec8a5a7d5,2033-08-13,2033-08-15,Tesco,5411,Groceries,Supermarket,-45.45,GBP,-216327.65,POS,London,GB,4488,user_001,,
d45c8dd7-0fce-4d7a-9472-a2a5249bd21f,2033-08-13,2033-08-15,Uber UK,4121,Transport,Ride Hailing,-13.38,GBP,-216341.03,E-Com,London,GB,1045,user_001,,
dc957fca-bdad-4d50-a266-7995a0d61958,2033-08-13,2033-08-15,Waitrose,5411,Groceries,Supermarket,-28.44,GBP,-216369.47,POS,London,GB,2219,user_001,,
155d815f-8f9e-45f8-93d8-69e10d09f56e,2033-08-14,2033-08-15,Waitrose,5411,Groceries,Supermarket,-56.69,GBP,-216426.16,POS,London,GB,4488,user_001,,
2a40a968-ef52-4e36-983f-6bbaad13fb4b,2033-08-14,2033-08-16,Apple.com/bill,5734,Shopping,Electronics,-137.12,GBP,-216563.28,E-Com,Cupertino,US,1045,user_001,,
3ec18e08-aa2a-4e81-bfda-ddcb9ca15f88,2033-08-14,2033-08-15,Uber UK,4121,Transport,Ride Hailing,-35.71,GBP,-216598.99,E-Com,London,GB,4488,user_001,,
6c2c7b25-4171-41b8-bd45-2d8da562141d,2033-08-14,2033-08-15,Apple.com/bill,5734,Shopping,Electronics,-54.68,USD,-216653.67,E-Com,Cupertino,US,4488,user_002,,FX purchase 67.78 USD @ rate 1.24
8a53f833-3d28-448c-8f44-0075b6bab2e2,2033-08-14,2033-08-15,Amazon UK,5942,Shopping,Online Retail,-92.06,GBP,-216745.73,E-Com,London,GB,2219,user_001,,
ed7fc35f-5b11-4548-9520-6453e1dc0384,2033-08-14,2033-08-15,Tesco,5411,Groceries,Supermarket,-83.71,GBP,-216829.44,POS,London,GB,1045,user_002,,
f4549a43-93e7-4282-b329-9138f1711e35,2033-08-14,2033-08-15,Shell,5541,Transport,Fuel,-90.1,GBP,-216919.54,POS,London,GB,9074,user_001,,
022ee77b-511c-499d-8b18-c82e9e71a5fb,2033-08-15,2033-08-17,City Council Tax,9399,Utilities,Council Tax,-160.68,GBP,-217080.22,Direct Debit,London,GB,4488,user_002,rec_6feaa5d43f,
2050a965-5a5e-4bb9-be25-00d21279114c,2033-08-15,2033-08-15,Amazon UK,5942,Shopping,Online Retail,-67.03,GBP,-217147.25,E-Com,London,GB,9074,user_001,,
2ad3c47d-e9cb-4461-971c-f36bafaaf824,2033-08-15,2033-08-17,O2 UK,4814,Bills,Mobile,-43.0,GBP,-217190.25,Direct Debit,Slough,GB,1045,user_001,rec_95042d8101,
35301bef-99a0-46d5-b0cb-a6db50e1b4d9,2033-08-15,2033-08-16,Uber UK,4121,Transport,Ride Hailing,-18.03,GBP,-217208.28,E-Com,London,GB,4488,user_001,,
3bed0c10-cf5e-4dae-b438-fd4a200be223,2033-08-16,2033-08-18,Local Market,5499,Groceries,Specialty,-11.81,GBP,-217220.09,POS,London,GB,9074,user_002,,
988934ba-136f-417b-9648-a82dcd8fdd91,2033-08-17,2033-08-17,GymBox,7997,Wellness,Gym,-48.23,GBP,-217268.32,Direct Debit,London,GB,4488,user_001,rec_3906953fd2,
eced41ec-fa88-4b8e-9450-f6add73ee8f1,2033-08-17,2033-08-18,Deliveroo,5812,Food & Drink,Delivery,-33.42,GBP,-217301.74,E-Com,London,GB,4488,user_001,,
00f3d0ce-e6d8-4b7c-8468-ff415153b76b,2033-08-18,2033-08-19,Shell,5541,Transport,Fuel,-57.75,GBP,-217359.49,POS,London,GB,2219,user_001,,
0efcdc54-14cf-49dc-951d-6a92d7783103,2033-08-18,2033-08-18,Shell,5541,Transport,Fuel,-76.21,GBP,-217435.7,POS,London,GB,1045,user_001,,
5b5cb443-541e-44bc-8709-0f2420198db3,2033-08-18,2033-08-22,Tesco,5411,Groceries,Supermarket,-78.8,GBP,-217514.5,POS,London,GB,9074,user_001,,
88a622a6-9aba-4e42-89ee-3449465bcbb2,2033-08-19,2033-08-22,Tesco,5411,Groceries,Supermarket,-74.6,GBP,-217589.1,POS,London,GB,9074,user_001,,
d0ad0806-023e-4a49-9903-312dfaadeeb2,2033-08-19,2033-08-22,Deliveroo,5812,Food & Drink,Delivery,-21.36,GBP,-217610.46,E-Com,London,GB,2219,user_001,,
d18b2fae-b7b1-432f-a4bd-1cc8d6c86e7b,2033-08-19,2033-08-22,Spotify,5735,Entertainment,Subscriptions,-9.4,EUR,-217619.86,E-Com,Stockholm,SE,2219,user_001,rec_4c746d2c3b,FX purchase 10.8 EUR @ rate 1.15
54aef9ff-5500-4fce-9214-26dc257d1c0e,2033-08-20,2033-08-22,Amazon UK,5942,Shopping,Online Retail,-12.3,GBP,-217632.16,E-Com,London,GB,9074,user_002,,
8c4b48a6-be9a-416e-9b90-7aa6d3b72173,2033-08-20,2033-08-22,Pret A Manger,5814,Food & Drink,Eating Out,-8.15,GBP,-217640.31,POS,London,GB,1045,user_001,,
6254e989-620e-4c40-964c-477d250c19c2,2033-08-21,2033-08-23,Pret A Manger,5814,Food & Drink,Eating Out,-9.0,GBP,-217649.31,POS,London,GB,9074,user_002,,
3d0c709e-8bae-44aa-b98f-887dd1e2cc17,2033-08-22,2033-08-22,Netflix,7841,Entertainment,Subscriptions,-13.5,GBP,-217662.81,E-Com,Los Gatos,US,4488,user_001,rec_1bfe33738d,
c68bee80-4548-408d-b797-3017f4b61e84,2033-08-22,2033-08-24,Amazon UK,5942,Shopping,Online Retail,-52.31,GBP,-217715.12,E-Com,London,GB,2219,user_001,,
022922c0-8dbe-413d-9f74-7ef7e7f332b6,2033-08-23,2033-08-24,Deliveroo,5812,Food & Drink,Delivery,-24.18,GBP,-217739.3,E-Com,London,GB,2219,user_001,,
c655a005-1388-4d1b-9043-f8690209f0a5,2033-08-23,2033-08-23,Transport for London,4111,Transport,Transit,-7.88,GBP,-217747.18,POS,London,GB,4488,user_001,,
34ad3199-1f6d-402e-9014-87e01b5a9585,2033-08-24,2033-08-24,Pret A Manger,5814,Food & Drink,Eating Out,-5.55,GBP,-217752.73,POS,London,GB,4488,user_001,,
4c1dd52a-1684-456f-a1cc-26c0635dc808,2033-08-24,2033-08-25,Uber UK,4121,Transport,Ride Hailing,-9.71,GBP,-217762.44,E-Com,London,GB,1045,user_001,,
4f140f40-a410-4688-8cfa-7a4bbb14399a,2033-08-24,2033-08-26,Local Market,5499,Groceries,Specialty,-17.53,GBP,-217779.97,POS,London,GB,4488,user_001,,
63ebc73e-c327-4d70-bece-aacadfa0f522,2033-08-24,2033-08-26,Uber UK,4121,Transport,Ride Hailing,-28.86,GBP,-217808.83,E-Com,London,GB,9074,user_001,,
6ffe8c56-e367-4c92-b4de-6b078da4dd89,2033-08-25,2033-08-25,Amazon UK,5942,Shopping,Online Retail,-38.23,GBP,-217847.06,E-Com,London,GB,1045,user_001,,
8fde2863-38dc-4f87-ac8c-bcdcb32c7411,2033-08-25,2033-08-29,Shell,5541,Transport,Fuel,-53.47,GBP,-217900.53,POS,London,GB,4488,user_001,,
90c3be78-2908-401d-8ff2-720790947b0f,2033-08-25,2033-08-25,T212 Capital,6011,Income,Salary,3023.05,GBP,-214877.48,Credit,London,GB,1045,user_001,rec_2ff8f778d0,
15d21b65-2d2c-4ab4-bfab-52cdab4dfd1c,2033-08-27,2033-08-29,Waitrose,5411,Groceries,Supermarket,-40.59,GBP,-214918.07,POS,London,GB,4488,user_002,,
190122f4-75e6-4ee7-9493-ed5216e8c63b,2033-08-27,2033-08-29,Apple.com/bill,5734,Shopping,Electronics,-149.81,GBP,-215067.88,E-Com,Cupertino,US,9074,user_002,,
a8e1ba88-b18e-4abb-bf01-38e69eb97de0,2033-08-27,2033-08-29,Waitrose,5411,Groceries,Supermarket,-48.56,GBP,-215116.44,POS,London,GB,1045,user_001,,
b06cfbec-ab9a-4a97-90eb-4b6230f10dcc,2033-08-27,2033-08-29,Waitrose,5411,Groceries,Supermarket,-70.02,GBP,-215186.46,POS,London,GB,1045,user_001,,
bf78b86f-6a46-4ec3-ae19-85c7875e1adf,2033-08-27,2033-08-29,Deliveroo,5812,Food & Drink,Delivery,-32.79,GBP,-215219.25,E-Com,London,GB,1045,user_001,,
41e0a08c-688b-4678-98ce-28a477893854,2033-08-28,2033-08-29,Pret A Manger,5814,Food & Drink,Eating Out,-9.44,GBP,-215228.69,POS,London,GB,1045,user_001,,
848fec9e-2ea8-4842-af80-3e0f9f5b690a,2033-08-28,2033-08-30,Pret A Manger,5814,Food & Drink,Eating Out,-10.42,GBP,-215239.11,POS,London,GB,9074,user_001,,
e8be081a-5722-4efd-8d6a-6e66352604f1,2033-08-29,2033-08-30,ATM Withdrawal,6011,Cash,ATM,-71.13,GBP,-215310.24,ATM,London,GB,1045,user_001,,
c7ce4a70-5738-46db-808d-4814e3de86bf,2033-08-30,2033-08-31,Tesco,5411,Groceries,Supermarket,-55.78,GBP,-215366.02,POS,London,GB,4488,user_001,,
145dc785-c282-475d-b10c-9a778810c55c,2033-09-01,2033-09-01,Deliveroo,5812,Food & Drink,Delivery,-21.67,GBP,-215387.69,E-Com,London,GB,1045,user_001,,
6cc9ee35-487f-441e-84c4-9ecbdfc1f123,2033-09-01,2033-09-01,Pret A Manger,5814,Food & Drink,Eating Out,-9.42,GBP,-215397.11,POS,London,GB,9074,user_001,,
75613f86-c146-4366-84d6-b261d5d634cb,2033-09-01,2033-09-05,Crown Estates Lettings,6513,Housing,Rent,-1484.5,GBP,-216881.61,POS,London,GB,9074,user_002,rec_fc2ae06846,
9d9cbb0f-cf75-4ad3-b2e3-2f24817eb51e,2033-09-02,2033-09-05,Transport for London,4111,Transport,Transit,-4.82,GBP,-216886.43,POS,London,GB,9074,user_001,,
0e319ec0-2669-464d-8af3-e0c320823d47,2033-09-03,2033-09-05,Shell,5541,Transport,Fuel,-94.84,GBP,-216981.27,POS,London,GB,4488,user_001,,
499fe7e6-ac13-4a13-b82e-c6517f216565,2033-09-03,2033-09-05,Waitrose,5411,Groceries,Supermarket,-75.74,GBP,-217057.01,POS,London,GB,9074,user_001,,
cc964999-7a1d-408b-91a6-874011bd5c02,2033-09-03,2033-09-05,Deliveroo,5812,Food & Drink,Delivery,-19.96,GBP,-217076.97,E-Com,London,GB,4488,user_001,,
cff2dcc5-1092-430b-9f0f-b1842221e7b9,2033-09-04,2033-09-05,Transport for London,4111,Transport,Transit,-11.57,GBP,-217088.54,POS,London,GB,2219,user_001,,
ea5e654e-70df-48ba-94c4-f37cbd5a718a,2033-09-04,2033-09-05,Tesco,5411,Groceries,Supermarket,-56.42,GBP,-217144.96,POS,London,GB,1045,user_001,,
69c2f9c5-37ee-4cf4-880a-1d1919c53175,2033-09-06,2033-09-07,Waitrose,5411,Groceries,Supermarket,-22.11,GBP,-217167.07,POS,London,GB,2219,user_001,,
ad504524-15e1-4689-a465-ea4c2d320fce,2033-09-06,2033-09-08,Local Market,5499,Groceries,Specialty,-7.76,GBP,-217174.83,POS,London,GB,2219,user_002,,
250b0776-28ab-45a0-8c81-705b36549c63,2033-09-07,2033-09-07,HM Revenue & Customs,9311,Income,Tax Refund,11.18,GBP,-217163.65,Credit,London,GB,1045,user_001,,Refund for Deliveroo
2aca10ce-0af2-4145-8512-ffa96580876a,2033-09-07,2033-09-08,Apple.com/bill,5734,Shopping,Electronics,-139.12,GBP,-217302.77,E-Com,Cupertino,US,1045,user_001,,
a6184741-97c5-4a89-b492-80c5e2d2d851,2033-09-07,2033-09-07,Octopus Energy,4900,Utilities,Electricity,-119.24,GBP,-217422.01,Direct Debit,London,GB,2219,user_001,rec_141a4a0666,
28cf8755-d43e-46c7-b3bf-afc06f52c379,2033-09-08,2033-09-12,Shell,5541,Transport,Fuel,-94.49,GBP,-217516.5,POS,London,GB,9074,user_001,,
adc5c398-c938-446c-a93d-f30c57a8414b,2033-09-08,2033-09-12,Pret A Manger,5814,Food & Drink,Eating Out,-7.61,GBP,-217524.11,POS,London,GB,2219,user_001,,
e952bada-ab0c-4107-b2f6-69a4b4f824cf,2033-09-09,2033-09-12,Tesco,5411,Groceries,Supermarket,-75.2,GBP,-217599.31,POS,London,GB,9074,user_001,,
b23da412-34d7-4e98-a13f-91a773d05c7d,2033-09-10,2033-09-12,Tesco,5411,Groceries,Supermarket,-53.3,GBP,-217652.61,POS,London,GB,1045,user_001,,
dd8c3a16-d8b1-47bc-a739-23b0d33098f7,2033-09-10,2033-09-12,Pret A Manger,5814,Food & Drink,Eating Out,-6.64,GBP,-217659.25,POS,London,GB,4488,user_001,,
078c41af-b9bd-4dd5-9787-c59e0cf9bfd8,2033-09-11,2033-09-13,Waitrose,5411,Groceries,Supermarket,-22.84,GBP,-217682.09,POS,London,GB,2219,user_001,,
199765fc-4de0-4d46-b53b-c196910c9945,2033-09-11,2033-09-12,Uber UK,4121,Transport,Ride Hailing,-21.33,GBP,-217703.42,E-Com,London,GB,2219,user_001,,
59dd7c8e-3139-4d99-b6d9-87950b3fe0c3,2033-09-11,2033-09-12,Apple.com/bill,5734,Shopping,Electronics,-201.65,GBP,-217905.07,E-Com,Cupertino,US,4488,user_001,,
9333fa23-1d15-497d-8fea-49259d793f66,2033-09-11,2033-09-12,Waitrose,5411,Groceries,Supermarket,-54.29,GBP,-217959.36,POS,London,GB,2219,user_001,,
9ed6fd53-5a4e-4c98-a85f-d6c86c69f9af,2033-09-11,2033-09-12,Uber UK,4121,Transport,Ride Hailing,-14.08,GBP,-217973.44,E-Com,London,GB,2219,user_001,,
af1c339f-44bf-4358-b492-024347428fcb,2033-09-11,2033-09-12,HM Revenue & Customs,9311,Income,Tax Refund,50.46,GBP,-217922.98,Credit,London,GB,9074,user_001,,Refund for ATM Withdrawal
bdfb7673-c94e-4d13-adba-a983eaa16897,2033-09-11,2033-09-12,Pret A Manger,5814,Food & Drink,Eating Out,-9.7,GBP,-217932.68,POS,London,GB,1045,user_001,,
fc64d850-358c-4bb8-8566-26b11e9da3e3,2033-09-11,2033-09-12,Transport for London,4111,Transport,Transit,-7.45,GBP,-217940.13,POS,London,GB,1045,user_001,,
b6a8f369-6159-4312-a58f-319a271cf3d9,2033-09-12,2033-09-14,Thames Water,4900,Utilities,Water,-38.34,GBP,-217978.47,Direct Debit,Reading,GB,2219,user_001,rec_3a34d62842,
e7065503-ffd3-4a71-bd4a-5753715e5a4d,2033-09-12,2033-09-14,Waitrose,5411,Groceries,Supermarket,-81.28,GBP,-218059.75,POS,London,GB,9074,user_001,,
ff5a2b66-0153-4cfc-ab55-c7e25a006c44,2033-09-12,2033-09-14,Shell,5541,Transport,Fuel,-39.83,GBP,-218099.58,POS,London,GB,4488,user_001,,
7676f4ec-0a29-420e-925d-6700d1888893,2033-09-13,2033-09-15,City Council Tax,9399,Utilities,Council Tax,-161.38,GBP,-218260.96,Direct Debit,London,GB,4488,user_001,rec_f531495db5,
be8f9f1b-a005-45a8-8516-d0c11c15b82b,2033-09-13,2033-09-14,Local Market,5499,Groceries,Specialty,-17.13,GBP,-218278.09,POS,London,GB,1045,user_002,,
1c5ac400-174c-42a3-9ac7-c545e25bc401,2033-09-14,2033-09-16,Waitrose,5411,Groceries,Supermarket,-25.4,GBP,-218303.49,POS,London,GB,9074,user_001,,
4bbd08ef-5abb-4c6f-9353-007c44b50498,2033-09-14,2033-09-16,Shell,5541,Transport,Fuel,-47.08,GBP,-218350.57,POS,London,GB,1045,user_001,,
5175a8f3-bb35-48f1-87c5-3b955e883654,2033-09-14,2033-09-16,Shell,5541,Transport,Fuel,-34.13,GBP,-218384.7,POS,London,GB,2219,user_001,,
58a90883-9c7a-4c1e-aad7-242b08a50948,2033-09-14,2033-09-16,Tesco,5411,Groceries,Supermarket,-28.47,GBP,-218413.17,POS,London,GB,4488,user_001,,
dd1c66d2-024a-4f96-b39c-245e502604e2,2033-09-14,2033-09-16,Local Market,5499,Groceries,Specialty,-18.61,GBP,-218431.78,POS,London,GB,2219,user_001,,
eca605ea-9d08-4141-9492-180604861bf5,2033-09-14,2033-09-15,Deliveroo,5812,Food & Drink,Delivery,-22.93,GBP,-218454.71,E-Com,London,GB,1045,user_001,,
6466ea9f-6797-45d8-87dc-fbb00b5f0610,2033-09-15,2033-09-19,Transport for London,4111,Transport,Transit,-10.46,GBP,-218465.17,POS,London,GB,2219,user_001,,
790d1fe5-6d0a-43e8-bd41-85d217004b22,2033-09-15,2033-09-19,O2 UK,4814,Bills,Mobile,-37.99,GBP,-218503.16,Direct Debit,Slough,GB,1045,user_001,rec_95042d8101,
1d8a3911-e03f-487f-a815-5fdc55ab1595,2033-09-16,2033-09-19,Transport for London,4111,Transport,Transit,-7.77,GBP,-218510.93,POS,London,GB,1045,user_001,,
217a8dcf-3ac3-4711-bac9-d69d0f4bf7bc,2033-09-16,2033-09-19,Pret A Manger,5814,Food & Drink,Eating Out,-8.04,GBP,-218518.97,POS,London,GB,4488,user_001,,
b96aebcd-b880-49f3-93f8-e2decd39a1a5,2033-09-16,2033-09-16,Tesco,5411,Groceries,Supermarket,-31.43,GBP,-218550.4,POS,London,GB,9074,user_001,,
c55fcae9-59d9-498e-ae47-859082b39254,2033-09-16,2033-09-16,Deliveroo,5812,Food & Drink,Delivery,-29.34,GBP,-218579.74,E-Com,London,GB,1045,user_002,,
4612c94e-131a-4833-b3d4-0bf608bec211,2033-09-17,2033-09-19,Shell,5541,Transport,Fuel,-63.26,GBP,-218643.0,POS,London,GB,9074,user_001,,
528f5520-00ee-4b96-99b7-34aaea3def3e,2033-09-17,2033-09-19,Tesco,5411,Groceries,Supermarket,-65.93,GBP,-218708.93,POS,London,GB,1045,user_002,,
05df2698-d316-4289-b3b0-1cd23efb1602,2033-09-18,2033-09-19,Local Market,5499,Groceries,Specialty,-7.75,GBP,-218716.68,POS,London,GB,4488,user_001,,
21410d0b-99fe-4359-8a33-7c63d8c94f8c,2033-09-18,2033-09-20,Waitrose,5411,Groceries,Supermarket,-30.42,GBP,-218747.1,POS,London,GB,9074,user_001,,
846c69ed-5be4-4cb7-a0b9-4b72fc5c917f,2033-09-18,2033-09-19,Uber UK,4121,Transport,Ride Hailing,-29.41,GBP,-218776.51,E-Com,London,GB,1045,user_001,,
1d752962-fc6b-4851-ade3-76ee387d7cfc,2033-09-19,2033-09-19,GymBox,7997,Wellness,Gym,-62.39,GBP,-218838.9,Direct Debit,London,GB,9074,user_001,rec_3906953fd2,
514211e3-cacc-4766-9243-0f97fd528d47,2033-09-19,2033-09-20,Pret A Manger,5814,Food & Drink,Eating Out,-9.79,GBP,-218848.69,POS,London,GB,4488,user_001,,
8b1f3546-3120-48ca-82f1-189306f5700c,2033-09-19,2033-09-19,Apple.com/bill,5734,Shopping,Electronics,-161.76,GBP,-219010.45,E-Com,Cupertino,US,2219,user_001,,
bb89d703-fb16-4d83-9d07-f726aa253381,2033-09-19,2033-09-21,Spotify,5735,Entertainment,Subscriptions,-8.33,GBP,-219018.78,E-Com,Stockholm,SE,2219,user_001,rec_4c746d2c3b,
d499c354-7dd9-48a0-9a5b-9c5c27f3c59a,2033-09-19,2033-09-21,Amazon UK,5942,Shopping,Online Retail,-23.42,GBP,-219042.2,E-Com,London,GB,4488,user_001,,
cb4ef8b2-dfc0-49c3-80be-ecb8e81d36e8,2033-09-20,2033-09-22,Deliveroo,5812,Food & Drink,Delivery,-24.41,GBP,-219066.61,E-Com,London,GB,4488,user_001,,
f8abf82e-4bf8-45d8-a19e-0e23a657187c,2033-09-20,2033-09-22,Amazon UK,5942,Shopping,Online Retail,-41.69,GBP,-219108.3,E-Com,London,GB,4488,user_001,,
9e024b3f-bbe2-4cda-806c-6dc57e3bb6b5,2033-09-21,2033-09-21,Netflix,7841,Entertainment,Subscriptions,-11.63,GBP,-219119.93,E-Com,Los Gatos,US,2219,user_001,rec_1bfe33738d,
0c745e6f-6041-4ef9-9162-97c33a289f15,2033-09-22,2033-09-22,Uber UK,4121,Transport,Ride Hailing,-12.86,GBP,-219132.79,E-Com,London,GB,2219,user_001,,
554ee126-ac1e-406f-afb6-9073c5561bcf,2033-09-22,2033-09-23,Apple.com/bill,5734,Shopping,Electronics,-193.95,GBP,-219326.74,E-Com,Cupertino,US,9074,user_001,,
00dbbebe-9da8-4ce0-83bd-7c8f6a42958e,2033-09-23,2033-09-26,Local Market,5499,Groceries,Specialty,-7.69,GBP,-219334.43,POS,London,GB,9074,user_001,,
0a6c732c-1a25-4798-b8d0-835f86ea197a,2033-09-23,2033-09-23,T212 Capital,6011,Income,Salary,2869.09,GBP,-216465.34,Credit,London,GB,9074,user_001,rec_2ff8f778d0,
df24fb04-a9cc-4e70-83c8-3dda806ad9ba,2033-09-23,2033-09-26,Local Market,5499,Groceries,Specialty,-11.42,GBP,-216476.76,POS,London,GB,1045,user_001,,
507dd835-2ba1-41e7-bbf5-b05d9640391c,2033-09-24,2033-09-26,Deliveroo,5812,Food & Drink,Delivery,-26.86,GBP,-216503.62,E-Com,London,GB,9074,user_001,,
946edac8-d00f-4eb4-bb5e-a91c0cdaf1c3,2033-09-24,2033-09-26,Amazon UK,5942,Shopping,Online Retail,-75.89,GBP,-216579.51,E-Com,London,GB,1045,user_001,,
ba75b984-8953-4421-8da3-ea29ed15d7af,2033-09-24,2033-09-26,Amazon UK,5942,Shopping,Online Retail,-12.01,GBP,-216591.52,E-Com,London,GB,9074,user_002,,
24ba1d59-0c1b-4951-9b08-5ddf97c07533,2033-09-25,2033-09-26,Amazon UK,5942,Shopping,Online Retail,-42.13,GBP,-216633.65,E-Com,London,GB,9074,user_001,,
52c07f98-4572-4007-b6b4-ed26552c6e69,2033-09-25,2033-09-26,Local Market,5499,Groceries,Specialty,-9.84,GBP,-216643.49,POS,London,GB,1045,user_001,,
b780601b-9fcf-4154-9e77-02d4a19dcf74,2033-09-25,2033-09-26,Tesco,5411,Groceries,Supermarket,-53.68,GBP,-216697.17,POS,London,GB,9074,user_001,,
dab6ec38-5cf5-4d20-88e5-d604f073f30a,2033-09-25,2033-09-26,Amazon UK,5942,Shopping,Online Retail,-67.79,GBP,-216764.96,E-Com,London,GB,4488,user_002,,
8a6e738c-7a42-475a-9a00-080f9484bab7,2033-09-26,2033-09-26,Amazon UK,5942,Shopping,Online Retail,-72.74,GBP,-216837.7,E-Com,London,GB,4488,user_001,,
a9e5ed80-b275-4852-87e1-bb84cff48ad8,2033-09-26,2033-09-28,Transport for London,4111,Transport,Transit,-10.88,GBP,-216848.58,POS,London,GB,9074,user_001,,
2de17d14-ee4b-4c1e-bb9c-2b7d8c6a8003,2033-09-27,2033-09-29,Waitrose,5411,Groceries,Supermarket,-46.82,GBP,-216895.4,POS,London,GB,2219,user_001,,
44ba21e9-28ac-4a8f-9d83-16caadeb6c6b,2033-09-27,2033-09-28,Sainsbury's,5411,Groceries,Supermarket,-40.71,GBP,-216936.11,POS,London,GB,9074,user_001,,
120e3488-5f72-4e46-a99d-57c1e5c9d021,2033-09-28,2033-09-30,Tesco,5411,Groceries,Supermarket,-42.96,GBP,-216979.07,POS,London,GB,2219,user_001,,
25dceddd-d879-4842-ae16-83a91226119f,2033-10-01,2033-10-03,Sainsbury's,5411,Groceries,Supermarket,-60.15,GBP,-217039.22,POS,London,GB,2219,user_002,,
3441ff8e-94aa-4e97-a6b7-0c37d57e3eb6,2033-10-01,2033-10-03,Deliveroo,5812,Food & Drink,Delivery,-28.5,GBP,-217067.72,E-Com,London,GB,2219,user_001,,
3f499c2f-9636-4593-b1ea-b62e1435ab35,2033-10-01,2033-10-03,Waitrose,5411,Groceries,Supermarket,-27.87,GBP,-217095.59,POS,London,GB,1045,user_001,,
4c84e6cb-f7ee-46cc-97c5-ce119ab8e934,2033-10-01,2033-10-03,Uber UK,4121,Transport,Ride Hailing,-12.77,GBP,-217108.36,E-Com,London,GB,4488,user_001,,
9886eae9-f49c-4c52-bf06-5529eb387344,2033-10-01,2033-10-03,Sainsbury's,5411,Groceries,Supermarket,-65.35,GBP,-217173.71,POS,London,GB,1045,user_001,,
fcb4d2f1-c597-422f-baa1-08ee218b498f,2033-10-01,2033-10-03,Shell,5541,Transport,Fuel,-89.59,GBP,-217263.3,POS,London,GB,2219,user_001,,
241c7765-364d-4b65-8231-27ef2e6ff88a,2033-10-02,2033-10-04,Amazon UK,5942,Shopping,Online Retail,-66.88,GBP,-217330.18,E-Com,London,GB,2219,user_001,,
999a00b3-afac-4c49-bc5f-cd61fff7c633,2033-10-02,2033-10-04,Transport for London,4111,Transport,Transit,-6.71,GBP,-217336.89,POS,London,GB,1045,user_002,,
9cdf52bf-5aac-4272-8190-ee3a2a123d5b,2033-10-02,2033-10-03,Tesco,5411,Groceries,Supermarket,-47.03,GBP,-217383.92,POS,London,GB,2219,user_001,,
5757d026-6b07-4704-9780-366d073bbe65,2033-10-03,2033-10-04,Shell,5541,Transport,Fuel,-44.47,GBP,-217428.39,POS,London,GB,4488,user_002,,
7f2c9833-4bf9-4b91-a337-96c55f02aef3,2033-10-03,2033-10-04,Sainsbury's,5411,Groceries,Supermarket,-22.44,GBP,-217450.83,POS,London,GB,2219,user_001,,
99399aaa-0979-4e6e-9d30-6824746773ef,2033-10-03,2033-10-03,Crown Estates Lettings,6513,Housing,Rent,-1501.56,GBP,-218952.39,POS,London,GB,4488,user_001,rec_19f70fbcce,
9e34c5bd-d69a-46f7-a489-cd9eb91d2cc7,2033-10-03,2033-10-05,Amazon UK,5942,Shopping,Online Retail,-56.28,GBP,-219008.67,E-Com,London,GB,9074,user_001,,
563ee28e-ee64-41fc-904a-5638bf23111c,2033-10-04,2033-10-05,Tesco,5411,Groceries,Supermarket,-74.17,GBP,-219082.84,POS,London,GB,2219,user_001,,
e00ac2c9-ddb3-4abf-afd0-f7d43f292c7c,2033-10-04,2033-10-04,Apple.com/bill,5734,Shopping,Electronics,-30.61,USD,-219113.45,E-Com,Cupertino,US,1045,user_001,,FX purchase 38.75 USD @ rate 1.27
aa4d3d8f-f147-439d-b5ee-9552f89192c9,2033-10-05,2033-10-06,Waitrose,5411,Groceries,Supermarket,-74.23,GBP,-219187.68,POS,London,GB,2219,user_001,,
2ce2625e-63d2-4cab-96b5-09e1ecf3ee90,2033-10-06,2033-10-07,Apple.com/bill,5734,Shopping,Electronics,-114.14,GBP,-219301.82,E-Com,Cupertino,US,1045,user_001,,
574b44d0-5563-46dc-873b-2c1f89cdffcc,2033-10-06,2033-10-07,Sainsbury's,5411,Groceries,Supermarket,-48.81,GBP,-219350.63,POS,London,GB,2219,user_001,,
b68b6d0c-2e51-4ce9-8a7d-374f1f6ba15f,2033-10-06,2033-10-07,Sainsbury's,5411,Groceries,Supermarket,-34.47,GBP,-219385.1,POS,London,GB,9074,user_001,,
b868f0f4-2e49-4009-80a6-10ee8cf34d09,2033-10-06,2033-10-06,Pret A Manger,5814,Food & Drink,Eating Out,-10.12,GBP,-219395.22,POS,London,GB,2219,user_001,,
b9106d74-53d7-402e-b724-85836c07781a,2033-10-06,2033-10-10,Transport for London,4111,Transport,Transit,-11.06,GBP,-219406.28,POS,London,GB,1045,user_001,,
f8e05021-9951-4a10-8bc1-34254abad0d5,2033-10-07,2033-10-07,Octopus Energy,4900,Utilities,Electricity,-113.64,GBP,-219519.92,Direct Debit,London,GB,1045,user_001,rec_141a4a0666,
203f6baa-6fa2-4865-99a9-85f195933417,2033-10-08,2033-10-10,Amazon UK,5942,Shopping,Online Retail,-30.41,GBP,-219550.33,E-Com,London,GB,2219,user_001,,
af5da7e0-0d64-481f-a9d3-521f602bbe51,2033-10-08,2033-10-10,Pret A Manger,5814,Food & Drink,Eating Out,-5.71,GBP,-219556.04,POS,London,GB,1045,user_001,,
c505e22f-2a36-4236-abbe-23eb7f412c9d,2033-10-08,2033-10-10,Transport for London,4111,Transport,Transit,-5.04,GBP,-219561.08,POS,London,GB,9074,user_001,,
ce55cc8b-06a2-4316-b0c3-76cfff30d3f0,2033-10-08,2033-10-10,British Airways,4511,Travel,Flights,-578.84,USD,-220139.92,E-Com,London,GB,9074,user_001,,Business travel
114cb03c-dee4-47d9-8dfe-2fe9d95e39f6,2033-10-09,2033-10-10,Tesco,5411,Groceries,Supermarket,-61.39,GBP,-220201.31,POS,London,GB,2219,user_001,,
168fa2e3-6255-47ec-a097-9cf5d4d60e20,2033-10-09,2033-10-10,Transport for London,4111,Transport,Transit,-6.04,GBP,-220207.35,POS,London,GB,4488,user_002,,
aa342f94-3893-4d88-a971-36e92bdd5a32,2033-10-09,2033-10-10,Pret A Manger,5814,Food & Drink,Eating Out,-7.64,GBP,-220214.99,POS,London,GB,9074,user_001,,
cdd89607-ef7e-4477-8618-2fe6fda6f44f,2033-10-09,2033-10-10,Shell,5541,Transport,Fuel,-77.62,GBP,-220292.61,POS,London,GB,2219,user_001,,
da922ecc-2264-4196-adc7-02c7820ab40d,2033-10-09,2033-10-11,Sainsbury's,5411,Groceries,Supermarket,-51.0,GBP,-220343.61,POS,London,GB,1045,user_001,,
251bed5c-049f-49fc-a75e-9837b6986e0b,2033-10-10,2033-10-11,Uber UK,4121,Transport,Ride Hailing,-27.92,GBP,-220371.53,E-Com,London,GB,4488,user_002,,
71d9fac3-9676-4b73-8792-792c48cd141f,2033-10-10,2033-10-12,Amazon UK,5942,Shopping,Online Retail,-76.07,GBP,-220447.6,E-Com,London,GB,2219,user_002,,
bb4003ad-fa32-41ae-abf6-99ddca67c31e,2033-10-10,2033-10-12,Pret A Manger,5814,Food & Drink,Eating Out,-11.94,GBP,-220459.54,POS,London,GB,9074,user_002,,
88fc2667-c297-4878-b911-7ff5ce347a7c,2033-10-11,2033-10-11,Thames Water,4900,Utilities,Water,-42.74,GBP,-220502.28,Direct Debit,Reading,GB,1045,user_001,rec_3a34d62842,
ee4e681f-6f20-4040-b639-f62d22c0b4a8,2033-10-11,2033-10-13,Tesco,5411,Groceries,Supermarket,-62.84,GBP,-220565.12,POS,London,GB,4488,user_001,,
9fece824-40c9-46c9-820a-0762c28567cc,2033-10-12,2033-10-13,Shell,5541,Transport,Fuel,-58.98,GBP,-220624.1,POS,London,GB,4488,user_001,,
1b5f448b-08dd-48d9-9a8d-298a4ce9c43a,2033-10-13,2033-10-17,Deliveroo,5812,Food & Drink,Delivery,-30.78,GBP,-220654.88,E-Com,London,GB,2219,user_001,,
3e01ec18-fc6b-4b0f-bad7-9443052e0f3a,2033-10-13,2033-10-14,City Council Tax,9399,Utilities,Council Tax,-167.65,GBP,-220822.53,Direct Debit,London,GB,9074,user_001,rec_f531495db5,
4bfc56f5-0f16-4b95-b3b1-b64947ca5bce,2033-10-13,2033-10-17,Apple.com/bill,5734,Shopping,Electronics,-194.28,GBP,-221016.81,E-Com,Cupertino,US,4488,user_002,,
65512803-e097-4c89-8c14-3d6d18cf27de,2033-10-13,2033-10-17,Tesco,5411,Groceries,Supermarket,-49.57,GBP,-221066.38,POS,London,GB,4488,user_002,,
d6129083-3ae4-439e-8788-37490a3c226f,2033-10-13,2033-10-14,Shell,5541,Transport,Fuel,-92.57,GBP,-221158.95,POS,London,GB,4488,user_001,,
0575969c-db87-42b5-a816-c4169c533a26,2033-10-14,2033-10-17,Transport for London,4111,Transport,Transit,-8.67,GBP,-221167.62,POS,London,GB,9074,user_002,,
2339e152-d5cd-446b-98ca-f61ef75ab8c1,2033-10-14,2033-10-17,Transport for London,4111,Transport,Transit,-8.08,GBP,-221175.7,POS,London,GB,1045,user_001,,
914d1806-4200-411f-997b-9f652ccb7813,2033-10-14,2033-10-17,Local Market,5499,Groceries,Specialty,-16.27,GBP,-221191.97,POS,London,GB,1045,user_001,,
c4f79faa-0aee-4f55-a2b4-6cc9f6287ed9,2033-10-14,2033-10-14,Waitrose,5411,Groceries,Supermarket,-67.2,GBP,-221259.17,POS,London,GB,1045,user_001,,
e4cca0b6-8513-40af-883a-02b8bfc6a4a3,2033-10-14,2033-10-14,Amazon UK,5942,Shopping,Online Retail,-45.53,GBP,-221304.7,E-Com,London,GB,9074,user_001,,
89fb9089-16ea-4408-92db-6fbe89c994c6,2033-10-15,2033-10-17,Local Market,5499,Groceries,Specialty,-6.59,GBP,-221311.29,POS,London,GB,1045,user_001,,
a455452f-8579-4a8e-b2f0-619f47f24d3b,2033-10-15,2033-10-17,Amazon UK,5942,Shopping,Online Retail,-112.39,GBP,-221423.68,E-Com,London,GB,1045,user_001,,
a9c4ec4a-ee4a-4797-901a-d3b96afa1dea,2033-10-15,2033-10-17,Deliveroo,5812,Food & Drink,Delivery,-26.91,GBP,-221450.59,E-Com,London,GB,1045,user_001,,
c97acd3b-efc1-487e-a17b-67f391f8cdda,2033-10-15,2033-10-17,Local Market,5499,Groceries,Specialty,-16.01,GBP,-221466.6,POS,London,GB,1045,user_002,,
cea77c5b-8f49-444d-9d3f-14b627c70d06,2033-10-15,2033-10-17,Pret A Manger,5814,Food & Drink,Eating Out,-9.03,GBP,-221475.63,POS,London,GB,4488,user_002,,
ded2c029-1f25-467f-a276-6d172e8a4ea2,2033-10-15,2033-10-17,Pret A Manger,5814,Food & Drink,Eating Out,-8.93,GBP,-221484.56,POS,London,GB,2219,user_001,,
83f56c81-974b-4dad-906b-0eac26963d47,2033-10-16,2033-10-17,Apple.com/bill,5734,Shopping,Electronics,-51.14,GBP,-221535.7,E-Com,Cupertino,US,2219,user_001,,
19f5e147-b44c-4123-9c53-cd995841da9d,2033-10-17,2033-10-19,Shell,5541,Transport,Fuel,-35.29,GBP,-221570.99,POS,London,GB,1045,user_001,,
266f26e1-e0f7-42e4-a50b-1c9875c859dd,2033-10-17,2033-10-18,Tesco,5411,Groceries,Supermarket,-34.21,GBP,-221605.2,POS,London,GB,9074,user_001,,
591b9203-cbb0-4a9e-aa2a-dc76695f5248,2033-10-17,2033-10-18,Waitrose,5411,Groceries,Supermarket,-58.46,GBP,-221663.66,POS,London,GB,2219,user_002,,
607d50e3-0d4a-4c84-bf8d-c5421b82dfb3,2033-10-17,2033-10-18,Waitrose,5411,Groceries,Supermarket,-43.78,GBP,-221707.44,POS,London,GB,1045,user_001,,
ad5e5816-8fab-4244-81e3-272e6e20b685,2033-10-17,2033-10-18,Amazon UK,5942,Shopping,Online Retail,-98.74,GBP,-221806.18,E-Com,London,GB,1045,user_001,,
b15ef1ca-1295-4f7e-9e74-4ee1f9bb550b,2033-10-17,2033-10-18,O2 UK,4814,Bills,Mobile,-40.43,GBP,-221846.61,Direct Debit,Slough,GB,1045,user_002,rec_d2dce4c42f,
c1a45be1-785e-4a3c-9623-79eeb78f05e3,2033-10-17,2033-10-18,GymBox,7997,Wellness,Gym,-49.68,GBP,-221896.29,Direct Debit,London,GB,1045,user_001,rec_3906953fd2,
1bf0ae56-8481-49e4-9050-02dc8bcda91c,2033-10-18,2033-10-18,Tesco,5411,Groceries,Supermarket,-67.74,GBP,-221964.03,POS,London,GB,4488,user_001,,
67c54936-2c7c-479f-b80d-780621d808f4,2033-10-19,2033-10-21,Waitrose,5411,Groceries,Supermarket,-83.81,GBP,-222047.84,POS,London,GB,2219,user_001,,
b648e1fe-2005-4a1d-b849-02747a587ebb,2033-10-19,2033-10-20,Spotify,5735,Entertainment,Subscriptions,-8.65,GBP,-222056.49,E-Com,Stockholm,SE,2219,user_002,rec_34b6e9e33f,
ed63bf1c-c3f0-403e-a1a8-fabfbdd75350,2033-10-19,2033-10-20,Sainsbury's,5411,Groceries,Supermarket,-69.27,GBP,-222125.76,POS,London,GB,2219,user_001,,
01881d14-ca08-4fe8-8f61-a60881efe821,2033-10-21,2033-10-21,Netflix,7841,Entertainment,Subscriptions,-12.55,GBP,-222138.31,E-Com,Los Gatos,US,2219,user_001,rec_1bfe33738d,
080bca30-a476-43cf-b68c-1b6c8f7887de,2033-10-21,2033-10-21,Amazon UK,5942,Shopping,Online Retail,-67.75,GBP,-222206.06,E-Com,London,GB,1045,user_002,,
28eb2110-bf75-4f1b-8873-ffe07a485978,2033-10-21,2033-10-21,Tesco,5411,Groceries,Supermarket,-48.01,GBP,-222254.07,POS,London,GB,4488,user_001,,
44382f39-3444-4605-b64e-aca6a61d6fb5,2033-10-22,2033-10-24,Local Market,5499,Groceries,Specialty,-7.58,GBP,-222261.65,POS,London,GB,2219,user_001,,
5094ed58-97da-49c0-948c-f3f84d209c20,2033-10-22,2033-10-24,Local Market,5499,Groceries,Specialty,-7.3,GBP,-222268.95,POS,London,GB,9074,user_002,,
dbe13122-7311-430c-8f8e-b06dd238fb7b,2033-10-22,2033-10-24,Pret A Manger,5814,Food & Drink,Eating Out,-7.63,GBP,-222276.58,POS,London,GB,2219,user_001,,
ea47bdc2-9fd6-4300-9c82-51a0d7f00d92,2033-10-22,2033-10-24,Amazon UK,5942,Shopping,Online Retail,-26.86,GBP,-222303.44,E-Com,London,GB,9074,user_001,,
29409f2e-ba93-4cd3-8b70-b353519c867e,2033-10-23,2033-10-25,Apple.com/bill,5734,Shopping,Electronics,-166.8,GBP,-222470.24,E-Com,Cupertino,US,2219,user_002,,
4e81f253-cbff-4c16-ad05-cc4eeebecfa0,2033-10-23,2033-10-24,Transport for London,4111,Transport,Transit,-9.16,GBP,-222479.4,POS,London,GB,1045,user_002,,
67fc56d8-639f-4cd0-bf8a-a3074bdc00e8,2033-10-23,2033-10-25,Pret A Manger,5814,Food & Drink,Eating Out,-11.2,GBP,-222490.6,POS,London,GB,9074,user_001,,
a5bbd1e7-1fc3-4405-a12d-e5919b340347,2033-10-23,2033-10-25,Local Market,5499,Groceries,Specialty,-20.48,GBP,-222511.08,POS,London,GB,1045,user_002,,
e4cef47c-6157-40c9-8fd2-0ab6f82e2115,2033-10-25,2033-10-25,T212 Capital,6011,Income,Salary,2943.53,GBP,-219567.55,Credit,London,GB,2219,user_001,rec_2ff8f778d0,
ec57fdc0-d90f-444a-ae2e-794852908455,2033-10-25,2033-10-25,Waitrose,5411,Groceries,Supermarket,-30.58,GBP,-219598.13,POS,London,GB,2219,user_001,,
5c41fe4b-4595-4475-a0f6-2ab5e6ce18c3,2033-10-26,2033-10-27,Tesco,5411,Groceries,Supermarket,-38.0,GBP,-219636.13,POS,London,GB,4488,user_001,,
7bd475b5-0e92-4239-a5c2-a89d0766b439,2033-10-26,2033-10-27,Waitrose,5411,Groceries,Supermarket,-33.95,GBP,-219670.08,POS,London,GB,2219,user_001,,
d0d107f0-f9d8-4532-8c23-013ec61676b6,2033-10-26,2033-10-28,Tesco,5411,Groceries,Supermarket,-39.73,GBP,-219709.81,POS,London,GB,1045,user_001,,
7f567ba0-d8cd-4a81-af7e-58d2014dffed,2033-10-29,2033-10-31,Apple.com/bill,5734,Shopping,Electronics,-96.22,GBP,-219806.03,E-Com,Cupertino,US,2219,user_001,,
a50b4db6-da67-413d-a4f1-6881b6297c08,2033-10-29,2033-10-31,Tesco,5411,Groceries,Supermarket,-56.57,GBP,-219862.6,POS,London,GB,9074,user_001,,
b34c83dd-85f7-4aec-a9df-424ef7a2df62,2033-10-29,2033-10-31,Local Market,5499,Groceries,Specialty,-13.92,GBP,-219876.52,POS,London,GB,1045,user_001,,
68d12c48-1d54-40e9-802c-0204e149e614,2033-10-30,2033-10-31,Pret A Manger,5814,Food & Drink,Eating Out,-7.78,GBP,-219884.3,POS,London,GB,2219,user_001,,
8d68e404-9ca7-48bf-a469-7151d781403f,2033-10-30,2033-11-01,Tesco,5411,Groceries,Supermarket,-81.14,GBP,-219965.44,POS,London,GB,1045,user_002,,
9e3903c6-defb-47ce-a746-656288955f5f,2033-10-30,2033-10-31,Uber UK,4121,Transport,Ride Hailing,-33.71,GBP,-219999.15,E-Com,London,GB,9074,user_001,,
5f76ebcd-7410-4718-bc55-21b82c5b21e1,2033-10-31,2033-10-31,Airline Refund,4511,Travel,Refund,22.25,GBP,-219976.9,Credit,London,GB,4488,user_001,,Refund for Amazon UK
a36ba49c-7290-4344-9257-59e96cce4efc,2033-11-01,2033-11-03,Crown Estates Lettings,6513,Housing,Rent,-1473.61,GBP,-221450.51,POS,London,GB,1045,user_002,rec_fc2ae06846,
e735f2c6-5ac4-42a5-9eeb-ec795212edfa,2033-11-01,2033-11-01,Deliveroo,5812,Food & Drink,Delivery,-20.39,GBP,-221470.9,E-Com,London,GB,4488,user_001,,
b9e212ce-0b47-4156-a9d0-94aa74ce7464,2033-11-02,2033-11-04,Tesco,5411,Groceries,Supermarket,-62.74,GBP,-221533.64,POS,London,GB,1045,user_001,,
ffc222a1-e722-4d31-9f3c-f90206790979,2033-11-02,2033-11-03,Shell,5541,Transport,Fuel,-60.47,GBP,-221594.11,POS,London,GB,2219,user_001,,
13eabf26-e80d-42e5-b163-4d1247d445a5,2033-11-03,2033-11-07,Deliveroo,5812,Food & Drink,Delivery,-25.87,GBP,-221619.98,E-Com,London,GB,9074,user_002,,
1bf171a9-2172-4a0a-a3d4-deb8dd50aa92,2033-11-04,2033-11-04,Shell,5541,Transport,Fuel,-39.18,GBP,-221659.16,POS,London,GB,4488,user_001,,
59e5cfbe-76ad-4b3a-808a-78d14f3efd5b,2033-11-04,2033-11-07,Uber UK,4121,Transport,Ride Hailing,-25.99,GBP,-221685.15,E-Com,London,GB,9074,user_001,,
8ec4b4c9-ee77-42f4-845f-a105e296d7d9,2033-11-04,2033-11-07,Waitrose,5411,Groceries,Supermarket,-45.68,GBP,-221730.83,POS,London,GB,9074,user_001,,
e81e97fa-6d46-49ab-8080-4ccaab0eee6a,2033-11-04,2033-11-07,Shell,5541,Transport,Fuel,-30.37,GBP,-221761.2,POS,London,GB,9074,user_001,,
99e48796-3397-4530-8746-9518137455fb,2033-11-05,2033-11-07,Amazon UK,5942,Shopping,Online Retail,-80.31,GBP,-221841.51,E-Com,London,GB,4488,user_001,,
ef249367-0162-418b-bf66-538e4da0a96f,2033-11-05,2033-11-07,Apple.com/bill,5734,Shopping,Electronics,-106.68,GBP,-221948.19,E-Com,Cupertino,US,9074,user_002,,
71fd5ab7-1e4e-450b-bf38-f8f0dc758ec1,2033-11-06,2033-11-08,Sainsbury's,5411,Groceries,Supermarket,-54.17,GBP,-222002.36,POS,London,GB,4488,user_001,,
952ef812-d2bf-45ad-aacc-f38a804c3156,2033-11-06,2033-11-08,Tesco,5411,Groceries,Supermarket,-67.15,GBP,-222069.51,POS,London,GB,9074,user_001,,
9c7668a9-1c24-4e0a-942a-643fcd321adb,2033-11-07,2033-11-08,Octopus Energy,4900,Utilities,Electricity,-112.55,GBP,-222182.06,Direct Debit,London,GB,9074,user_001,rec_141a4a0666,
e28935c9-a847-4f97-b47e-95c19d249ea5,2033-11-07,2033-11-07,Deliveroo,5812,Food & Drink,Delivery,-16.71,GBP,-222198.77,E-Com,London,GB,4488,user_002,,
114f58a0-4384-4190-8c4f-628109d04ebd,2033-11-09,2033-11-09,Tesco,5411,Groceries,Supermarket,-56.54,GBP,-222255.31,POS,London,GB,9074,user_001,,
503ac452-9e9c-4e87-ad18-29bc99fa4c4c,2033-11-09,2033-11-11,Deliveroo,5812,Food & Drink,Delivery,-33.32,GBP,-222288.63,E-Com,London,GB,9074,user_001,,
027fcabe-5f97-4671-95db-0dacf460d9c7,2033-11-10,2033-11-10,Local Market,5499,Groceries,Specialty,-17.55,GBP,-222306.18,POS,London,GB,2219,user_001,,
7448c5dd-f24a-4f5b-9183-ffc801d8e06c,2033-11-10,2033-11-11,Uber UK,4121,Transport,Ride Hailing,-32.03,GBP,-222338.21,E-Com,London,GB,2219,user_001,,
ac8cc307-1b8b-4571-8de4-da0b247bf611,2033-11-10,2033-11-10,ATM Withdrawal,6011,Cash,ATM,-74.29,GBP,-222412.5,ATM,London,GB,9074,user_002,,
2e15509e-7133-4f3a-8114-37998fb617d5,2033-11-11,2033-11-14,Thames Water,4900,Utilities,Water,-42.85,GBP,-222455.35,Direct Debit,Reading,GB,9074,user_002,rec_954d02400c,
8d6a26f3-83e7-4efd-b8aa-cf0e4c8ad8bb,2033-11-11,2033-11-14,Shell,5541,Transport,Fuel,-87.0,GBP,-222542.35,POS,London,GB,1045,user_001,,
a2d7276a-eaf5-40ef-8566-0ff6835c4cec,2033-11-11,2033-11-14,Amazon UK,5942,Shopping,Online Retail,-34.03,GBP,-222576.38,E-Com,London,GB,1045,user_001,,
72715084-daa4-4657-918b-d46cd2f62c84,2033-11-12,2033-11-14,Tesco,5411,Groceries,Supermarket,-45.52,GBP,-222621.9,POS,London,GB,2219,user_001,,
8671ce28-b07f-4334-9642-e4d3ea0e5760,2033-11-12,2033-11-14,Tesco,5411,Groceries,Supermarket,-37.56,GBP,-222659.46,POS,London,GB,2219,user_001,,
e56d6261-7836-49ca-8c97-9a7fa11ce755,2033-11-12,2033-11-14,Uber UK,4121,Transport,Ride Hailing,-27.95,GBP,-222687.41,E-Com,London,GB,9074,user_001,,
eb884e66-a350-4004-a503-ed0a9032305a,2033-11-12,2033-11-14,Pret A Manger,5814,Food & Drink,Eating Out,-7.61,GBP,-222695.02,POS,London,GB,2219,user_002,,
3a2a1aea-a84e-4ca9-a628-0337bd0f5f5f,2033-11-13,2033-11-15,Sainsbury's,5411,Groceries,Supermarket,-52.96,GBP,-222747.98,POS,London,GB,9074,user_001,,
83d06b92-5bd3-485c-942d-76478ea19a6e,2033-11-13,2033-11-15,Uber UK,4121,Transport,Ride Hailing,-9.63,GBP,-222757.61,E-Com,London,GB,9074,user_001,,
c575517c-84e4-49bf-9e56-db62648a6139,2033-11-13,2033-11-14,Pret A Manger,5814,Food & Drink,Eating Out,-8.27,GBP,-222765.88,POS,London,GB,9074,user_001,,
f4c05227-08ae-476f-a0b4-b9f2e4e01ae1,2033-11-13,2033-11-14,Sainsbury's,5411,Groceries,Supermarket,-18.91,GBP,-222784.79,POS,London,GB,2219,user_001,,
010dace2-7a84-46c6-b5fb-89883972ec93,2033-11-14,2033-11-14,Tesco,5411,Groceries,Supermarket,-33.27,GBP,-222818.06,POS,London,GB,9074,user_001,,
0635f973-273e-43ef-bc92-1ca8df712876,2033-11-14,2033-11-14,Sainsbury's,5411,Groceries,Supermarket,-61.34,GBP,-222879.4,POS,London,GB,9074,user_001,,
4b866fca-0402-41b6-a1fe-76f72fa194ab,2033-11-14,2033-11-14,Waitrose,5411,Groceries,Supermarket,-79.0,GBP,-222958.4,POS,London,GB,1045,user_001,,
4e06a079-d8ac-4b8d-8abd-4e948b865693,2033-11-14,2033-11-14,Deliveroo,5812,Food & Drink,Delivery,-25.04,GBP,-222983.44,E-Com,London,GB,9074,user_001,,
5f1cb256-1621-46a1-9378-5def992c0585,2033-11-14,2033-11-16,City Council Tax,9399,Utilities,Council Tax,-150.82,GBP,-223134.26,Direct Debit,London,GB,1045,user_002,rec_6feaa5d43f,
5a960184-f6f1-4453-83e7-3074201a2a2c,2033-11-15,2033-11-16,O2 UK,4814,Bills,Mobile,-41.1,GBP,-223175.36,Direct Debit,Slough,GB,1045,user_001,rec_95042d8101,
c6f367ed-c111-464a-a81d-381e4934a889,2033-11-15,2033-11-15,Apple.com/bill,5734,Shopping,Electronics,-83.86,USD,-223259.22,E-Com,Cupertino,US,2219,user_001,,FX purchase 111.33 USD @ rate 1.33
4c0b1235-86ea-4a55-ad5c-b14536e884e2,2033-11-16,2033-11-17,Uber UK,4121,Transport,Ride Hailing,-15.59,GBP,-223274.81,E-Com,London,GB,9074,user_001,,
c9dda532-cc9d-45df-813f-d8c399d44819,2033-11-16,2033-11-17,Waitrose,5411,Groceries,Supermarket,-66.34,GBP,-223341.15,POS,London,GB,2219,user_001,,
fa051ab8-5b9d-4785-b0cf-b0594788af7e,2033-11-16,2033-11-17,ATM Withdrawal,6011,Cash,ATM,-116.77,GBP,-223457.92,ATM,London,GB,9074,user_001,,
06499933-2439-476b-98e1-b11058e9dfb5,2033-11-17,2033-11-21,Transport for London,4111,Transport,Transit,-11.41,GBP,-223469.33,POS,London,GB,9074,user_001,,
fbd6d910-8800-4d7e-8024-e6be18be1d85,2033-11-17,2033-11-17,GymBox,7997,Wellness,Gym,-52.84,GBP,-223522.17,Direct Debit,London,GB,2219,user_002,rec_19771e79cd,
a56b38d1-a64b-4e10-96b9-17470a468c10,2033-11-18,2033-11-18,Waitrose,5411,Groceries,Supermarket,-21.27,GBP,-223543.44,POS,London,GB,4488,user_001,,
2e7452b9-09f3-49fd-bcd1-094348b0cd37,2033-11-19,2033-11-21,Transport for London,4111,Transport,Transit,-8.26,GBP,-223551.7,POS,London,GB,9074,user_001,,
3511f2e5-9477-4d28-a24d-6eed96c6885a,2033-11-19,2033-11-21,Amazon UK,5942,Shopping,Online Retail,-43.46,GBP,-223595.16,E-Com,London,GB,1045,user_001,,
528081ef-af46-45c9-bdb6-412696aac795,2033-11-19,2033-11-21,Uber UK,4121,Transport,Ride Hailing,-16.23,GBP,-223611.39,E-Com,London,GB,9074,user_001,,
b8700876-778a-4d2f-b48c-bc63d1524841,2033-11-19,2033-11-21,Local Market,5499,Groceries,Specialty,-13.56,GBP,-223624.95,POS,London,GB,4488,user_001,,
d9236a98-517b-4032-995c-c51635c1ef8e,2033-11-19,2033-11-21,Tesco,5411,Groceries,Supermarket,-76.39,GBP,-223701.34,POS,London,GB,4488,user_002,,
d9beda6d-6b0d-40ab-9fab-4f500773a668,2033-11-19,2033-11-21,Amazon UK,5942,Shopping,Online Retail,-63.05,GBP,-223764.39,E-Com,London,GB,9074,user_001,,
301978f3-232b-4cf4-af21-201f7a8c3cca,2033-11-20,2033-11-22,Waitrose,5411,Groceries,Supermarket,-21.41,GBP,-223785.8,POS,London,GB,2219,user_001,,
dee9354f-f165-468b-b477-f6f7e713f17e,2033-11-20,2033-11-21,Tesco,5411,Groceries,Supermarket,-40.98,GBP,-223826.78,POS,London,GB,1045,user_001,,
5230890e-76f5-4862-a111-a7fcc40b288b,2033-11-21,2033-11-22,Spotify,5735,Entertainment,Subscriptions,-9.69,EUR,-223836.47,E-Com,Stockholm,SE,1045,user_001,rec_4c746d2c3b,FX purchase 11.83 EUR @ rate 1.22
6fbe7f4d-84da-45c3-a463-39b23120c52e,2033-11-21,2033-11-21,Netflix,7841,Entertainment,Subscriptions,-15.72,GBP,-223852.19,E-Com,Los Gatos,US,1045,user_002,rec_d9322c1382,
8931b90c-6aaf-4801-b919-1967ee068530,2033-11-21,2033-11-21,Transport for London,4111,Transport,Transit,-11.03,GBP,-223863.22,POS,London,GB,2219,user_002,,
bc3f0ce0-ba27-44d4-835a-8359558c4813,2033-11-21,2033-11-21,Amazon UK,5942,Shopping,Online Retail,-74.87,GBP,-223938.09,E-Com,London,GB,1045,user_001,,
212ca66a-91e5-44b9-bfb3-00c6e3110d56,2033-11-22,2033-11-23,Sainsbury's,5411,Groceries,Supermarket,-35.75,GBP,-223973.84,POS,London,GB,2219,user_001,,
bbcb5459-8303-4846-aef8-81fc3e45ebd2,2033-11-22,2033-11-22,HM Revenue & Customs,9311,Income,Tax Refund,64.92,GBP,-223908.92,Credit,London,GB,2219,user_001,,Refund for Octopus Energy
ca879ac1-135c-44ec-baae-6fbb58c6ec80,2033-11-22,2033-11-24,Deliveroo,5812,Food & Drink,Delivery,-15.61,GBP,-223924.53,E-Com,London,GB,4488,user_001,,
7cae38fc-4af2-46f0-8f82-8e937bbc7aff,2033-11-23,2033-11-25,Waitrose,5411,Groceries,Supermarket,-33.82,GBP,-223958.35,POS,London,GB,2219,user_001,,
ee239043-1bd1-4c3f-a0a1-0e93c1fedb0b,2033-11-23,2033-11-24,Tesco,5411,Groceries,Supermarket,-77.38,GBP,-224035.73,POS,London,GB,2219,user_001,,
2420f261-d619-4459-85f0-ecfbc4db8057,2033-11-25,2033-11-25,T212 Capital,6011,Income,Salary,3132.64,GBP,-220903.09,Credit,London,GB,4488,user_001,rec_2ff8f778d0,
35a1be73-cfab-4258-80e0-e87471f17245,2033-11-26,2033-11-28,Shell,5541,Transport,Fuel,-81.68,GBP,-220984.77,POS,London,GB,4488,user_002,,
7992b404-81ef-4b9d-9b11-602728e620cf,2033-11-26,2033-11-28,Pret A Manger,5814,Food & Drink,Eating Out,-5.98,GBP,-220990.75,POS,London,GB,2219,user_001,,
dd991290-982e-4c30-8273-8a6525114a83,2033-11-26,2033-11-28,Uber UK,4121,Transport,Ride Hailing,-29.6,GBP,-221020.35,E-Com,London,GB,4488,user_001,,
7cd7c1f0-1faf-47c7-bd50-352173b4e099,2033-11-27,2033-11-28,Transport for London,4111,Transport,Transit,-8.0,GBP,-221028.35,POS,London,GB,1045,user_001,,
97fe4ff8-4d5e-4459-88d4-0d10ce8f8fb2,2033-11-27,2033-11-29,Tesco,5411,Groceries,Supermarket,-18.22,GBP,-221046.57,POS,London,GB,1045,user_001,,
cf2b3569-9d55-4c24-acd4-647d9f5b189a,2033-11-27,2033-11-28,Deliveroo,5812,Food & Drink,Delivery,-32.16,GBP,-221078.73,E-Com,London,GB,1045,user_002,,
01709df3-ed49-4b8b-934e-a5ea8104ef0f,2033-11-30,2033-12-02,Waitrose,5411,Groceries,Supermarket,-23.2,GBP,-221101.93,POS,London,GB,9074,user_001,,
32b54d08-bf5c-4e39-a5c3-ab323d3aaf7b,2033-11-30,2033-12-01,Apple.com/bill,5734,Shopping,Electronics,-34.65,GBP,-221136.58,E-Com,Cupertino,US,9074,user_001,,
379c92a3-dfd2-4d48-b6c4-c6cc29cf3069,2033-11-30,2033-12-01,Sainsbury's,5411,Groceries,Supermarket,-24.28,GBP,-221160.86,POS,London,GB,9074,user_001,,
d506e689-ea3b-46e4-82a1-2b186985cf55,2033-11-30,2033-11-30,Apple.com/bill,5734,Shopping,Electronics,-62.52,GBP,-221223.38,E-Com,Cupertino,US,4488,user_002,,
1777dc62-c0d9-47f6-bd1c-61f6ffa78bb8,2033-12-01,2033-12-01,Crown Estates Lettings,6513,Housing,Rent,-1551.97,GBP,-222775.35,POS,London,GB,9074,user_002,rec_fc2ae06846,
250090cb-cd06-4772-8069-c87f5b240191,2033-12-01,2033-12-01,Deliveroo,5812,Food & Drink,Delivery,-12.7,GBP,-222788.05,E-Com,London,GB,2219,user_001,,
46f94608-e2b1-4d43-bf13-3f7c0a76675f,2033-12-01,2033-12-05,Local Market,5499,Groceries,Specialty,-12.51,GBP,-222800.56,POS,London,GB,2219,user_001,,
0883a532-53a7-458b-9c73-ffac40e77501,2033-12-02,2033-12-05,Waitrose,5411,Groceries,Supermarket,-65.6,GBP,-222866.16,POS,London,GB,4488,user_002,,
08aac49f-88af-4790-bf45-5b433543a8c9,2033-12-02,2033-12-02,Amazon UK,5942,Shopping,Online Retail,-82.9,GBP,-222949.06,E-Com,London,GB,9074,user_001,,
7a6cf404-b296-4cdf-bccd-bf3c50459062,2033-12-02,2033-12-05,Apple.com/bill,5734,Shopping,Electronics,-144.65,USD,-223093.71,E-Com,Cupertino,US,4488,user_001,,FX purchase 176.77 USD @ rate 1.22
645bda50-6acf-4b83-979e-5b98b9391784,2033-12-03,2033-12-05,Pret A Manger,5814,Food & Drink,Eating Out,-9.3,GBP,-223103.01,POS,London,GB,2219,user_001,,
c58769cb-fccf-4998-859b-0aafe062062e,2033-12-03,2033-12-05,Waitrose,5411,Groceries,Supermarket,-47.76,GBP,-223150.77,POS,London,GB,9074,user_001,,
08afb78f-10c9-47d4-8077-67cad00dd924,2033-12-04,2033-12-06,Waitrose,5411,Groceries,Supermarket,-38.5,GBP,-223189.27,POS,London,GB,1045,user_001,,
312158ea-aaea-4afa-867c-87a463d23638,2033-12-04,2033-12-05,Pret A Manger,5814,Food & Drink,Eating Out,-8.99,GBP,-223198.26,POS,London,GB,9074,user_001,,
3773de90-20b7-4def-85c5-7de090c3331f,2033-12-04,2033-12-06,Uber UK,4121,Transport,Ride Hailing,-33.13,GBP,-223231.39,E-Com,London,GB,4488,user_001,,
5be35a98-fe56-437c-92d2-a421d946f188,2033-12-04,2033-12-05,Shell,5541,Transport,Fuel,-32.05,GBP,-223263.44,POS,London,GB,4488,user_001,,
50f1d863-28b5-4453-8767-89f220f1cc22,2033-12-05,2033-12-07,Waitrose,5411,Groceries,Supermarket,-57.8,GBP,-223321.24,POS,London,GB,4488,user_001,,
6d8f3182-ef9c-4427-b0ff-81df37f6dc2a,2033-12-05,2033-12-05,Deliveroo,5812,Food & Drink,Delivery,-12.83,GBP,-223334.07,E-Com,London,GB,1045,user_002,,
74c736b9-ff31-4409-b4bf-63b2f78a7851,2033-12-05,2033-12-07,ATM Withdrawal,6011,Cash,ATM,-71.18,GBP,-223405.25,ATM,London,GB,2219,user_001,,
63f667f8-86ac-451f-8850-30e6c1637cf8,2033-12-06,2033-12-07,Sainsbury's,5411,Groceries,Supermarket,-31.04,GBP,-223436.29,POS,London,GB,9074,user_001,,
f01bee71-6b9a-4fd6-b97d-d641a54dae8c,2033-12-06,2033-12-07,Local Market,5499,Groceries,Specialty,-13.34,GBP,-223449.63,POS,London,GB,2219,user_001,,
fa1c1554-7511-43b8-baa7-362a9484da7e,2033-12-06,2033-12-06,Local Market,5499,Groceries,Specialty,-13.0,GBP,-223462.63,POS,London,GB,2219,user_001,,
4e66100a-7100-44c3-8111-55fba4ea5f37,2033-12-07,2033-12-08,Deliveroo,5812,Food & Drink,Delivery,-12.74,GBP,-223475.37,E-Com,London,GB,9074,user_001,,
539a2b69-93dc-4251-882a-b53b5042e3b4,2033-12-07,2033-12-09,Sainsbury's,5411,Groceries,Supermarket,-27.71,GBP,-223503.08,POS,London,GB,1045,user_001,,
eb9e815e-5bd2-4cd8-9ac9-c1643365d947,2033-12-07,2033-12-09,Octopus Energy,4900,Utilities,Electricity,-130.88,GBP,-223633.96,Direct Debit,London,GB,2219,user_001,rec_141a4a0666,
5cf182c6-40cf-402b-976c-60e60fa3a75d,2033-12-08,2033-12-12,Amazon UK,5942,Shopping,Online Retail,-78.2,GBP,-223712.16,E-Com,London,GB,2219,user_001,,
60e83f53-44f3-4637-a77f-76a3a97c5e1c,2033-12-08,2033-12-08,ATM Withdrawal,6011,Cash,ATM,-73.07,GBP,-223785.23,ATM,London,GB,1045,user_002,,
99d77033-dfb4-439f-abb9-cc536733c2bc,2033-12-08,2033-12-12,Tesco,5411,Groceries,Supermarket,-25.89,GBP,-223811.12,POS,London,GB,1045,user_001,,
60509369-a899-486c-bed9-d775d1616702,2033-12-09,2033-12-12,Pret A Manger,5814,Food & Drink,Eating Out,-7.65,GBP,-223818.77,POS,London,GB,4488,user_002,,
9869784e-4260-4dd8-82d8-255f7573c521,2033-12-09,2033-12-12,Apple.com/bill,5734,Shopping,Electronics,-127.28,GBP,-223946.05,E-Com,Cupertino,US,2219,user_001,,
a9512d76-e388-45f1-a57f-15c72c352d47,2033-12-09,2033-12-12,Transport for London,4111,Transport,Transit,-11.63,GBP,-223957.68,POS,London,GB,2219,user_001,,
e7c52304-bda7-454c-b196-c20853d21316,2033-12-09,2033-12-12,Tesco,5411,Groceries,Supermarket,-24.69,GBP,-223982.37,POS,London,GB,9074,user_001,,
1e25df5a-261c-4de0-937f-eb37184f9090,2033-12-10,2033-12-12,Tesco,5411,Groceries,Supermarket,-76.49,GBP,-224058.86,POS,London,GB,2219,user_001,,
9e8fb8fd-59d0-42b0-ac09-bfa94d0a75a7,2033-12-10,2033-12-12,Uber UK,4121,Transport,Ride Hailing,-32.9,GBP,-224091.76,E-Com,London,GB,1045,user_001,,
ea62c9a4-a396-46bf-84e3-bfa1699efe6d,2033-12-10,2033-12-12,Apple.com/bill,5734,Shopping,Electronics,-97.94,GBP,-224189.7,E-Com,Cupertino,US,1045,user_001,,
986d6a15-ef0e-48d9-b1db-0e0cc7ef167a,2033-12-11,2033-12-12,Amazon UK,5942,Shopping,Online Retail,-49.7,GBP,-224239.4,E-Com,London,GB,9074,user_001,,
d19168bb-224c-4dde-b097-554e66dbebe8,2033-12-11,2033-12-12,Amazon UK,5942,Shopping,Online Retail,-96.07,GBP,-224335.47,E-Com,London,GB,1045,user_001,,
e4f804f1-d680-4e20-86a3-a8f1859ffa48,2033-12-11,2033-12-12,Uber UK,4121,Transport,Ride Hailing,-13.41,GBP,-224348.88,E-Com,London,GB,4488,user_001,,
fc3ad4ef-bc83-48ce-895e-a6517e07dc9a,2033-12-11,2033-12-13,Amazon UK,5942,Shopping,Online Retail,-20.22,GBP,-224369.1,E-Com,London,GB,4488,user_001,,
467d18b6-7c93-407e-a4b1-726f03ef39eb,2033-12-12,2033-12-13,Waitrose,5411,Groceries,Supermarket,-52.31,GBP,-224421.41,POS,London,GB,1045,user_001,,
9ce8875b-1c31-4816-a5d3-f2a39d7bf450,2033-12-12,2033-12-12,Apple.com/bill,5734,Shopping,Electronics,-193.03,USD,-224614.44,E-Com,Cupertino,US,4488,user_002,,FX purchase 239.36 USD @ rate 1.24
a7f33178-28e2-4cd2-8cc7-4ca98ae32da3,2033-12-12,2033-12-13,Waitrose,5411,Groceries,Supermarket,-49.82,GBP,-224664.26,POS,London,GB,9074,user_001,,
c431fa92-12d0-4922-a781-7c71b99bbb78,2033-12-12,2033-12-12,Thames Water,4900,Utilities,Water,-40.09,GBP,-224704.35,Direct Debit,Reading,GB,4488,user_002,rec_954d02400c,
4aa8fe76-9ead-40dd-b1b6-9aea0376958b,2033-12-13,2033-12-15,Apple.com/bill,5734,Shopping,Electronics,-125.71,GBP,-224830.06,E-Com,Cupertino,US,2219,user_001,,
7dee0bee-d01a-4bb7-b672-43d324f9c340,2033-12-13,2033-12-13,City Council Tax,9399,Utilities,Council Tax,-166.67,GBP,-224996.73,Direct Debit,London,GB,2219,user_002,rec_6feaa5d43f,
3fb6e085-53a9-4049-9511-4a17d0f38263,2033-12-14,2033-12-16,Deliveroo,5812,Food & Drink,Delivery,-18.24,GBP,-225014.97,E-Com,London,GB,4488,user_001,,
529aed92-b237-4140-839e-c170e9fce49b,2033-12-14,2033-12-14,ATM Withdrawal,6011,Cash,ATM,-116.57,GBP,-225131.54,ATM,London,GB,1045,user_001,,
c84f5e77-89e6-4504-b47f-22c7c0fa2c4c,2033-12-15,2033-12-15,Apple.com/bill,5734,Shopping,Electronics,-12.24,GBP,-225143.78,E-Com,Cupertino,US,9074,user_002,,
f247bbd4-eccc-499d-9744-e6005d536fd1,2033-12-15,2033-12-19,O2 UK,4814,Bills,Mobile,-46.33,GBP,-225190.11,Direct Debit,Slough,GB,4488,user_001,rec_95042d8101,
23b25e9a-e685-4e64-a625-246285a8638d,2033-12-16,2033-12-19,Sainsbury's,5411,Groceries,Supermarket,-36.25,GBP,-225226.36,POS,London,GB,9074,user_001,,
2c54a3ea-6d89-4ed6-9c05-c9ee43e2d7c7,2033-12-16,2033-12-16,Airline Refund,4511,Travel,Refund,25.24,GBP,-225201.12,Credit,London,GB,4488,user_001,,Refund for Waitrose
4e7ed2e2-ab03-46aa-837f-a54db5d7669e,2033-12-16,2033-12-19,Shell,5541,Transport,Fuel,-53.06,GBP,-225254.18,POS,London,GB,1045,user_001,,
583d1d65-9c91-42b2-9981-37c00af52a8a,2033-12-16,2033-12-19,Waitrose,5411,Groceries,Supermarket,-83.23,GBP,-225337.41,POS,London,GB,1045,user_001,,
7c28bc2e-df7e-4d70-a5f1-b4711b1232c6,2033-12-16,2033-12-16,Local Market,5499,Groceries,Specialty,-11.01,GBP,-225348.42,POS,London,GB,9074,user_001,,
28ad6463-8dbd-471c-944c-bc60498f8b21,2033-12-17,2033-12-19,Sainsbury's,5411,Groceries,Supermarket,-36.45,GBP,-225384.87,POS,London,GB,2219,user_001,,
72e1e7f7-4792-48ef-9301-72fbcbe387c8,2033-12-17,2033-12-19,Tesco,5411,Groceries,Supermarket,-30.65,GBP,-225415.52,POS,London,GB,1045,user_001,,
7c34aa69-bea0-454d-bdee-d216d3c0d436,2033-12-17,2033-12-19,Local Market,5499,Groceries,Specialty,-19.75,GBP,-225435.27,POS,London,GB,2219,user_001,,
e969af6d-47f0-4668-a5c4-fea5002d246b,2033-12-17,2033-12-19,Pret A Manger,5814,Food & Drink,Eating Out,-6.38,GBP,-225441.65,POS,London,GB,9074,user_002,,
ee519916-2235-4520-a2dc-385f1355d58d,2033-12-17,2033-12-19,Airline Refund,4511,Travel,Refund,15.48,GBP,-225426.17,Credit,London,GB,1045,user_001,,Refund for Tesco
099033f8-9cfb-47ff-8442-d75366be48b0,2033-12-18,2033-12-20,Waitrose,5411,Groceries,Supermarket,-61.7,GBP,-225487.87,POS,London,GB,1045,user_002,,
110a70eb-4e53-4ab7-ae9e-baf4de755137,2033-12-18,2033-12-19,Amazon UK,5942,Shopping,Online Retail,-12.4,GBP,-225500.27,E-Com,London,GB,2219,user_001,,
34053c56-9cc6-4bd8-b466-290f595279a1,2033-12-18,2033-12-20,Shell,5541,Transport,Fuel,-69.11,GBP,-225569.38,POS,London,GB,4488,user_001,,
d5434bd7-f8f8-4d7a-8a0b-4296cfc3b19e,2033-12-18,2033-12-20,Amazon UK,5942,Shopping,Online Retail,-76.9,GBP,-225646.28,E-Com,London,GB,1045,user_001,,
05a5380f-8b6a-436b-9ce4-5ed7bf5d221d,2033-12-19,2033-12-21,Spotify,5735,Entertainment,Subscriptions,-8.38,GBP,-225654.66,E-Com,Stockholm,SE,1045,user_001,rec_4c746d2c3b,
75b0da7d-7163-4da9-937c-1cda13df0fe7,2033-12-19,2033-12-19,GymBox,7997,Wellness,Gym,-49.29,GBP,-225703.95,Direct Debit,London,GB,2219,user_001,rec_3906953fd2,
f58b9787-c42a-4007-8d7c-9b838b185840,2033-12-19,2033-12-21,Apple.com/bill,5734,Shopping,Electronics,-172.98,GBP,-225876.93,E-Com,Cupertino,US,9074,user_001,,
f6c683ab-07e9-4318-935b-6fedf49eb866,2033-12-19,2033-12-19,Apple.com/bill,5734,Shopping,Electronics,-16.73,GBP,-225893.66,E-Com,Cupertino,US,9074,user_001,,
20190b6b-4611-4eb4-b132-bd12d4c39591,2033-12-20,2033-12-22,Pret A Manger,5814,Food & Drink,Eating Out,-8.52,GBP,-225902.18,POS,London,GB,1045,user_001,,
c6d1e5fb-96b9-44ab-a2ea-4a2692f8e246,2033-12-20,2033-12-21,Pret A Manger,5814,Food & Drink,Eating Out,-10.15,GBP,-225912.33,POS,London,GB,1045,user_002,,
05d0be6e-521a-4939-88fd-c84b953ee7e8,2033-12-21,2033-12-21,Airline Refund,4511,Travel,Refund,9.49,GBP,-225902.84,Credit,London,GB,2219,user_001,,Refund for Local Market
ab75df57-2580-4d3e-9365-cf92543092ac,2033-12-21,2033-12-21,Waitrose,5411,Groceries,Supermarket,-36.75,GBP,-225939.59,POS,London,GB,4488,user_001,,
c8e0aa83-b03d-4da8-933a-e4dbabf0fa96,2033-12-21,2033-12-23,Uber UK,4121,Transport,Ride Hailing,-22.65,GBP,-225962.24,E-Com,London,GB,1045,user_001,,
f2494a35-a6bd-4367-900e-16e4b34c716e,2033-12-21,2033-12-23,Netflix,7841,Entertainment,Subscriptions,-12.63,GBP,-225974.87,E-Com,Los Gatos,US,9074,user_001,rec_1bfe33738d,
5c3ed71b-a9e2-4cf1-a330-d0fd0b0277e0,2033-12-23,2033-12-26,Tesco,5411,Groceries,Supermarket,-77.94,GBP,-226052.81,POS,London,GB,4488,user_001,,
70f9fee9-219c-4dec-8a21-be316ab73d0c,2033-12-23,2033-12-26,Local Market,5499,Groceries,Specialty,-12.08,GBP,-226064.89,POS,London,GB,9074,user_001,,
bc69fabd-7643-4c83-9337-c23165b50cb6,2033-12-23,2033-12-26,Amazon UK,5942,Shopping,Online Retail,-75.33,GBP,-226140.22,E-Com,London,GB,1045,user_001,,
cbbd2451-c52c-4820-aede-759609cac8a3,2033-12-23,2033-12-23,T212 Capital,6011,Income,Salary,3258.53,GBP,-222881.69,Credit,London,GB,1045,user_001,rec_2ff8f778d0,
ec1e06b6-13bc-4a1b-9661-dc17b13ac057,2033-12-23,2033-12-23,Pret A Manger,5814,Food & Drink,Eating Out,-9.0,GBP,-222890.69,POS,London,GB,4488,user_002,,
4dd857c4-8a35-49d4-8e63-3e2b0deb1ce9,2033-12-24,2033-12-26,Apple.com/bill,5734,Shopping,Electronics,-98.26,USD,-222988.95,E-Com,Cupertino,US,2219,user_001,,FX purchase 123.88 USD @ rate 1.26
61208f03-7679-416d-b698-c7be0d9b067c,2033-12-24,2033-12-26,Amazon UK,5942,Shopping,Online Retail,-95.21,GBP,-223084.16,E-Com,London,GB,4488,user_001,,
be66aca0-fa1f-4375-b8cd-9a4686ac4590,2033-12-24,2033-12-26,Uber UK,4121,Transport,Ride Hailing,-9.24,GBP,-223093.4,E-Com,London,GB,9074,user_001,,
de2884cf-7da4-4dcf-a941-f1bee7291a1f,2033-12-25,2033-12-26,Deliveroo,5812,Food & Drink,Delivery,-23.6,GBP,-223117.0,E-Com,London,GB,4488,user_001,,
7043d6f3-c3ff-49d2-893e-42afdfed7d44,2033-12-26,2033-12-26,Transport for London,4111,Transport,Transit,-6.29,GBP,-223123.29,POS,London,GB,9074,user_001,,
b4562800-40de-414b-ab5f-fe2ca643f8c8,2033-12-28,2033-12-28,Airline Refund,4511,Travel,Refund,26.38,GBP,-223096.91,Credit,London,GB,2219,user_001,,Refund for Sainsbury's
d4c36e62-5f17-4d9f-8f72-2074bf2191e8,2033-12-28,2033-12-30,Amazon UK,5942,Shopping,Online Retail,-53.25,GBP,-223150.16,E-Com,London,GB,4488,user_002,,
a8ffc4a8-7c8b-4fb7-aa9f-97bc115d3a31,2033-12-29,2033-12-29,Pret A Manger,5814,Food & Drink,Eating Out,-9.87,GBP,-223160.03,POS,London,GB,4488,user_001,,
05c9a57a-3be9-4e5b-960b-89cf9d9ad2f1,2033-12-30,2034-01-02,Pret A Manger,5814,Food & Drink,Eating Out,-9.7,GBP,-223169.73,POS,London,GB,4488,user_001,,
34e94a9c-aaa5-477d-b7bb-56b8643a0ea8,2033-12-30,2033-12-30,Deliveroo,5812,Food & Drink,Delivery,-12.8,GBP,-223182.53,E-Com,London,GB,4488,user_001,,
7385701e-2ab8-422e-ad70-2a25f70d32d6,2033-12-30,2033-12-30,HM Revenue & Customs,9311,Income,Tax Refund,6.24,GBP,-223176.29,Credit,London,GB,2219,user_002,,Refund for Pret A Manger
a553d7b5-489a-4ee7-82f6-50464a51d2da,2033-12-30,2033-12-30,Local Market,5499,Groceries,Specialty,-21.26,GBP,-223197.55,POS,London,GB,2219,user_001,,
ea6a5465-a864-4329-9d13-d19801d43915,2033-12-30,2033-12-30,Deliveroo,5812,Food & Drink,Delivery,-23.79,GBP,-223221.34,E-Com,London,GB,4488,user_001,,
5d1c8172-89fc-4c0c-a201-fa2965a4a5ee,2033-12-31,2034-01-02,Pret A Manger,5814,Food & Drink,Eating Out,-7.38,GBP,-223228.72,POS,London,GB,4488,user_001,,
686dc846-9322-43b1-bab3-16bc0ac73f03,2033-12-31,2034-01-02,Pret A Manger,5814,Food & Drink,Eating Out,-11.02,GBP,-223239.74,POS,London,GB,1045,user_001,,
7ad177a2-6631-4bfd-98a7-7f47d2201da6,2033-12-31,2034-01-02,Transport for London,4111,Transport,Transit,-9.83,GBP,-223249.57,POS,London,GB,9074,user_001,,
88c34c84-0e53-4e64-bbd0-c85f1bc367c6,2033-12-31,2034-01-02,Apple.com/bill,5734,Shopping,Electronics,-45.1,GBP,-223294.67,E-Com,Cupertino,US,9074,user_001,,
da44e9fe-2822-4bbf-a2c9-53aa033aae1c,2033-12-31,2034-01-02,Pret A Manger,5814,Food & Drink,Eating Out,-7.57,GBP,-223302.24,POS,London,GB,4488,user_001,,
ea7c8016-eb2d-47c9-b414-db41fcac21b0,2033-12-31,2034-01-02,Waitrose,5411,Groceries,Supermarket,-44.87,GBP,-223347.11,POS,London,GB,2219,user_001,,
4e1b90d8-d53b-4482-81c9-be5fc27a3de3,2034-01-01,2034-01-02,Pret A Manger,5814,Food & Drink,Eating Out,-10.1,GBP,-223357.21,POS,London,GB,2219,user_001,,
65330a77-6561-4178-821a-b6a1ff238a07,2034-01-01,2034-01-02,Transport for London,4111,Transport,Transit,-8.68,GBP,-223365.89,POS,London,GB,4488,user_001,,
9a392b74-f0df-4c1d-909b-b46b6a330914,2034-01-01,2034-01-02,Sainsbury's,5411,Groceries,Supermarket,-49.95,GBP,-223415.84,POS,London,GB,2219,user_002,,
fbc35859-6728-4a80-a1f5-7f2c0617ac3d,2034-01-01,2034-01-03,Deliveroo,5812,Food & Drink,Delivery,-13.61,GBP,-223429.45,E-Com,London,GB,2219,user_001,,
5f9572f6-ca62-43de-88ad-de2e21eaae53,2034-01-02,2034-01-02,Crown Estates Lettings,6513,Housing,Rent,-1576.28,GBP,-225005.73,POS,London,GB,9074,user_001,rec_19f70fbcce,
8dcd056a-6fed-4c14-a230-85cd9371aa87,2034-01-03,2034-01-05,Pret A Manger,5814,Food & Drink,Eating Out,-10.33,GBP,-225016.06,POS,London,GB,2219,user_001,,
97b747f0-374f-4741-957d-e7c5f69ea7f6,2034-01-03,2034-01-03,Uber UK,4121,Transport,Ride Hailing,-33.42,GBP,-225049.48,E-Com,London,GB,1045,user_001,,
dc73f6d4-4a77-4f9a-9117-59cad6dd8bee,2034-01-03,2034-01-04,Amazon UK,5942,Shopping,Online Retail,-73.27,GBP,-225122.75,E-Com,London,GB,2219,user_001,,
519b22ff-2276-4329-ad43-39165f8bf9a3,2034-01-04,2034-01-04,Shell,5541,Transport,Fuel,-59.31,GBP,-225182.06,POS,London,GB,4488,user_001,,
3b773460-25bb-4d3c-8376-494624bd0c35,2034-01-05,2034-01-05,Transport for London,4111,Transport,Transit,-8.5,GBP,-225190.56,POS,London,GB,4488,user_001,,
6e92db9b-d0f7-4529-8f9c-e7d36bb0965f,2034-01-05,2034-01-05,Sainsbury's,5411,Groceries,Supermarket,-21.59,GBP,-225212.15,POS,London,GB,9074,user_001,,
1f337c9f-f763-4883-acb8-dbb642bf70fe,2034-01-06,2034-01-09,Shell,5541,Transport,Fuel,-51.84,GBP,-225263.99,POS,London,GB,2219,user_002,,
27256c79-792c-416b-9343-e9efc68a354a,2034-01-06,2034-01-09,Sainsbury's,5411,Groceries,Supermarket,-22.48,GBP,-225286.47,POS,London,GB,1045,user_001,,
415e0c2b-6c64-4b45-aa15-c1092764e64a,2034-01-06,2034-01-09,Uber UK,4121,Transport,Ride Hailing,-26.69,GBP,-225313.16,E-Com,London,GB,9074,user_002,,
8b5bc5a3-9775-435d-9658-64926e9b0759,2034-01-06,2034-01-09,Deliveroo,5812,Food & Drink,Delivery,-21.35,GBP,-225334.51,E-Com,London,GB,4488,user_001,,
ae0447a8-521c-4347-a965-dd3e60b773b4,2034-01-07,2034-01-09,Waitrose,5411,Groceries,Supermarket,-88.4,GBP,-225422.91,POS,London,GB,9074,user_001,,
b4fb2db8-57e5-4234-b7cd-a50ab1443df3,2034-01-07,2034-01-09,Sainsbury's,5411,Groceries,Supermarket,-52.58,GBP,-225475.49,POS,London,GB,9074,user_001,,
da341134-bbd5-461e-8e3d-89f54b92846a,2034-01-07,2034-01-09,Tesco,5411,Groceries,Supermarket,-25.75,GBP,-225501.24,POS,London,GB,1045,user_001,,
16e09f41-ab75-42fa-9155-bd5f8796d8a9,2034-01-08,2034-01-09,Amazon UK,5942,Shopping,Online Retail,-44.41,GBP,-225545.65,E-Com,London,GB,2219,user_001,,
293e6f13-edc6-436a-bfcb-b1a1f899449a,2034-01-08,2034-01-09,Waitrose,5411,Groceries,Supermarket,-38.18,GBP,-225583.83,POS,London,GB,2219,user_001,,
3e1bade1-d713-47f9-8da0-e71dceab61ad,2034-01-08,2034-01-10,Deliveroo,5812,Food & Drink,Delivery,-17.51,GBP,-225601.34,E-Com,London,GB,2219,user_001,,
486c7138-4136-429f-b25c-920837e35e67,2034-01-08,2034-01-09,Sainsbury's,5411,Groceries,Supermarket,-69.39,GBP,-225670.73,POS,London,GB,1045,user_001,,
4d59c837-9dce-4674-9085-272550f8dc70,2034-01-08,2034-01-10,Deliveroo,5812,Food & Drink,Delivery,-14.9,GBP,-225685.63,E-Com,London,GB,4488,user_002,,
7dcb39fa-2f1f-458e-b483-125151c11111,2034-01-08,2034-01-09,Pret A Manger,5814,Food & Drink,Eating Out,-6.86,GBP,-225692.49,POS,London,GB,1045,user_001,,
e561bb68-679b-4ffa-acb7-bb5044e6f2dc,2034-01-08,2034-01-10,Deliveroo,5812,Food & Drink,Delivery,-33.62,GBP,-225726.11,E-Com,London,GB,9074,user_002,,
ae91e96b-8eaa-46af-a8c2-0f4b1c7a7c07,2034-01-09,2034-01-11,Apple.com/bill,5734,Shopping,Electronics,-137.55,GBP,-225863.66,E-Com,Cupertino,US,2219,user_001,,
f62f1ae5-acfa-4005-84fc-421cd10c7073,2034-01-09,2034-01-10,Octopus Energy,4900,Utilities,Electricity,-122.4,GBP,-225986.06,Direct Debit,London,GB,9074,user_001,rec_141a4a0666,
488bdab3-04cc-4256-a72e-c502a9e96c6e,2034-01-10,2034-01-11,Amazon UK,5942,Shopping,Online Retail,-14.92,GBP,-226000.98,E-Com,London,GB,9074,user_002,,
7fddd398-eff4-42d5-972a-ad6fd1656def,2034-01-10,2034-01-11,Pret A Manger,5814,Food & Drink,Eating Out,-5.86,GBP,-226006.84,POS,London,GB,9074,user_001,,
74c81869-0103-4c59-9a45-0510b71e4c97,2034-01-11,2034-01-12,Thames Water,4900,Utilities,Water,-36.97,GBP,-226043.81,Direct Debit,Reading,GB,9074,user_001,rec_3a34d62842,
788811c6-391f-41cd-8bc8-5160895c21e8,2034-01-11,2034-01-12,Shell,5541,Transport,Fuel,-94.98,GBP,-226138.79,POS,London,GB,4488,user_001,,
bed49cad-f89c-4079-bae5-c876adb2b1f3,2034-01-11,2034-01-11,Local Market,5499,Groceries,Specialty,-8.18,GBP,-226146.97,POS,London,GB,4488,user_001,,
d902c2e0-08ea-4611-a2e4-a890880559ac,2034-01-11,2034-01-11,Tesco,5411,Groceries,Supermarket,-41.32,GBP,-226188.29,POS,London,GB,1045,user_001,,
bad03173-146a-439e-b1d8-1b841a2a41ed,2034-01-12,2034-01-12,Uber UK,4121,Transport,Ride Hailing,-29.59,GBP,-226217.88,E-Com,London,GB,2219,user_001,,
b8b6f8d4-d32e-404a-8130-28bdab682581,2034-01-13,2034-01-16,Local Market,5499,Groceries,Specialty,-8.62,GBP,-226226.5,POS,London,GB,2219,user_001,,
cd3c83bf-70f4-4798-a0d7-dd5ce371e13b,2034-01-13,2034-01-13,Shell,5541,Transport,Fuel,-79.97,GBP,-226306.47,POS,London,GB,2219,user_001,,
e050dd14-7c96-43e6-aa45-6aae270227e4,2034-01-13,2034-01-16,City Council Tax,9399,Utilities,Council Tax,-185.3,GBP,-226491.77,Direct Debit,London,GB,1045,user_001,rec_f531495db5,
56d9cc24-f823-48d8-bdfb-d6f93d8e7e96,2034-01-14,2034-01-16,Deliveroo,5812,Food & Drink,Delivery,-23.92,GBP,-226515.69,E-Com,London,GB,9074,user_002,,
f0b6ee2e-aa06-4fbe-a41e-9c948a079137,2034-01-14,2034-01-16,Amazon UK,5942,Shopping,Online Retail,-61.17,GBP,-226576.86,E-Com,London,GB,1045,user_001,,
6017391e-d5ea-4259-a349-e536d910a1d9,2034-01-15,2034-01-16,Amazon UK,5942,Shopping,Online Retail,-25.62,GBP,-226602.48,E-Com,London,GB,4488,user_001,,
86b1d416-915f-46e8-b206-bdbecf7c9073,2034-01-15,2034-01-16,Tesco,5411,Groceries,Supermarket,-32.51,GBP,-226634.99,POS,London,GB,2219,user_001,,
0ef51a01-b775-48c5-b637-8760f4d069c3,2034-01-16,2034-01-17,Pret A Manger,5814,Food & Drink,Eating Out,-5.59,GBP,-226640.58,POS,London,GB,4488,user_001,,
18741da2-8a19-4b10-bf30-0896fe6a0102,2034-01-16,2034-01-16,O2 UK,4814,Bills,Mobile,-51.43,GBP,-226692.01,Direct Debit,Slough,GB,9074,user_001,rec_95042d8101,
3a267274-592b-4b85-94d8-48602b26b99c,2034-01-16,2034-01-17,Apple.com/bill,5734,Shopping,Electronics,-119.22,GBP,-226811.23,E-Com,Cupertino,US,2219,user_001,,
dd8e3535-d5aa-4f45-9e9c-bdadc97b812b,2034-01-16,2034-01-17,Local Market,5499,Groceries,Specialty,-19.63,GBP,-226830.86,POS,London,GB,1045,user_001,,
3616d83f-e9b2-4e3c-a869-9de90c463cfd,2034-01-17,2034-01-17,Deliveroo,5812,Food & Drink,Delivery,-28.97,GBP,-226859.83,E-Com,London,GB,4488,user_001,,
5a66978d-c49d-4de0-8557-03c7ff42bb21,2034-01-17,2034-01-19,Amazon UK,5942,Shopping,Online Retail,-101.71,GBP,-226961.54,E-Com,London,GB,2219,user_001,,
6cc74687-3a11-4db4-a1ad-f6c0d62dc5ba,2034-01-17,2034-01-19,GymBox,7997,Wellness,Gym,-52.72,GBP,-227014.26,Direct Debit,London,GB,2219,user_002,rec_19771e79cd,
a1b42fb8-6d3a-48a9-9b22-767840db38a7,2034-01-17,2034-01-19,Pret A Manger,5814,Food & Drink,Eating Out,-9.84,GBP,-227024.1,POS,London,GB,2219,user_001,,
a8d1fc7d-897d-4a8e-b78f-555ca015f619,2034-01-17,2034-01-18,Uber UK,4121,Transport,Ride Hailing,-33.42,GBP,-227057.52,E-Com,London,GB,4488,user_001,,
1e5766d2-0322-4206-8ceb-17bef2dab231,2034-01-18,2034-01-18,Transport for London,4111,Transport,Transit,-8.28,GBP,-227065.8,POS,London,GB,2219,user_001,,
526c02be-fcc1-436c-99d8-0029ce129133,2034-01-18,2034-01-20,Pret A Manger,5814,Food & Drink,Eating Out,-6.9,GBP,-227072.7,POS,London,GB,1045,user_001,,
278efa7c-ae3b-4c76-bed0-ed569f6627ce,2034-01-19,2034-01-19,Waitrose,5411,Groceries,Supermarket,-88.71,GBP,-227161.41,POS,London,GB,1045,user_001,,
4f601452-b28b-486a-aa6e-e4a256cb8ceb,2034-01-19,2034-01-20,Amazon UK,5942,Shopping,Online Retail,-40.83,GBP,-227202.24,E-Com,London,GB,9074,user_002,,
53859313-a86f-4bcb-adf2-92f19655b5ce,2034-01-19,2034-01-19,ATM Withdrawal,6011,Cash,ATM,-86.93,GBP,-227289.17,ATM,London,GB,2219,user_001,,
65fe289f-4afe-4d8a-8f28-5c3b2ee83cba,2034-01-19,2034-01-20,Spotify,5735,Entertainment,Subscriptions,-8.08,GBP,-227297.25,E-Com,Stockholm,SE,4488,user_001,rec_4c746d2c3b,
838e0783-68dc-4ae0-a575-05cf9e7a8660,2034-01-19,2034-01-19,Transport for London,4111,Transport,Transit,-6.58,GBP,-227303.83,POS,London,GB,4488,user_001,,
901efc9e-1ecc-461b-a94d-16586d3fbdfc,2034-01-19,2034-01-19,Local Market,5499,Groceries,Specialty,-20.27,GBP,-227324.1,POS,London,GB,1045,user_001,,
943364fa-796f-4929-9427-e6738c9ee520,2034-01-19,2034-01-23,Transport for London,4111,Transport,Transit,-10.82,GBP,-227334.92,POS,London,GB,1045,user_001,,
af0e46d0-dd47-4d5a-b8d3-eb6719eabf69,2034-01-19,2034-01-23,Sainsbury's,5411,Groceries,Supermarket,-20.5,GBP,-227355.42,POS,London,GB,9074,user_001,,
72c6572b-e3a5-4696-81e0-9f74456383e7,2034-01-20,2034-01-20,Apple.com/bill,5734,Shopping,Electronics,-117.96,USD,-227473.38,E-Com,Cupertino,US,2219,user_001,,FX purchase 151.08 USD @ rate 1.28
b0e08344-1f3a-467f-a300-26e18657467f,2034-01-20,2034-01-20,Sainsbury's,5411,Groceries,Supermarket,-61.58,GBP,-227534.96,POS,London,GB,2219,user_002,,
1b752563-719a-4ec9-a792-61cfd56462cf,2034-01-21,2034-01-23,Apple.com/bill,5734,Shopping,Electronics,-87.88,USD,-227622.84,E-Com,Cupertino,US,2219,user_002,,FX purchase 107.38 USD @ rate 1.22
2862c4a3-6754-4690-8046-00253e68f42c,2034-01-21,2034-01-23,Sainsbury's,5411,Groceries,Supermarket,-61.6,GBP,-227684.44,POS,London,GB,4488,user_001,,
3088d9ff-718f-41b5-8588-1d7474ce6efe,2034-01-21,2034-01-23,Waitrose,5411,Groceries,Supermarket,-20.01,GBP,-227704.45,POS,London,GB,1045,user_001,,
3636bd90-18dc-4271-b736-1fddc6a12df5,2034-01-21,2034-01-23,Uber UK,4121,Transport,Ride Hailing,-30.5,GBP,-227734.95,E-Com,London,GB,4488,user_002,,
bd9d31e2-9765-4d4f-a72b-97efafc55922,2034-01-21,2034-01-23,Deliveroo,5812,Food & Drink,Delivery,-17.7,GBP,-227752.65,E-Com,London,GB,9074,user_001,,
07fb8b46-b9fe-4906-b9a9-dda3fa7d8f72,2034-01-22,2034-01-23,Shell,5541,Transport,Fuel,-88.13,GBP,-227840.78,POS,London,GB,9074,user_001,,
f2741e9e-a23e-4a5a-b5d3-be9a826501fe,2034-01-22,2034-01-23,Waitrose,5411,Groceries,Supermarket,-38.51,GBP,-227879.29,POS,London,GB,1045,user_001,,
fceaebeb-c807-40ea-b299-d18288595b76,2034-01-22,2034-01-23,Pret A Manger,5814,Food & Drink,Eating Out,-10.65,GBP,-227889.94,POS,London,GB,1045,user_001,,
fe334691-cc20-4ea6-a977-adda4c6c0fce,2034-01-22,2034-01-23,Local Market,5499,Groceries,Specialty,-12.91,GBP,-227902.85,POS,London,GB,9074,user_001,,
7adcd5fa-6929-4cdd-9c12-482131f416a6,2034-01-23,2034-01-24,Apple.com/bill,5734,Shopping,Electronics,-99.67,GBP,-228002.52,E-Com,Cupertino,US,2219,user_001,,
ed1025ec-b3e5-4db5-b0a4-a15fc53bdc9c,2034-01-23,2034-01-25,Pret A Manger,5814,Food & Drink,Eating Out,-10.48,GBP,-228013.0,POS,London,GB,4488,user_002,,
fb5fc949-07d6-4e51-9810-93b753d83c62,2034-01-23,2034-01-25,Netflix,7841,Entertainment,Subscriptions,-12.51,USD,-228025.51,E-Com,Los Gatos,US,9074,user_001,rec_1bfe33738d,FX purchase 15.94 USD @ rate 1.27
8fc8ac67-4400-40d4-a129-5aac130ba408,2034-01-24,2034-01-24,Airline Refund,4511,Travel,Refund,43.95,GBP,-227981.56,Credit,London,GB,1045,user_001,,Refund for O2 UK
98fa4515-d45b-4b41-bc19-8fea68607921,2034-01-24,2034-01-25,Deliveroo,5812,Food & Drink,Delivery,-23.82,GBP,-228005.38,E-Com,London,GB,2219,user_001,,
1e76a12f-fdaa-456c-98de-f4de7c99f387,2034-01-25,2034-01-25,Transport for London,4111,Transport,Transit,-8.84,GBP,-228014.22,POS,London,GB,9074,user_001,,
b674e76a-ce7b-4b73-8abf-8d7fad4a08fd,2034-01-25,2034-01-25,T212 Capital,6011,Income,Salary,3229.34,GBP,-224784.88,Credit,London,GB,9074,user_001,rec_2ff8f778d0,
8fc07434-6e8a-42e0-9716-dc59019ee1ea,2034-01-26,2034-01-30,Transport for London,4111,Transport,Transit,-9.07,GBP,-224793.95,POS,London,GB,9074,user_001,,
b109b8dd-c99a-4f97-aae6-df03c4e012cf,2034-01-26,2034-01-30,Local Market,5499,Groceries,Specialty,-17.51,GBP,-224811.46,POS,London,GB,4488,user_001,,
d032f445-b8a1-4cc2-a819-de7be76b5063,2034-01-26,2034-01-30,Apple.com/bill,5734,Shopping,Electronics,-24.68,USD,-224836.14,E-Com,Cupertino,US,2219,user_001,,FX purchase 30.88 USD @ rate 1.25
eea83d0d-bbb7-4cb5-b125-56ec8f6402bd,2034-01-26,2034-01-27,Waitrose,5411,Groceries,Supermarket,-27.58,GBP,-224863.72,POS,London,GB,4488,user_001,,
13455153-a8c5-4dd6-9081-e1feccfaae04,2034-01-28,2034-01-30,Local Market,5499,Groceries,Specialty,-21.56,GBP,-224885.28,POS,London,GB,4488,user_001,,
6c995472-7895-45b0-a8c7-1f1da863da0b,2034-01-28,2034-01-30,Waitrose,5411,Groceries,Supermarket,-40.39,GBP,-224925.67,POS,London,GB,9074,user_001,,
861a5b07-90ee-40b8-846d-077e966d8a2b,2034-01-28,2034-01-30,Waitrose,5411,Groceries,Supermarket,-34.2,GBP,-224959.87,POS,London,GB,1045,user_001,,
d320b9e1-a210-4e94-a700-0b2656c7c7dc,2034-01-28,2034-01-30,Waitrose,5411,Groceries,Supermarket,-57.44,GBP,-225017.31,POS,London,GB,9074,user_001,,
1934fd2e-002a-439e-96ee-0f1c03d3cf65,2034-01-29,2034-01-31,Pret A Manger,5814,Food & Drink,Eating Out,-10.45,GBP,-225027.76,POS,London,GB,4488,user_001,,
d54931bc-6f01-4873-8790-6f78d7a42e09,2034-01-29,2034-01-30,Waitrose,5411,Groceries,Supermarket,-77.65,GBP,-225105.41,POS,London,GB,1045,user_002,,
ec259f4c-6c6e-4b71-9fb5-d429abdcb690,2034-01-29,2034-01-30,Deliveroo,5812,Food & Drink,Delivery,-26.71,GBP,-225132.12,E-Com,London,GB,4488,user_001,,
c23b032e-ef8d-4d3e-9d16-177071744a97,2034-01-30,2034-01-31,Deliveroo,5812,Food & Drink,Delivery,-31.82,GBP,-225163.94,E-Com,London,GB,9074,user_001,,
ef46f045-0488-41d2-a4b4-5e3cb56029d7,2034-01-30,2034-01-31,Apple.com/bill,5734,Shopping,Electronics,-170.12,USD,-225334.06,E-Com,Cupertino,US,2219,user_002,,FX purchase 212.72 USD @ rate 1.25
c25f6920-a6d1-4187-aab1-63cf4d57cccd,2034-01-31,2034-02-01,Uber UK,4121,Transport,Ride Hailing,-27.14,GBP,-225361.2,E-Com,London,GB,9074,user_001,,
c9e33d23-a3c2-446b-ba89-749f8b868124,2034-01-31,2034-02-01,Waitrose,5411,Groceries,Supermarket,-88.04,GBP,-225449.24,POS,London,GB,4488,user_001,,
414e294a-fca3-4b51-bf19-b5b2389fe5e4,2034-02-01,2034-02-01,Deliveroo,5812,Food & Drink,Delivery,-12.23,GBP,-225461.47,E-Com,London,GB,4488,user_001,,
b7922b9e-76d8-44de-8eb3-5dfffaec14dc,2034-02-01,2034-02-03,Crown Estates Lettings,6513,Housing,Rent,-1649.26,GBP,-227110.73,POS,London,GB,4488,user_001,rec_19f70fbcce,
d7df28cc-97fc-4f22-a7aa-7dbebb6686fd,2034-02-03,2034-02-06,Amazon UK,5942,Shopping,Online Retail,-38.83,GBP,-227149.56,E-Com,London,GB,4488,user_001,,
8701eafb-4d75-4e8e-a7c5-7381d8a65a0b,2034-02-04,2034-02-06,Deliveroo,5812,Food & Drink,Delivery,-18.4,GBP,-227167.96,E-Com,London,GB,4488,user_001,,
90d22fba-850d-41fa-b872-086cd315b3c6,2034-02-04,2034-02-06,Waitrose,5411,Groceries,Supermarket,-87.12,GBP,-227255.08,POS,London,GB,9074,user_001,,
9a4557da-8aa7-4a7e-8b6e-ca63d6f3477d,2034-02-04,2034-02-06,Local Market,5499,Groceries,Specialty,-12.02,GBP,-227267.1,POS,London,GB,2219,user_001,,
9c5a4e59-1a80-4dfc-a80a-6ee6cb686733,2034-02-04,2034-02-06,Local Market,5499,Groceries,Specialty,-8.18,GBP,-227275.28,POS,London,GB,4488,user_001,,
1e39f1e2-fd56-487e-8fa1-d5bf0573ff60,2034-02-05,2034-02-06,Uber UK,4121,Transport,Ride Hailing,-27.09,GBP,-227302.37,E-Com,London,GB,4488,user_002,,
2c960135-9ab7-476b-bca9-758f70bf8be9,2034-02-05,2034-02-06,Deliveroo,5812,Food & Drink,Delivery,-22.64,GBP,-227325.01,E-Com,London,GB,4488,user_001,,
3eb59452-fe29-4452-b25c-2b75470e382d,2034-02-05,2034-02-07,Pret A Manger,5814,Food & Drink,Eating Out,-6.94,GBP,-227331.95,POS,London,GB,4488,user_002,,
43e3ae7a-9143-46fc-9d7f-332a935e773a,2034-02-05,2034-02-06,Transport for London,4111,Transport,Transit,-5.76,GBP,-227337.71,POS,London,GB,4488,user_001,,
4863b1b1-088a-4b10-8e25-e9d04738e49e,2034-02-05,2034-02-06,Apple.com/bill,5734,Shopping,Electronics,-136.12,GBP,-227473.83,E-Com,Cupertino,US,4488,user_001,,
b0b556db-4030-4f93-a113-8e8d9b9d8fb7,2034-02-05,2034-02-06,Uber UK,4121,Transport,Ride Hailing,-18.6,GBP,-227492.43,E-Com,London,GB,1045,user_001,,
fda078d9-4982-4c27-8e1f-c42d110fee6f,2034-02-05,2034-02-06,Pret A Manger,5814,Food & Drink,Eating Out,-6.03,GBP,-227498.46,POS,London,GB,2219,user_001,,
596abaed-2d1e-49f5-a32e-cb6d7241dbe6,2034-02-06,2034-02-06,Waitrose,5411,Groceries,Supermarket,-83.65,GBP,-227582.11,POS,London,GB,4488,user_001,,
1f695aab-dbfc-4999-95f7-acd70221cc9c,2034-02-07,2034-02-08,Octopus Energy,4900,Utilities,Electricity,-113.43,GBP,-227695.54,Direct Debit,London,GB,2219,user_001,rec_141a4a0666,
a3d2f2ad-fc32-4936-b5e0-ef1abc43bda7,2034-02-08,2034-02-09,Shell,5541,Transport,Fuel,-73.44,GBP,-227768.98,POS,London,GB,9074,user_001,,
ca75c927-634c-4e1c-9b02-ebd8650de430,2034-02-08,2034-02-08,Amazon UK,5942,Shopping,Online Retail,-103.26,GBP,-227872.24,E-Com,London,GB,2219,user_001,,
39b64b4f-8558-41b5-8f2e-4de4042eb705,2034-02-09,2034-02-13,Pret A Manger,5814,Food & Drink,Eating Out,-11.23,GBP,-227883.47,POS,London,GB,1045,user_001,,
31bf70ec-58e6-48d8-af2e-8456d4608548,2034-02-10,2034-02-13,Deliveroo,5812,Food & Drink,Delivery,-22.47,GBP,-227905.94,E-Com,London,GB,9074,user_001,,
5edf3615-80f5-40cb-bee2-433a95bcfd31,2034-02-10,2034-02-10,HM Revenue & Customs,9311,Income,Tax Refund,27.34,GBP,-227878.6,Credit,London,GB,4488,user_001,,Refund for Waitrose
d39e96d9-470b-48bb-b08c-57f56efd714a,2034-02-10,2034-02-13,Transport for London,4111,Transport,Transit,-4.72,GBP,-227883.32,POS,London,GB,2219,user_001,,
9333f346-d3fb-487c-a147-a6372f89f120,2034-02-11,2034-02-13,Deliveroo,5812,Food & Drink,Delivery,-12.97,GBP,-227896.29,E-Com,London,GB,9074,user_001,,
9722b0b0-1617-4d22-b9cf-00b589054461,2034-02-11,2034-02-13,Local Market,5499,Groceries,Specialty,-9.35,GBP,-227905.64,POS,London,GB,1045,user_001,,
c697909e-be13-4728-bbd1-8534c05e0052,2034-02-11,2034-02-13,Local Market,5499,Groceries,Specialty,-19.1,GBP,-227924.74,POS,London,GB,2219,user_001,,
ea70ef84-534c-4d7a-b051-17b215677a11,2034-02-11,2034-02-13,Waitrose,5411,Groceries,Supermarket,-40.67,GBP,-227965.41,POS,London,GB,4488,user_002,,
1a313d67-efc1-439f-af94-2dd4f79fc4da,2034-02-12,2034-02-13,ATM Withdrawal,6011,Cash,ATM,-77.29,GBP,-228042.7,ATM,London,GB,1045,user_001,,
cefbb435-9f54-420f-b3e0-d86b079ba1b5,2034-02-12,2034-02-14,Shell,5541,Transport,Fuel,-94.48,GBP,-228137.18,POS,London,GB,4488,user_001,,
fd146bb5-57ca-4047-8111-f8afa5ac30a5,2034-02-12,2034-02-14,Shell,5541,Transport,Fuel,-32.42,GBP,-228169.6,POS,London,GB,9074,user_002,,
498519b1-8c69-4425-a03d-780d8059b5c3,2034-02-13,2034-02-14,Thames Water,4900,Utilities,Water,-40.07,GBP,-228209.67,Direct Debit,Reading,GB,2219,user_001,rec_3a34d62842,
88e4c752-b92c-4b92-bb02-007bfc2636d8,2034-02-13,2034-02-14,City Council Tax,9399,Utilities,Council Tax,-182.08,GBP,-228391.75,Direct Debit,London,GB,4488,user_001,rec_f531495db5,
b52a246d-7e0d-4d2b-b366-6f52117336c2,2034-02-13,2034-02-15,Sainsbury's,5411,Groceries,Supermarket,-41.78,GBP,-228433.53,POS,London,GB,1045,user_001,,
2f4e0c87-844e-4213-b7ab-6f0410e43637,2034-02-14,2034-02-14,Local Market,5499,Groceries,Specialty,-14.7,GBP,-228448.23,POS,London,GB,2219,user_001,,
56cc4394-a34b-49fa-9782-be84c72b4608,2034-02-14,2034-02-15,Apple.com/bill,5734,Shopping,Electronics,-150.47,GBP,-228598.7,E-Com,Cupertino,US,2219,user_001,,
